text	label
estoy hasta el ojete de que me dig√°is que tengo cara de mala leche	negative
@user Por?  Ten√≠a pensado verla despu√©s de la segunda de Daredevil	neutral
Esto de estar feliz mola	positive
Ya no es tan divertido	negative
@user te recuerdo que soy una persona que tiene criterio, equivocado, pero lo tengo	neutral
@user @user @user con una peque√±a donaci√≥n har√° felices a miles de chicas que no tienen  #asociacionmariloli	positive
He probado una nueva espuma para el pelo y s√≠ que lo deja m√°s rizado pero se queda como efecto gomina y no me gusta.	negative
@user Ojal√° pudiera darte el abrazo en vivo o al menos acompa√±arte hoy. Siento mucho lo de tu primo	neutral
@user aqu√≠ tienes a mi bae aka una egipcia preciosa que esta aprendiendo espa√±ol. Os llevareis bien  @user	positive
@user ya somos dos, que triste	negative
JUAS ahora dicen que la paja se la van a hacer con Tracer y su novia. Porque siempre se puede caer m√°s bajo a√∫n ¬øno?	neutral
#2A√±osDeLegi√≥nHolk Llevo como unos 8 meses Talvez menos o mas no s√© Me ense√±aron y demostraron que LH es algo magico	positive
üåº severus snape üåº  -pobresito  -nunca le odi√©, me parec√≠a muy estricto e injusto pero sab√≠a que algo pasaba...	negative
@user es chevre las letras!! sabes q dia es ma√±ana,....	neutral
Se echa de menos  #digital #art #life @ Escuela Superior de Arte y Tecnolog√≠a (ESAT) http	positive
Esta ceniza me tiene harta, me arden los ojos	negative
¬øAprender Motion Graphics en #Barcelona sin que me cueste un ri√±√≥n es posible? ¬øAlguien conoce alg√∫n sitio?	neutral
@user No. tampoco soy cursi	positive
En fin estoy hasta los huevos del 90% de las personas as√≠ que.	negative
@user jajajajaja, ¬°qu√© linda! Yo tambi√©n me puse re feliz cuando me enter√©, nos dejan un √°lbum antes que TOP se vaya al servicio	neutral
@user     Ya est√° preparando cosillas nuevas jeje	positive
@user Jo, yo que me hab√≠a ilusionado	negative
Si la U cerr√≥ todo... entonces yo estoy libre hasta el lunes	neutral
Hoy toca escuchar a #MiguelRios con otros grandes artistas...  #Insurrecci√≥n...	positive
@user @user qu√© tendr√° brozas.. jaajajaja que me descontrola, ser√° la mala influencia	negative
@user Katy le di√≥ like en instagram y en mis Rt hace dos d√≠as los vieron juntos	neutral
Voy a jugar mi primera ranked de 10. Hmm no se si la liar√© o no, pero bronce V me espera y ma√±ana jugar√© poco o nada, so a jug√°rsela	positive
Cuando le he dicho a la bollo que estoy morena se ha re√≠do en mi cara	negative
@user @user @user @user lo importante es saber cuando! Por si hay que evitar compras for√°neas	neutral
Sin duda @user fue una experiencia preciosa  @user @user Y habr√° m√°s!	positive
Como s√© que les re interesa, les actualizo: me dijo que s√≠ a ver una peli pero me habl√≥ de un pibe d√°ndome a entender que est√°n saliendo	negative
como entraba una conversaci√≥n de estas largas de hablar toda la noche con alguien	neutral
una Go-Pro de calidad! proteccion bajo el agua y soporte de cabeza    porq ago tantas caras...OK EN FIN!	positive
Se que la pena de muerte no es algo bueno . Pero que diablos podemos hacer con los violadores ! Yo no le veo otra salida	negative
@user se llama Wolf, es la mascota #SeSalen en apoyo a los deportistas paral√≠mpicos  M√°s inf http üòÉ	neutral
Que dicha que hay trabajo y salud y vacaciones tambi√©n	positive
@user Impresionante. Una pena que hoy no pueda hacer una foto del atardecer.. P.d Gracias guapi√±o	negative
Este viernes ir√© al cine a ver #NoRespires para celebrar mi cumple. Por cierto, no est√°is invitados	neutral
La pulsera es preciosa tio	positive
@user es lamentable un tema tan sensible jam√°s con ese enfoque	negative
-Me caes muy bien  -Tienes que jugar m√°s partidas al lol con Russel y conmigo -Por qu√© tan Otako, deja de ser otako -Haber si me muero	neutral
@user, vaya, felicidades atrasadas y muchas gracias	positive
@user  Otra cosa es que no tuviera seguridad social, porqe no era obligatorio en su situacion. Lee, los libros no muerden	negative
"Trato de manejar esa sensaci√≥n de: ""no me soporto a mi misma"" de estos ultimos 2 d√≠as ¬°qu√© dolor! Es que no soy yo misma. #malditoandres"	neutral
@user Que bonita la gente educada un gran abrazo para vos ü§ó	positive
@user En Espanya la prensa ni es libre, ni es independiente, ni much√≠simo menos plural  S√≠ntoma de nuestra pobre democracia.	negative
@user fuera del t√≠pico saludo navide√±o tengo una duda: pasan Navidad juntos o cada uno con su familia? Saludos desde Lima	neutral
@user Feliz Navidad Felino!!! Jaja! Saludos y abrazos a la familia!	positive
Se me rompi√≥ el pantal√≥n horizontalmrnnte por el muslo hasta debajo de la nalga... Ya estoy a la moda	negative
Estimada @user, reciba un cordial saludo, nosotros somos el 1er Centro de Ozonoterapia en el Per√∫, contamos con muchos tratamientos	neutral
FF a los geniales de @user !!	positive
"90% para designar a quienes somos muy aficionados a todos este mundo nippon y aunque la elicaci√≥n suene que tiene un ""final feliz"" mmm"	negative
ser√≠a muy chuzo tener una gopro pero yo de mi casa no salgo as√≠ que no tendr√≠a mucho sentido.	neutral
2. Si. Eres mi crush m√°ximo aunque te considere de mis mejores amigos	positive
Nunca dejes el fb abierto y tu hermana a lado, es un PELIGRO!	negative
Tanto ritmo en el restaurant #DonMarcelo Si vienes a #Cusco, no olvides visitarlo @ Plaza de‚Ä¶	neutral
@user Google luego se encarga de asociar el contenido (bien escrito) con la b√∫squeda que se hizo (mal escrita).	positive
Ayay quiero grrabar un trocito de Drown con el ukelele porque tiene que quedar preciosa. Pero tengo la voz fatal	negative
@user deber√≠a liarla en el @user con un stand que proyectara desde el p√∫blico a las pantallas del concierto  #MTVDcode2016.	neutral
@user que ricoooo, me abriste el apetito!! Solo una cosa. Las aceitunas tienen que ser las negras	positive
Pero como no tengo una puta mierda en com√∫n pues nadie me mete para ning√∫n grupo ni nada, claro	negative
Me gusta mucho ir a Chep√©n y estar con la familia de Kike. Lo que no me gusta es tener que trabajar el lunes siguiente	neutral
Bueno,gracias a algunos(casi gratis) por confiar su salud en mi(un a√±o m√°s) no se enfermen mucho este a√±o pues, jaja mentira, saludos	positive
Que le pasa a @user que no puede estar en Twitter y WhatsApp a la vez? Las 2 fiestas est√°n igual de buenas y se esta perdiendo una!	negative
"Haces un update con tu pata de intercambio. Te pregunta, entre otras cosas, por tu vida amorosa. Suena ""brillas"" de Le√≥n Larregui."	neutral
Hace tres d√≠as que entre a @user y hoy me he pegado el segundo clip  1080 desde lo alto del ala del caza http	positive
Cuando pasan de tu p*** cara  üò¢	negative
@user la divaza te tiene cansado toda la noche no te deja dormir	neutral
Tengo una perrina adorable... Sab√©is que me acompa√±a hasta la a habitaci√≥n cuando me voy a dormir?	positive
No me puedo quedar dormida ni un ratito, porque para mi mam√° ya estoy an√©mica de nuevo	negative
@user No se , creo que no . Yo solo mire mi fecha	neutral
Con lo cual he abierto todas las ventanas y he conectado el m√≥vil a los altavoces, a ver si ahora suena mejor	positive
@user Tio entonces piensas que mosca es un insulto, yo creo que eso es un poco irrespetuoso a las pobres	negative
@user hoy tengo libre JAJA , viernes no puedo	neutral
@user @user ahora se me despierta la curiosidad de saber cu√°les eran esos antiguos nombres...	positive
@user Si, l√°stima que el bicho grandote sirva para sembrar destrucci√≥n y muerte	negative
ayer me dio mi dio mi ataque de panico retrocedi a cuando tenia 5 a√±os, me despertaba sola en cama y comenzaba a gritar pq no habia nadie	neutral
S√≥lo la Karlita me entiende y me da buenos consejos	positive
Ya no tengo libro para leer ni serie para ver, mis noches se est√°n volviendo aburridas	negative
Con entusiasmo y optimismo en este primer d√≠a del a√±o. Todo depende de lo que Dios me tiene preparado. #VamosConFe	neutral
Tengamos un d√≠a lleno de magia y lindos momentos	positive
Despu√©s de unos cuatro d√≠as de ermita√±a, salir al sol no me hizo muy bien fiebre largate	negative
@user todo lo que sea posible	neutral
D√≠as como hoy agradezco no tener carro. Andar con el h√≠gado hinchado por saber esos marchamos, mejor ando en Uber jaja	positive
Dif√≠cilmente el quiera algo serio con ust si todo empez√≥ por yaleo y nudes resp√©tese y ver√° que la buscan para algo serio y bonitoÔ∏è	negative
cuando est√°s conversando de la m√°s tranquila y te hacen recordar que mataron al perro de majin boo	neutral
@user gracias Manuel por este arte de recoger mi texto en tu revista  Un abrazo grande!	positive
Quiero comer algo, aunque estoy llena	negative
No sab√≠a que el amor de mi vida iba a cantar. Hubiese visto el programa.	neutral
@user y c√≥mo mezclan realidad con mundos paralelos, y que es diferente a las dem√°s pel√≠culas de Marvel	positive
glowen sigue a cuentas inactivas y es en plan oh seguro que esas cuentas te dan mucho m√°s apoyo que a las que le diste unf JAJAJA	negative
Elige amar, as√≠ duela, as√≠ parezca un imposible, as√≠ te tiemble el alma, as√≠ tengas miedo, as√≠ vayas a salir herida. El amor transforma	neutral
@user @user @user @user @user Gran capacidad de an√°lisis de @user en esa entrevista. #visi√≥n	positive
Me gustar√≠a arreglar tantas cosas pero no puedo arreglar ninguna y es muy frustrante	negative
Ha ardido una caravana aparcada al lado de la playa   Fuego ya sofocado por los bomberos @‚Ä¶ http	neutral
#SinPelosEnLaLengua Adem√°s,la novia de luz esta buena  Que opin√°is de @user maricon??	positive
Atm veo los 7 primeros teams un poco lejos de los 3 √∫ltimos. A ver que pasa si mejoran y/o cambian sus estrategias etc idk	negative
El huequito del septum no se me ha cerrado por completo pero ya no me cabe la pieza	neutral
@user Que guap√≠simo , dejaron mendizorroza, pero San mames ... de los + guapos del MUNDO¬°¬° sin duda.(opini√≥n)	positive
Por payasa debo hacer un trabajo grupal para ma√±ana, algunos grupos a√∫n no terminan y yo tengo que hacerlo en m√°ximo 2 horas	negative
Despu√©s de siete largos a√±os vuelvo a pasar navidad junto con mi mam√°, mi pap√° y mi hermana. Todos juntos con una yapita de sobrino.	neutral
@user 1000/10 de verdad a ti que voy a decir petarda que te quiero m√°s que a m√≠ mismo  ‚ú®	positive
ola wapa k tal stas?? spero k no seas una sorra kmo las otras xikas   - machirulo   QU√â COJONES JAJSAKJKJSADJJSJASJAJAJA	negative
@user @user dicen que tira pa, san Mateo ahora Jaaja	neutral
@user @user ¬øSer√° solo digital entonces? ¬°Perfecto! De verdad much√≠simas gracias Un abrazo desde Costa Rica. ¬°Pura vida!	positive
@user joder como te entiendo  nosotros literalmente nos tenemos que saltar las clases e ir a un centro comercial si queremos kkar	negative
Decidido: lanzo canal de YouTube. Con qu√© canci√≥n o con qu√© tema me aconsejan que empiece?	neutral
Ese aplauso para Diego Luna y Felicity Jones fue estruendoso. Tengo ganas de ver Rogue One y no puedo	positive
Lo de quedarse sola en casa sonaba a planazo de domingo, hasta que me doy cuenta de que no hay dulces en casa	negative
Nicole choteando idiotas desde tiempos inmemorables!	neutral
@user Por cierto, encantado de conocerte virtualmente  Tenemos a @user en com√∫n. Saludetes.	positive
@user necesito mi raci√≥n de atenci√≥n diaria que si no no mantengo la autoestima	negative
@user @user Fue la √∫ltima vez que fuimos al cine	neutral
@user Pero es que est√° muy rica	positive
@user @user La pena es que no incluya a modo de extra el original. Con el de consola te lo regalaban con el preorder	negative
"Si pudiese cantar bonito no dejar√≠a de hacerlo con ""Come what may"" de Moulin Rouge"	neutral
@user ya mismo seguro! Un abrazo fuerte	positive
Las horas que son y sigo sin ser capaz de ponerme a estudiar....el sue√±o puede conmigo	negative
@user lo se  pero no miraba la acc, solo miraba de vez en cuando el combo y me emocionada y nervios y shit	neutral
@user Que bonita zona de entreno escogieron	positive
Creo que voy a ponerme talking to the moon de Bruno Mars porque estoy plof y esa cancion es tan triste que	negative
@user Yo tambi√©n vi la peli y llor√© lo que no est√° escrito  Ahora estoy leyendo el libro y me estoy echando unas risas impresionantes!	neutral
Envidio de buena manera a los que tienen la oportunidad de ir ma√±ana al estadio	positive
#MePas√≥PorPavazo @user Amigo que guapo eres, mi amiga y yo queremos hacer un trio, y yo todo ganador, Me pepearon @user	negative
@user Ma√±ana si me duermo en la oficina le cuento para que se sienta culpable *busca el cofal y las pantuflas* Bonita noche	neutral
y sin querer me han elevado la barra, para seguir preparandome...waoooo este extraordinario mundo del cafe loveyouÔ∏èÔ∏è	positive
Todos quer√≠amos ver las 2 ticas juntas en la final pero as√≠ es esto , ahora le toca a lei q avanza a la final #VISSLAISAworldjuniors	negative
Yo s√© que estot todo el d√≠a dici√©ndolo peeeero vamos a merendar a alg√∫n sitio cuki	neutral
@user no las des preciosa	positive
Bueeeeno... no me siento bien. Gracias playlist por cagarme peor	negative
yo esque los veranos curro, asi que no puedo quedar mucho  pero si algun dia te pasas avisa y vamos a full hd  @user	neutral
No todo es orines y ceniza: hoy vi una ni√±a con patines y casco divirti√©ndose en la Plaza de la Cultura, y fue muy lindo	positive
@user  Ahora es Abel quien est√° resfriado  es lo ke tiene estar juntos todo el tiempo jajaja el curro bien?	negative
@user @user s√≠, celulares distintos en realidad	neutral
salir de trabajar, mirar un par de cosas del canal e irme al cine a ver mascotas con los amigos¬° planazo de sabado	positive
@user @user Hablaba normal, con alguien, antes de q usted se metiera insultando. Deber√≠a tener m√°s educaci√≥n	negative
¬øNadie quiere hacer de Uber y llevarme hasta Tarraz√∫?	neutral
@user menos mal que no has dicho escuchal üòÇüòÇüòÇüòÇüòÇ #enlacabezaNo #loSiento	positive
Que ganas tengo de volver a disfruta pronto de √©l y que lejano lo veo    #SiNoEst√°s4d√≠as	negative
#2017prometoque recuperare estado fisico, seguire amando y respetando a mi @user y veere todos los dias @user	neutral
Que lindo es tener a la viejita en casa, la extra√±√© en toda sus formas, desde los gritos por el desorden, hasta su saz√≥n en la comida	positive
Mae eso si es cierto, ahora nadie (la mayor√≠a) busca tener algo serio	negative
@user En cuando era peque√±a y bailaba en mi pueblo descalza con un vestido  ¬øTu?	neutral
@user @user Claro, yo quer√≠a por eso de manifiesto, hay cables chinos cojonudos. Otra cosa es que te compres el mas barato	positive
@user ya s√©. y con lo m√≠o es especialmente dif√≠cil. bro, esto no es exclusivamente sobre la plata u know this	negative
""" Para pasar un d√≠a complicado, lo mejor un buen bocado! ""   #FelizLunes #AtariSS #Donosti http http"	neutral
@user Lo mejor de l 2016 fue ver crecer a Ivettly y pasar momentos de alegr√≠a y tristeza pero llenos de ense√±anzas.	positive
A ver, que necesito para ser streamer y conseguir seguidores? -Cam -Micro -Subir algo decente -Tetas  Me faltan las tetas ya no puedo	negative
@user es lo que tiene ser el mejor	neutral
@user Que tengas un fant√°stico d√≠a Caeli	positive
Ma√±ana vuelvo a trabajar despu√©s de 15 d√≠as de vacaciones. Donde quedan los 3 meses de verano de peque√±os?  #QueDuroEsSerAdulto	negative
@user @user @user es un t√©rmino coloquial, no un an√°lisis	neutral
@user @user @user Gran programa pero se extra√±a a Leto !	positive
@user sabran los jueces qu√™ es honestidad? ?..y respeto? ?..no postulaba a un mercado de abastos. .si claro p lo q le interesa	negative
@user Ayer la gente de mi FB se port√≥ mejor que la de mi TL de TW en relaci√≥n con el tema de los himnos...	neutral
Los mi√©rcoles son lindos, quedarme en casa hasta las 10am me parece un lujo	positive
¬øHabr√° algo peor que no traer los aud√≠fonos a la chamba? Estoy muriendo lentamente	negative
@user pucha, yo complet√© el pokedex Per√∫, solo me faltan los regionales que dudo los consiga y a esperar los legendarios	neutral
Hoy se acaba la fiesta m√°s bonita del a√±o! #√∫ltimod√≠adenavidad #bajadadereyes‚Ä¶	positive
Pobre ilusa yo, pens√© que me har√≠ais algo de caso por una vez	negative
@user @user Adem√°s cuando dice que se casar√≠a con Ash  o cuando visten de yukata juntos en el festival ayy	neutral
"""No tenemos la sensaci√≥n de ir a un trabajo"", din os @user  Eu na ofi lendo o @user, tampouco a te√±o  http"	positive
@user @user @user @user @user @user Triste q nada cambie para las mujeres en pol√≠tica en 30 a√±os	negative
Tambien subire el changelog a lo largo de estos dias, estaros preparados porque viene todo de golpe!	neutral
@user Tambien un buen domingo para ti Fercito, y que tengas una linda semana amigo lleno de aventuras , Saludos de mis t√≠as	positive
Yo no me la juego con las mierdas de la suerte, ya tengo muy mala suerte como pa jugarmela	negative
¬øOs apetece un directo hablando del partido y un poco de la jornada en general? Si veo muchos likes en este tweet me animo	neutral
@user @user @user las tengo pero a√∫n no las he le√≠do. Caer√°n prontito	positive
Vengo hasta Carabanchel para estudiar pero la biblioteca esta cerrada	negative
Ser√© breve: quiero yuquitas y por mi chamba no venden	neutral
@user ¬°Enhorabuena! Eres la ganadora del sorteo,escr√≠benos por mensaje privado para darte el premio	positive
Era a la 6 que me quer√≠a levantar, no a las 5:15 con el ruido de una hijueputa licuadora gracias al descerebrado de mi primo	negative
El era como un profe de ingles gratis para mi , noooooo #VideoMTV2016 @user	neutral
Y se acab√≥ El Oso el Tigre y los dem√°s fue bueno mientras dur√≥	positive
Es que por las noches en mi cuarto y mi sobremesa me angustio sab√©is  Me vengo al sof√° con el port√°til y el ventilador y eso	negative
@user Yo estoy valorando Movistar. Son careros, pero tienen buenas ofertas para el primer a√±o. Y luego ya se ver√°...  @user	neutral
me encantar√≠a mucho tener una buena c√°mara y saber como usarla a la perfecci√≥n	positive
Cuando contrato 500mbs extra y llevo consumido 3 Gb JAJAJA cuando vea la factura no habr√° tanta risa	negative
Casi me quedo dormido en el bus hasta Trujillo	neutral
@user gracias por tu atenta y puntual bienvenida al curso online. Va a ser un placer trabajar contigo	positive
Quieras o no, vivir rodeada de mar, te influye.  Paso un par de semanas sin ir a la playa y ya me hace falta.	negative
@user MEMEO AJAJAJ Pues yo llevo.. 3 a√±os sin dar educaci√≥n f√≠sica	neutral
Estoy contenta, acabo de ver que los gustos que en alg√∫n momento transmit√≠ sobre una banda en espec√≠fica, ha llegado a otra persona m√°s.	positive
que te echo de menos cosa chicaa!   http	negative
"@user @user @user @user ...""futbolizando"" la afici√≥n auitomovil√≠stica."	neutral
Ey @user me gustar√≠a escuchar #UnMinutoSinDolor, nuevo single promocional de @user en #LaMejorVariedadMusical de @user	positive
Preferir√≠a discutir con un umpalumpa que con un (a) cristiano (a) conservador (a) de derecha.	negative
A un paso de darle una vuelta completa a nuestro sol Lov u @ El Tiz√≥n	neutral
Una pizza. Una conversaci√≥n amena. Amigos. Buena noche	positive
Massimo Bottura est√° en Am√©rica. Est√° en M√©xico. Y yo estoy aqu√≠, acostada en mi cama, sufriendoooo!!! Quiero conocerlo	negative
@user llego a saber que zafreo es igual a cerveceo y voy	neutral
Buenos d√≠as amigos de Facebook   ¬°¬°Volvemos a tener Granizados de‚Ä¶ http	positive
Soy la peor basura del mundo porque, justo hoy Andrea ten√≠a que verme con otra mujer, que mal me sent√≠.	negative
@user yo me mande a traer una XL por ebay y me queda enorme y eso que estoy panzon jaja	neutral
El d√≠a 2 tengo los ex√°menes, suena lejano pero es la semana que viene jajaxd	positive
Desesperada estoy, trabajar√© en cualquier cosa	negative
@user Hahahaha no me enoja. Solo juego aunque es cierto	neutral
@user ¬°much√≠simas gracias Blanca! La verdad es que es un plato f√°cil pero muy rico y vistoso	positive
Estoy segura que esta fue mi √∫ltima entrevista a Jaime Saavedra como ministro de Educaci√≥n. Vamos a perder un gran ministro.	negative
@user @user es que hablo de sus correos corporativos en sus PCs	neutral
Pens√© que los hac√≠as y compartias por aqu√≠ en plan espont√°neo, no que ten√≠as una cuenta espec√≠fica @user. Follow you now again  .	positive
@user porque si digo que quiero mam√≥n chino me dicen una vulgaridad	negative
Ay Dios he pecado, pero es que ese bikini estaba re lindo y necesitaba bronceador	neutral
Me voy ma√±ana para la playa, confiando que el sol me quite esta gripe tan horrible.	positive
@user Eso es antiguo ya	negative
No Dennis, no puedes cometer los mismo errores, es hora de cambiar y cometer nuevos errores	neutral
@user y si puedo trabajar en Madrid, Buenos Aires o Bogot√° yo ser√≠a tambi√©n muy feliz hihihihi	positive
@user Ll√©vales bibliograf√≠a! La evidencia en educaci√≥n m√©dica existe	negative
@user pero podr√≠as rescatar las cosas buenas que te pasaron √°nimos	neutral
@user que te vaya bien por Murcia mala persiana	positive
@user ooops cierto. Me mata @user	negative
√öltimo dia en Elche, ahora toca Benidorm	neutral
@user jajajaja yo creo que esa fue improvisto eh! muchas grasias hermosa!!	positive
@user pura vida. Ya llam√© pero fue como no haber llamado.	negative
@user Ya ves, parece un comic m√°s maduro pero el dibujo se delata solo	neutral
Tenemos nueva actualizacion en F1 2016! Muchos cambios y mejoras   http	positive
Me gustar√≠a que Movistar no me deje colgado sin internet despu√©s de haberme ido de Orange	negative
@user hmmmm no s√©, a√∫n las siento pegadas en el cielo de la boca	neutral
Segunda sesi√≥n del d√≠a y ahora ya voy notando la adaptaci√≥n    Muy c√≥modo  En ocasiomes hago‚Ä¶ http	positive
Estos d√≠as me encuentro muy d√©bil... espero que se me pase pronto!!!	negative
@user Cual es tu helado favorito y comida? Como te parecio Costa Rica cuando viniste y a donde fuiste? Sigueme pls saludos bye	neutral
@user Jajaja ah√≠ tenemos gustos diferentes pero as√≠ tb se puede hablar de todo  #TonyYSorayaEnMalaga	positive
@user pff... Cada vez tengo m√°s claro qje soy mura rara	negative
@user una gran oportunidad para que disfrutemos (con @user ) de su trabajo...	neutral
No hay nada mejor que ver el estreno de #RogueOne con la mejor compa√±√≠a	positive
@user yo lo √∫nico e puedo rescatar es T√òP y Coldplay,pero no tengo un cinco.	negative
2 meses que parecen una eternidad. no sabes como me haces falta mi querida abuelita	neutral
"@user Qu√© buena pinta.. se parece mucho a un ""suquet de rape"" por aqu√≠"	positive
@user Porque era el primer semestre y te daba miedo faltar. A ver si este a√±o nos abandonas menos.	negative
@user acabo de subir una foto con √©l, pero es el mismo nombre que mi twitter	neutral
Pensar en irse pronto a la cama y ver que dan 2 cap√≠tulos de #minorityreport la mejor manera de alegrarse la noche	positive
Como dice @user , se escapa otro verano en un furg√≥n blindado    @salaBBK #Bilbao #QuiqueGonz√°lez  http	negative
@user Exacto! Todo lo que √©l hace lo hace con el coraz√≥n y desde el coraz√≥n	neutral
Bueno, ya he montado la biblioteca y de no tener espacio, con ella me sobran huecos jajaja En unos a√±os estara llenita	positive
Con lo que voy a gastar compr√°ndome algo para halloween me compro una mudada y de paso la entrada en 5 mil	negative
mi hermoso @user esta que hace live en ig y no puedo ver me quiero morir queria un saludo para las @user	neutral
La final de @user esta esta muy interesante	positive
mi vida es una mierda primero me enamoro de un macedonio en ibiza y ahora del timbales de la panorama	negative
Estoy bien  Muchas gracias a aquellos que preguntais, el problema es que hoy no me dieron cita.. dijeron que imposible	neutral
Es que es taaaaaan bonito	positive
Pero tenemos fe en que el TEC sea igual de masoquista que siempre y nos haga ir a como de lugar.	negative
Miraflores dime que dentro de ti hay buenos polos	neutral
Recuerdo cuando le escrib√≠a a mi hermana @user para que me motivara y me hiciera sentir √∫til. Dios me dio a la mejor hermana	positive
@user @user jaja y por que lo peor, los juegos de Ubisoft no son tan malos, lo que si es un poco malo es ser solo de Sony	negative
@user no porque no los tienes activados a todos	neutral
La vida hay que verla de manera optimista. Hay que luchar, hay que ser fuertes ante todo.	positive
@user una especie de Titanic pero en versi√≥n cutre no?	negative
@user hola, te contamos que el incidente que tuvimos con el aspersor ya se solucion√≥ ¬°Te esperamos pronto!	neutral
Hoy fue la primera vez en 20 a√±os de vida que me com√≠ un Chifrijo jaja Sab√≠a rico, pero si el chicharron no tuviese pellejo ser√≠a mejor	positive
@user su madre s√© suicido y la encontr√≥ Chelo muerta	negative
@user FELIZ CUMPLEA√ëOS JULIAN Z ! q Dios te bendiga much√≠simo, un fuerte abrazo desde Huacho	neutral
@user Buenos d√≠as, un √©xito su maratonica, yo me sum√© y s√© que van a llevar mucha alegr√≠a a personas que est√°n sufriendo	positive
@user Me enamor√© de una bruja, dos veces, es que no hay tanto gato so cansino	negative
Ojal√° todos tuvieran un techo y comida y pasar una buena noche buena	neutral
Recibir este nuevo a√±o en familia es lo m√°s bonito y con un coraz√≥n agradecido por tanta bendici√≥n de nuestro amado Dios. #Feliz2017	positive
Ha muerto mi profesora de volumen/escultura y en serio que bajonazo	negative
@user No lo soy lemado	neutral
@user que yo soy fiel t√≠o	positive
@user ni siquiera llegu√© para ver las competiciones de R√≠o en directo, solo las barras asim√©tricas de Aliya	negative
¬°Hola @user! Una pregunta? La visita a la f√°brica es gratuita o hay que pagar algo? Un saludo bonicos y bonicas mios!	neutral
@user esa est√° genial en serio, vamos, vamos un d√≠a	positive
Ya se que soy lo peor pero jo	negative
@user somos dos! jaja ahora eres Mart√≠n? oye voy para Lima el prox mes, para el reencuentro d la u, avisas si estar√°s por esos d√≠as	neutral
Algo bueno que le puedo encontrar al incendio de Villava es que esta tan cerca del Instituto... seria una pena que se quemase...	positive
El problema de las ofertas ahorita, esque no lleg√≥ al m√≠nimo para regalarle a mi amigo secreto. Y siento que lo voa estafar	negative
-Amor 1:02 : Acabo de ver a mi hermana con su pretendiente -Camila D√≠az 1:03 : uyyy no te exhaltes es normal jaja -Amor 1:04:Casi le pego	neutral
@user se habia puesto octavo pero en la √∫ltima vuelta se ha puesto 4	positive
Tan desesperado que hasta stalkea	negative
@user Yo tengo un par, pero son s√≥lo R	neutral
@user Es una buena forma de dar la bienvenida a mi casa	positive
me cago en dios ya no soy teen el cumplea√±os m√°s triste de mi vida	negative
Me recomendais alguna silla gaming buena please	neutral
@user tengo que hablar todav√≠a con las librer√≠as pero a ver si cae la primera este mes ya  @user	positive
@user una oleada de cosas hom√≥fobas d√≠as anteriores	negative
me olvide de un peque√±o detalle y ahora debo ir a Wong	neutral
@user @user @user @user @user felicidades chicos !!nosotros como vuestros fans estamos super orgullosos	positive
Tan s√≥lo es un mal d√≠a no una mala vida	negative
Que ganas de cagarla y decirle a mis pap√°s que no se qued√≥ donde una amiga si no donde su nuevo novio	neutral
@user ahh ya ya jajaja. Bueno, buenas noches, que descanse	positive
@user Yo mismo quiero hacerlo pero muchas veces me da pereza y me enfado conmigo mismo	negative
@user oye pero es carbohidrato	neutral
Soy muy poco cari√±oso pero el amor esta	positive
@user hoy te he visto (y tu a mi) y no me has saludado, mala gente  (no te dije nada porque ibas acompa√±ada)	negative
Todos vamos a ser puteados ma√±ana, bonita Navidad eh #despedidos	neutral
@user La vida nos lleva por caminos inextricables jajaja Me alegro de que te haya molado el programa de hoy	positive
Mi imposible quiere irse a Europa. Yo ten√≠a peque√±as esperanzas sabiendo que era imposible, pero ahora se las lleva para Europa	negative
@user pero no es lo mismo	neutral
@user que nos regales con capturas de imagen de tus actividades ya no es sorpresa. Lo sorprendente es que tienes inivitado!	positive
@user y vos tan sano	negative
@user @user Vaya. No hemos invitado a nadie, la gente sea ido metiendo sola a la conversaci√≥n.	neutral
@user @user @user @user @user soy la de atras JAJAJA me meo jo que foto mas chula	positive
Me cago en la puta ola de calor que est√° haciendo  haber si nos morimos	negative
.@user hola, envi√© un correo debido a que mi usuario est√° supendido. Quisiera me ayuden con el inconveniente. Gracias	neutral
@user en eso estamos claros, pero yo tengo fe en que los ticos somos solidarios cuando mas se necesita	positive
@user lo siento Juan ya sabes que soy hetero	negative
Yo todo feliz por recibir la orden patronal Y DE AHORA EN ADELANTE VA A SER DIGITAL	neutral
Tengo hora y media libre en Heredia.	positive
por qu√© el concurso de #SoyJustDancer es solo para espa√±a? @user	negative
@user @user ¬°Hola, Irene! Para que la participaci√≥n sea v√°lida tiene que ser a trav√©s de Instagram	neutral
@user @user Bien! Yo no se que tiene el mundo en contra de la tercera generaci√≥n  Mi fav es la primera pero merece la pena.	positive
@user @user mis amigos hablando jodes .... K bonita amistad	negative
. @user necesito el libro de @user. Y tambi√©n esa obra q os comento que no acabo de localizar. En breve, pasar√© a veros	neutral
Buenos dias, vamos a hacer algunos recados y a empezar el dia con energia!!	positive
@user ni tu como soportas el calor sevillano hija m√≠a	negative
El viernes dejo de ver a muchas personas por un buen tiempo y ah la	neutral
Buen partido a todos @user , suerte en la final de losers y a ver si nos volvemos a ver en la gran final. Saludo a esos casters	positive
Ahora que estoy en Madrid casi no puedo hacer fotos chachis, solo a mi careto y no	negative
A las 17:30 pillo el bus	neutral
@user Pablo de d√≠a y Paula de noche  Aqu√≠ me ten√©is. Un verdadero placer chic@s!	positive
@user @user @user lo mas gracioso es que diciendo esas cosas solo fomenta aun mas el odio hacia el feminismo	negative
Tres cosas para lo que no soy buena: 1- cocinar 2- maquillaje 3- cantar. Pero as√≠ me quieren	neutral
@user üëçüèª aunque mejor todav√≠a no tener caja tonta.  Desde que no veo la tele el d√≠a me cunde mucho m√°s	positive
@user @user ya lo s√©, pobre Uno  Te acompa√±o en los feels	negative
@user Seguirme es lo √∫nico que tienes que hacer.	neutral
@user Toca un tema maravilloso, porque sin dejar de ser ficci√≥n es algo que podr√≠a darse. Un Gran Hermano vol.02	positive
Terminar√°n odi√°ndome, como casi todos los padres que me conocen	negative
Camino a casa solo fueron 3 chelas	neutral
Hoy ha hecho un d√≠a espl√©ndido. En todos los sentidos.	positive
@user Pues tuvo que ser al ponerme el pijama pq √∫ltimamente uso vestidos largos. Tengo un ronch√≥n considerable	negative
@user igual Diana desearte una feliz navidad espero la pas√© muy bien con la familia Dios te d√© muchas bendiciones te amamos	neutral
amo el fanart de roe deer	positive
Menciono a Sof√≠a en cosas bonitas y ella me lo paga bloqueandome por wa	negative
@user me pasa exactamente lo mismo	neutral
@user Gracias primito, le har√© presente los saludos! Est√°s invitado si puedes vienes	positive
Este d√≠a sera, muy pero muy largo ..	negative
@user si , tengo q ver, para ir a la cl√≠nica tengo q pedir m√≠nimo 2 d√≠as de vacaciones xq ni carnet tengo y no tengo dias	neutral
@user Mira,as√≠ haces ejercicio JAJAJA	positive
M√°s le vale venirse porque hacerme ilusiones est√° fe√≠simo	negative
En pocos minutos empieza Combate!! Usa el HT #CbtHastaSiempre y com√©ntanos que fue lo que m√°s te gusto de tu programa favorito...	neutral
@user jaja ya veremos... Que siempre es mejor poco de calidad que mucho... Espero coincidir con los que quiero... Abrazo crack!	positive
hoy ha sido un d√≠a muy malo para mi	negative
Cada dia se acerca mas la navidad agamos que todos los ni√±os tengan un motivo x cual sonreir invitalo a tu casa buenos dias!!!!	neutral
Hoy por primera vez me ha funcionado el sad.	positive
Que triste que conozcan el Trap por esos artistas y no por el Trap genuino	negative
Feliz de ver a mis amigos felices #BuenaVibraAlFin	neutral
@user @user @user me lo pase genial	positive
Puto, PS4 pro se queda pillado( congelado), pensaba que era solo yo , pero no , ya son varios amigos que es lo mismo	negative
@user Muchaas!! Y algunas muy bonitaas! Pero es verdad que se tiende a interpretar los 40 principales..	neutral
@user bueno igual la ver√© porque el protagonista es muy guapo	positive
Mi consejo para sacar notas molonas es... ESTUDIAD y dejar de bajar tanto a cangas	negative
Quiero como tener carro para hacer todo r√°pido	neutral
@user no lo es, tranquila	positive
t√≠o q yo me acuerdo que me hice una foto s√∫per chachi saltando en la cama y no la encuentro	negative
La vida es demasiado corta para seguir las reglas...	neutral
√âl se ha ganado un lugar especial en mi coraz√≥n.	positive
@user jajajaja la tuya y la d mucha gente seguro!! Pero yo no puedo sin mi melena me muero	negative
@user @user @user es que es una reivindicaci√≥n muy de moda... Ya sabes... de gente pedante como yo	neutral
@user Mis Felicitaciones para Usted Se√±or Presidente. Su mensaje fue muy bueno, firme y directo. Mi familia y yo le mandamos saludos!	positive
@user ultimo dia hoy? Nooooo  que yo iba el miercoles que vuelvo de las vacaciones.	negative
Siempre ando metida en google buscando im√°genes lindas  si me encanta. de lo que sea me gustar√≠a que sean solo para mi pero no se puede	neutral
@user @user claro jeje lo que sea ser√°, siempre ah√≠ que ser positivo y tener una sonrisa	positive
@user que me quiero poner las pulseras en la mano izquierda para que no me molesten al escribir pero	negative
Vamos a trabajar m√°s en ello No puedo volver a ser una persona flem√°tica	neutral
@user aah Ok! Pues est√° genial porque no da sensaci√≥n de estar encerrado	positive
16 chocolates Ferrero no fueron suficientes, pa la pr√≥xima ojal√° me regalen la de 54	negative
Dicen que Twitch va mal hoy, pero a√∫n as√≠ os pondr√© stream en 20 mins	neutral
Que GUSTAZO me da que Espa√±a le gane a B√©lgica en su puta CASA y encima con goles de un CANARIO !	positive
@user muy underground ya mano	negative
¬øUn poquito de DB pel√≠cula 4 en catal√°n? Nueva lista en nuestro canal de YouTube   http	neutral
@user la segunda! Of course! Con ese ritmo me imagino que estar√° genial	positive
¬øCu√°ndo se dar√° cuenta Apple que su navegador #safari no es competitivo sin extensiones?. MOZ no tiene extensiones para safari	negative
#SumateAlSi  Que as√≠ sean los futuros ataques en Colombia...  http	neutral
@user es un gran, gran tipo  @user	positive
Mi m√≥vil no me deja abrir los grupos y tengo unos 600 mensajes as√≠ de regalo	negative
Eso s√≠ voy a ir muy muy lenta	neutral
@user yupiiiiiiiiiiiiiiiiiiiiiiiiiiiii!!!!! es que no os puedo escuchar todo el programa y as√≠ os disfruto en mis ratos libres.	positive
"Ya tengo fiebre de nuevo y mami ""se puede tomar una pastilla hasta las 12"" valdr√© verga hasta esa hora"	negative
alguien que me de alg√∫n plan guay pa el lunes?	neutral
Me acabo de dar cuenta de que hoy un amigo duerme l√≠der. Enhorabuena @user y que ma√±ana sigas as√≠	positive
Mi profe de comunicaci√≥n se parece a la profesora Umbridge. Yo s√© que en el fondo es malvada y nos quiere ver quedarnos.	negative
@user el resto puedo dudar pero de ese grupo lo tengo claro	neutral
Amnesia ‚ú®  Terminas de verlo y no tienes npi de que has visto  Los protas son re lindos üåö Esta bien la verdad üëå http	positive
La lluvia definitivo que no me tiee piedad cuando ando en bus	negative
Me he en encontrado como 8761653729751528763 Colombianos entre Lima y Nasca, Per√∫.	neutral
@user Denada  porcierto hazme un hueco en tu agenda de combates quiero ver lo que es capaz tu monotype contra el mio	positive
@user Dios por mi le dar√≠a todo mi dinero pero no tengo y soy menor no tengo tarjeta de PayPal Dios que mal la debe estar pasando	negative
Quiero comer algo rico pero no hay con quien salir #foreveralone	neutral
Qu√© bueno que las aprovecharon @user @user	positive
Un gilipollas se me ha cruzado entero en una rotonda  y ya le estaba viendo que lo iba a hacer	negative
@user si o si regresaras a Per√∫ baby! Es m√°s, cuando leas esto es probable que est√©s aqu√≠ ya #PorFin	neutral
@user Me los pusieron hace bien poco en casa de un colega, le dan serio	positive
El primer a√±o que empec√© a vivir lejos de mi casa mami me llamaba todos los d√≠as, ya no, se pasan los d√≠as y nada, el amor se acaba	negative
No pude con mi genio y voy a almorzar. Para colmo combinado de pollo con gaseosa	neutral
@user mejor as√≠, que solo un grupo selecto lo sepa	positive
La gente se descojona de mi cuando me indigno y no se lo toman en serio	negative
@user he dicho acabadas  Better Call Saul saca en 2017 otra temporada	neutral
@user @user ha sido genial conocerte maite te quiero mucho en serio una monada de chica	positive
@user Pero no es pan chino	negative
+ a veces se la ped√≠a prestado se molest√≥ y me la vendi√≥ para que no la joda. Ahora ella es la que m√°s la usa	neutral
Tuve un sue√±o muy muy lindo y hoy ando con todas las ganas	positive
Quiero que vuelva el invierno  y ponerme pantalones largos y chaquetas y sudaderas y abrigos, puto verano.	negative
- Amor, ¬øvamos a ver la vida secreta de tus muscotas? - Hoy no puedo BB - No tienes dinero no? - No - Misio de mierda.	neutral
@user @user @user mi profesor de instituto dice que he suavizado mucho el lenguaje. Con 16 a√±os era m√°s po√©tico	positive
@user Jajaja Y al s√©ptimo d√≠a descans√≥ (?) Que mal mae Lo siento	negative
@user los palitos no son bonitos, los puntos s√≠ #sutileza	neutral
Cada vez que veo a esa muchacha est√° m√°s guapa	positive
@user en Espa√±a comemos (tragamos) de todo y con tod aqu√≠ esta trayectoria pol√≠tica parece normal. Saludos	negative
2da semana de talleres de naturaleza!! que nuevos retos vendran??	neutral
@user bueno felicidades por el millon de crack que hay en el canal !! soy un suscriptor ya un poco antiguo a por mas DE PERU	positive
tio pero cuando dawn dispara a beth y daryl la dispara a ella inmediatamente y se pone a llorar	negative
@user @user no tengo cat√°logo de modelos de polvos azules amiga	neutral
@user Efectos pr√°cticos. Aprovechar el desorden del rival. Lo hacemos todos	positive
La lluvia definitivo no me tiene piedad cuando ando en bus	negative
Lo bueno que m√±n acaba sus finales	neutral
Feliz por las salvadas por el p√∫blico y la salvada por el jurado canta dms bien pero la veo como solista, Aimee era m√°s para #LaBanda	positive
C√≥mo me desean feliz navidad si trabajo en 3 horas (?)	negative
em diez d√≠as hace dos a√±os desde que elsa tenia el pelo rapado por un lado	neutral
@user A m√≠ me haces un favor, encantado  @user	positive
@user Pobre   Pues aqu√≠ me va, atendiendo llamadas en la porter√≠a del colegio cual recepcionista telef√≥nico	negative
Queda claro que yo solo vivo para viajar~ No necesito casas ni propiedades, solo necesito boletos de avi√≥n y mi mapita	neutral
No me niegues, Se√±or, tu misericordia; que siempre me protejan tu amor y tu verdad. Salmos 40:11 Buen d√≠a a todos	positive
dios acabo de recoger mis libros pa segundo de bachillerato y el de historia de espa√±a y el de geograf√≠a son jodidamente gordos	negative
Ya cambiaron al modelo d Paco Rabane. el que estaba antes era un mu√±equito yico.	neutral
@user pues no, algunos lunes son maravillosos...por ejemplo el de hoy! üòú Hasta ma√±ana!	positive
@user Bueno, al Atleti 2014/15 Juve Olympiacos Malmo, 2015/16 Benfica Galatasaray Astana. Ya tocaba un a√±o serio eh...	negative
@user ay, ayer cuando lo publicaron y lo vi me entr√≥ un sentimiento m√°s grande por dentro...	neutral
"@user @user @user @user  ""la Temporada"" era muy prestigiosa. Recuerdo leer las cr√≥nicas en las revistas espa√±olas."	positive
Oye, me ten√©is un poco abandonada  http	negative
Decidme que al final de la gala dir√©is , QUE COMIENCEN LOS JUEGOS DEL HAMBRE! que al final solo quedar√° uno  #Gala1GH17	neutral
@user Los m√°s buenazos, son los medio gruesitos y cortados de forma vertical. Seg√∫n yo.	positive
@user Pasa el link de la mas interesante please, por no ver 5 veces lo mismo	negative
@user @user @user vi ese video hace un tiempo me pareci√≥ chevere . Pero no me gusta la canci√≥n	neutral
Hoy pasaremos una hermosa tarde con ellos #ShowNavidad #CasaHogarMam√°Victoria	positive
Mis anteojos est√°n demasiado flojos y eso que tienen meses de comprados	negative
La profesora se pregunta qu√© pasa con la segurdad jur√≠dica, y yo solo sigo pensando en qu√© culpa tuvo Fatmagul	neutral
Mi beb√© primero reniega porque tiene hambre, y cuando ya comi√≥ un mont√≥n, reniega porque est√° muy llena. La m√°s linda es	positive
@user tanto tiempo sigui√©ndote y leyendo las cosas bonitas q pon√≠as y ahora ya no me dejas?	negative
@user @user cualquiera dir√≠a que estamos deseando pasar fr√≠o	neutral
Que dicha que me vale todo lo que todo el mundo diga	positive
"Llevo como una hora repitiendo ""No deb√≠ haber bebido ese √∫ltimo Monster"" teniendo que madrugar  Mi vida."	negative
Necesito urgente entrar a la gimnasia y al gimnasioo	neutral
Hostia pero si en 15 minutos estreno canal!!!! OMG! El Almac√©n de Juegos. Bienvenidos jugadores	positive
@user @user @user Mas bien, penoso desconocimiento diversas realidades del Per√∫. Ahora anda preocupada x el cl√°sico(!?)	negative
Ya estuviera re descontrolado jajajajja	neutral
@user, muchas gracias. La verdad es que lo tienen f√°cil para acertar	positive
Pobre pablo  es que soy yo	negative
@user yo solo quiero hacerte trencitas	neutral
@user @user Pellegrino ha dotado al equipo una gran consistencia defensiva. Y buenos fichajes	positive
@user soy un hombre OCUPADO que no puede estar pendiente de estas cosas	negative
Quiero una caldosa y un granizado.	neutral
@user Pero la verdad es que en general no voy mal de motivaci√≥n... casi al rev√©s, me sobra motivaci√≥n (y ego	positive
@user @user Eso toca ma√±ana. Hoy me sent√≠a incapaz	negative
Desde hoy har√© mejor las cosas	neutral
@user eso mae!!! Que bueno que te gust√≥ el concierto, me alegra mucho!! A m√≠ tambi√©n me hac√≠a falta tocar esas piezas!!	positive
@user @user @user No puedo ver esas mariconadas.	negative
El quinto d√≠a #cousins #Holidays @ Previos Restobar-Pub	neutral
@user pues eliges bien lo poco que ves entonces querido amigo	positive
tengo un porrito ya liado.. pero no se para cuando	negative
Yo s√≥lo ame, y Di todo d mi..... aunque no soy perfecta, solo tengo un coraz√≥n sincero, una mente que te piensa a cada momento. pitufo	neutral
Se viene algo bueno #Navidad #Imelda #Tronconavide√±o #Fresas #frambuesas #blueberries @ Imelda	positive
a mi mejor amiga no le gusta el ceviche ni los makis y me siento frustrada porque no podemos ser BUENAS mejores amigas	negative
A pesar de todo...veo sorpresa en el Bernab√©u...llamadme loca	neutral
@user ..pero, vamos, yo con cualquier cosica..unos huevos fritos son un manjar (siempre que haya pan para mojar, claro	positive
Lo peor que puede existir es decepcionar a alguien que quieres	negative
@user jajajaja este es un plato del restauran de mi casa, cuando quieras tienes tu descuento familiar	neutral
Me hace sentir tan bien al ver a mi ex y no sentir absolutamente nada por el	positive
Me voy a las 6 a Madrid y me esperan 6 horitas en un autobus, seguramnete lleno de gente, porque mi suerte funciona as√≠	negative
Por qu√© un partido a las 10 a.m.	neutral
¬°Ya tenemos ganadora! Felicidades @user Nos hablamos por mensaje. ¬°Gracias a todos por participar!	positive
@user no seas malo con √©l	negative
El huevin respectivo debido al feriado...vao a meter una caminata mas sus chelitas para al menos ver que hay abierto en la calle.	neutral
Por cosas as√≠, estoy segura de que tom√© una muy buena decisi√≥n	positive
NUNCA dejen el Snapchat abierto en el celular de la mam√°, creo hoy duermo en la calle	negative
@user para m√≠ no son feas  hay feas y bonitas    te salvas de arder en el infierno por hetero	neutral
@user siempre habr√° algo amiga, pero con el tiempo lo superas y pierden importancia	positive
@user y que el mae no sea tan desastroso como aparent√≥ durante la campa√±a. Hope is all we have left	negative
El s√°bado se casa Adriel y eso me hace sentir super vieja maee cuando ibamos a pueblo viejo x olafos saliamos fuck off y yo era la ni√±era	neutral
Amanec√≠ lleno de la comilona anoche en el #BNOpenHouse ...pero siempre hay campo para m√°s . A desayunar	positive
#Windows10 qu√© mal me caes... @user Para abrir cualquier navegador o aplicaci√≥n es tan lento, torpe e ineficiente que da pavor	negative
No es feriado el 26 de dic ni el 2 de enero, entonces mremod f√∫tbol s√°bado y domingo	neutral
@user @user @user Gracias, lo √∫nico que me hace feliz es escuchar m√∫sica, adivinar y ganar	positive
Como cuando est√°s s√∫per triste y pones un playlist de Camila y Ha Ash . Los de la agencia se van a deprimir	negative
Digo yo que tengo mala memoria y mi vecino se ha tatuado el nombre de su mujer	neutral
@user @user cuando lo veo siempre le digo que en Twitter gusta a muchos!  Ojal√° accederia porque para Dani ser√≠a muy bueno	positive
Primera vez que David cena en mi casa y quiebra un vaso.	negative
@user me siento triste amiga	neutral
@user claro que s√≠, Par√≠s merece mil visitas	positive
No vuelvo a New York, esa pea fue muy maldita y mi chaqueta	negative
@user yo quer√≠a que me dieran la bcr as√≠	neutral
El puente mas bonito de la constituci√≥n este a√±o en Alicante 12,13 y 14 @user en directo y all√≠ estar√©	positive
11.46PM y tengo hambre, mejor me acuesto ya por que la panader√≠a est√° cerrada	negative
@user poco pero intenso  estoy por pirarme un d√≠a a sevilla con el Mario	neutral
@user @user Un lapsus advertido gracias a @user y subsanado. Gracias por tu aportaci√≥n.	positive
@user no lo consigo  ayudame porfi que es super importante	negative
@user No se si est√°n editados.	neutral
@user Correcto! Es pura arte. Mejor no lo pudiste describir. Felicidades!!! Bendiciones!	positive
@user @user Por desgracia vende m√°s  ,ri√±as,trifulcas,peleas,al cuello!! m√°talo!!	negative
@user Lo mejor para el es que salga del Club Zidane no le da la Oportunidad de Jugar! A mi no me gusta que este en la Banca.	neutral
@user es la feria de mi tierra  Solo espero que sea un √©xito y ser un gran anfitri√≥n	positive
No, no. Ya no te quiero, me declaro soltera a partir de ahora, me has hecho da√±o  @user	negative
@user hombre!  Yo siempre y con la gente que me cae bien claro, con los que me caen mal ni agua  Muacc	neutral
Plan perfecto para terminar el fin de semana. @user - @user. Despu√©s @user - @user	positive
@user ya ya pero a√∫n as√≠ no me convenci√≥	negative
Vine a mi casa porque mis pap√°s dicen que los tengo abandonados y me chantajearon con comida pero hoy iba para la playa en la noche	neutral
Hoy recib√≠ una buena noticia y llevo saltando de la emoci√≥n como 30 minutos.	positive
Mar Negro q se haya ca√≠do un avi√≥n lleno de m√∫sicos, m√©dicos q enviaron para alegrar a la gente en Siria me deja +segura q no existe dios	negative
@user las etiquetas son necesarias. Lxs locxs molamos. Si no quieres etiquetas no molas  LOOOOCAAAA jajajajaj	neutral
¬°Venga va! A ver si consigo la versi√≥n f√≠sica, que vista en tienda parece magn√≠fica  @user  #Dinast√≠aDelDienteDeLe√≥n	positive
¬øpor qu√© os empe√±√°is en que no soy espa√±ola?	negative
Amiguitos, yo siempre hablo/escribo de la misma forma, soy bastante cari√±oso ... no te estoy gileando, ni quiero algo contigo, s√≠?	neutral
Me vengo dando cuenta que s√≠... el gordo navide√±o y yo siempre s√≠... regalo de santa, por despistada? marchamo y regalos pagados #gracias	positive
Hay videos que no se env√≠an porque no tengo espacio en el m√≥vil as√≠ que lo siento	negative
@user @user El tuit va acompa√±ado de una foto que quiere decir lo contrario, S√ç es sarcasmo	neutral
@user ay tan lindo amigo!! Gracias. Espero que jueguen con rencor, porque se hacen imparables cuando est√°n resentidos	positive
Tan triste mi vida que me hablan en Snapchat solo para decirme que mis animales son lindos	negative
A recuperar la resistencia f√≠sica, hola Viernes sangriento!!!	neutral
@user siiiiii t√≠o  el viernes te invito a una litro jurao	positive
@user jajaja ya ves teneis algo encontra mia  espero que la proxima vez sea de vuestro equipo üòÇ	negative
@user Y suuuuper diferente a sus trabajos anteriores! Tengo que comprarlo tho porque no esta disponible en apple music	neutral
#DiaDelVideojuegoHC por todas esas grandes tardes que nos hacen pasar y las que pasaran!	positive
@user Ya no es por bonito o por feo sino porque es un animal con sentimientos t√≠a es horrible	negative
@user Feliz A√±o Bella! Las mejores vibras	neutral
@user esa vidilla universitaria que tiene lo hace muy especial y que bien se come cerquita de los canales  #SaltaconHolanda	positive
@user pero es muy trillado	negative
@user ten√≠a pensado cuando me quitase este ponerme unos de kpop  a la siguiente contigo lindo	neutral
Acabo de comprobar en Linkedin  si eras mi antiguo alumno, tengo un gran recuerdo @user  Te deseo lo mejor @user	positive
Me he puesto nervioso por la funci√≥n de ma√±ana. Y si me da una laguna mental??? Mierda ahora no puedo dejar de pensar en eso	negative
@user @user Ufff... hay una discusi√≥n enorme sobre esto. La Cl√≠nica Mayo dej√≥ de hacerlas por a√±os por los resultados	neutral
No se cuantas veces la abre escuchado, pero no me canso de hacerlo y es que suena tan bien juntos @user  http	positive
@user hoy me he gastado 90 euros en LEGOs, as√≠ que los maletines van regular	negative
@user ll√©vame a tu casa, la otra vez blastoise y hoy dragonite	neutral
@user retiro mi calificativo ofensivo hacia @user Su gesto de hoy me ha parecido valiente...  contamos con todos.	positive
Hay algunos shojos de comedia rom√°ntica que me gustar√≠a que se centraran un poco m√°s en lo rom√°ntico	negative
Yo ya estoy con gripe y ni me he mojado	neutral
@user el pueblo crema est√° feliz con lo de Vento!	positive
hoy ha sido ver a un perro muerto en el anden izdo. de la autopista huelva-sevilla y entrarme toda la impotencia del mundo	negative
@user @user A mi Movistar me llama para preguntarme si estoy satisfecho con mi servicio y si hay algo que puede hacer por mi	neutral
@user Buen art√≠culo Carlos , se va Lucas pero tampoco hay que dramatizar , casi me haces llorar	positive
Vanessa ¬ødonde estas? te extra√±o mucho, ya va ser navidad y necesito verte	negative
1 y 2 correctas. 3, ni una.   http	neutral
Ustedes siempre han sido lo m√°s bonito de mi a√±o. Anita y Amaya	positive
@user @user al menos ya va ir preso, el tuyo sigue feliz de la vida plagiando textos	negative
@user @user @user convenciendo a mi hija mayor para verlo	neutral
@user Bonito rinc√≥n  ¬°Qu√© ganas de ver la nueva web!	positive
@user yo no soy normal	negative
@user es que ya no era necesario llamar ,ya sabiamos lo que espera ,la proxima sera	neutral
Que agusto se queda una despu√©s del Circuito termol√∫dico de  @user	positive
Ten√≠a m√°s de un a√±o de no usar Premiere Pro y no era tan mala editando... ahora lo olvid√© todo	negative
Cuando te enamoras de cada flaca que pasa. Chimbote era chevere pero no me quirro ir de trujillo.	neutral
Pues ya es oficial, curro nuevo y mejor	positive
Tengo dos orzuelos enquistados en el ojo izquierdo y me hacen la cara muy asim√©trica. Me veo raro	negative
@user lo de la comida le quita toda la parte negativa entonces, buenaso. Gracias!! Que te vaya super bien en tus finales	neutral
"@user perfecto!  Nada mejor que incitar a lectura. Ya me contar√°s que tal, es m√°gico. De esos para ""ni√±os"" que no son para ni√±os"	positive
@user Lo mejor son sus amiguitos defendi√©ndole dici√©ndome a m√≠ que pase p√°gina cuando es √©l el que no me deja en paz	negative
@user Ely todo bien? no se nada de ti u.u tengo n√∫mero nuevo!	neutral
Si necesit√°is un hater profesional de lo que sea, pod√©is llamar a @user	positive
@user porque mi equipo G8 se calienta demasiado y la bateria se baja r√°pido	negative
"@user Un chivi que hace videos y es m√°s toc√°ndose el cabello que video haciendo ""algo divertido o entretenido""."	neutral
@user te tienes que hacer amiga de peluqueros que no est√©n locos y fuera, tienes don de gentes co√±e	positive
No entiendo, hasta hace unos d√≠as te hablaba lindo, fresh y de la naaada cambian, y t√∫ no hiciste nada #Kheeeeeeeee√© #SacandoConclusiones	negative
@user vamos a juntos en concierto?	neutral
#FelizMiercoles porque hoy pase lo que pase va ha ser un buen d√≠a	positive
"Como dijo @user, ""hay que ignorar a los trolls"", despu√©s de a√±os us√© de nuevo el block, el m√°s pesado y bobo que conoc√≠"	negative
@user oh no te la debo negrito, lo lamento, prometo ir al pr√≥ximo kaos ir desde las 8 pm y guardarte cola	neutral
@user @user clado que s√≠. En serio, gracias por todo lo que nos has ense√±ado	positive
Me est√° entrando una depresi√≥n ahora mismo... ¬øPara cuando la m√°quina del tiempo? Que me lleve de nuevo al 29 de junio joder	negative
@user i lleva mucho sin actualizar? ahora sucede que me enamoro del fic y lo dejan abandonado	neutral
@user @user @user Ay yo no he visto la nueva temporada! Buena sugerencia	positive
@user Junto montas el unico dia que me llaman para tomar algo	negative
Mis lunes no volver√°n a ser iguales @user	neutral
"@user el canal de ""Global Talents"" suele ser r√°pido en subir actuaciones, valoraciones, previos, y resultados..."	positive
@user En vez de perseguir a corruptos y defraudadores, pretenden encarcelar a quienes cuestionan al poder con unos cuentos tuits	negative
@user no te preocupes ^^ como dije...ELF puede hacer lo que quiera, a mi solo me importa SJ	neutral
@user Y son m√°s de las 5 de la ma√±ana! Y encima ma√±ana vuelve a ser d√≠a de grabaci√≥n.. todo sea por dejar todo preparado	positive
"@user La burgues√≠a venezolana, los m√°s ricos, animando a la poblaci√≥n a colapsar Venezuela con la ""Toma de Caracas""  Triste."	negative
@user @user @user invitad√≠simo a hacer las cosas diferente, hay que involucrarse y dar espacios a la mejor gente.	neutral
@user Te puedes creer que te iba a poner lo mismo  Te quiero mi Nini	positive
No s√© si los maltrataban de verdad pero me dio penita ver eso No me gusto eso, no son objetos para que los traten as√≠. Me indigna tanto	negative
@user @user @user el tiempo promedio para ejercitarse, es de 1hr. Si quieres m√°s tiempo, la alimentaci√≥n tambi√©n cambia	neutral
En fin @user espero que recibas este tuit en otra realidad alternativa donde sigues viva porque ah√≠ no se acaba tu camino  ¬°suerte!	positive
Suerte nivel, llame a la pizzeria para pasar por una pizza y llueve cuando deje mis sombrilla perdidas	negative
¬øvoy o no voy a c≈ìur de pirate en madrid? es como a la semana siguiente de volver de mil√°n/burdeos	neutral
Gracias a toda la gente que dio RT a mi mensaje de buscar clan. He conseguido ser suplente adc en DragonsZGaminG,con ganas	positive
@user Es muy duro para un ni√±o verse forzado a ser parte de esos procesos	negative
@user gracias por etiquetarme, pero no suelo hacer estas cosas	neutral
#feliz septiembre..es bonito retarse..es increible lo mucho que puedes aprender.. medirse con el obst√°culo..eres la joyita de la corona	positive
@user s que habr√° terceras elecciones, no que no las habr√°... est√° dif√≠cil la predicci√≥n	negative
@user No te preocupes, pero como hay tanta mala baba en Twitter pensaba que hab√≠a sido por eso	neutral
No, solo quiero bailarte la medusa loca en privado  @user	positive
No s√© porqu√© pero ya no me cae para nada, es m√°s me da asquito y antes √©ramos amigas, aunque creo que ni eso consideraba ella	negative
@user me regalaron la mediana	neutral
Ahora que soy @user todo es m√°s bonito.	positive
@user en donde vivo no hay alternativas v√°lidas a√∫n‚Ä¶ No creas q no lo mir√©  @user  @user	negative
@user de sobra, si solo somos 3  dime tu ID y ya te agrego	neutral
@user mi objetivo es seguir aprendiendo. Por dicha uno nunca para de aprender. Por ah√≠ espero seguir asombr√°ndome	positive
@user yo me las puse y acto seguido me las quite por que no era capaz de desbloquear el m√≥vil ajjajajja	negative
Vamos Ame vamos....bahhh.....q mas da.....conence el a√±o cansada..... quiero solo dormir hoy....	neutral
@user Muchas gracias atrasadas!! Esto del Twitter hacia que no lo miraba.... Un abrazoteee!!	positive
@user dejas al novio y a los dos d√≠as ya estas con otro.  Y yo soltero desde el 96. La vida es demasiado injusta conmigo	negative
voy a salir a comprar mayolicas y acabados a habich, veamos q sucede en el camino, la gente buena celulares prendidos porfavor, 3, 2 ,1	neutral
@user Much√≠simas gracias por difundir  ¬°Un abrazo!	positive
He visto un Allen Walker en la Expo que uff, menudo cosplay, yo iba de Lena pero sin peluca, quer√≠a una puta foto	negative
"Ya no puedo la broma de ""estoy embarazada"" por el d√≠a de los inocentes."	neutral
Que guay que @user sea nuevo concursante de @user seguro que lo hace genial....Me encanta!!!	positive
@user impresionante lo que hizo Alejandra por Dios que feo que se hagan de rogar pa competir, falta de humildad. Vamos rojo.....	negative
@user @user De nuevo, encantado. Y a mi tampoco me gustan esos titulares tendenciosos. Pero tampoco los opuestos  Saludos.	neutral
Es incre√≠ble que ahora entro a wpp solo para el trabajo	positive
Era mas el ambiente chungo	negative
Empieza la semana con la ilusi√≥n de saber que va a ser m√°gica, llena de momentos felices, sonrisas, miradas y mucho amor. Que as√≠ sea	neutral
Por fin r√≠o, caray. Despu√©s de lo de ayer, pens√© que me iba a deprimir, pero hoy estoy feliz	positive
@user Cre√≠ que era el Almost Blue de Chet Baker. Qu√© luzfloridecepci√≥n contigo	negative
@user por curiosidad intent√© en 5 bancos distintos y en todos declinado, pero mi reporte est√° en verde y mi score tambi√©n	neutral
@user si, muy hermoso, y eso que no me conociste a mi	positive
hoy es mi √∫ltimo d√≠a de vacaciones y lo m√°s emocionante de mi d√≠a ha sido hacer el puzzle de sunggyu	negative
@user ¬°Enhorabuena! Has ganado el KIT, escr√≠benos por mensaje privado para decirte c√≥mo te vamos a mandar el premio	neutral
Ensalada de Salm√≥n, una de las ricas propuestas en el men√∫ de hoy   #MenuDiario #RestauranteCasinoLasPalmas http	positive
ojal√° justin subiendo una foto comi√©ndose la boca con sof√≠a para que os den por culo a todas	negative
@user eso dice mucho de √©l... as√≠ que nada, t√≥mate tu tiempo que cuando est√©s preparado, todo llegar√°	neutral
Aii,y que se me pasa felicitar a @user y no puede ser!! Muchaass felicidades Mara,espero que hayas pasado un d√≠a muy bonito	positive
Ayer me dieron una botella y le pegue un trago pensando que era yin o Fresca gracias marifer	negative
Desde ma√±ana me dedicar√© a estudiar y dejar√© mis sentimientos amorosos por otro lado	neutral
@user ¬°Enhorabuena! Eres el ganador del sorteo, escr√≠benos un mensaje privado para darte el premio	positive
@user pero el caso es que en Humanidades hay lat√≠n y griego y yo en mi vida he dado latin y griego as√≠ que me iria fatal en ellas	negative
11:11 que no me encuentre mal	neutral
Fue un bonito fin de semana cumplea√±ero : amigos, familia, torta, comida rica, juegos de mesa y muchas risas. Me siento bendecido y feliz	positive
@user ehhhhhhh ese no he sido yo, y lo digo muy en serio  hasta los cojones de que me roben mi puto identidad.	negative
Ma√±ana debuto en percusi√≥n para leones chinos, ya puedo dejar de ser una samulnorian frustrada. Aunque el traje de Samulnori es m√°s lindo	neutral
T√©cnicas Reunidas ya es una de las 10 mayores ingenier√≠as internacionales!  No sab√©is lo que nos alegra    http	positive
Quiero que en mi foto de carn√© en lugar de una fotograf√≠a de mi cara me dejen poner un emoticono de carita triste	negative
@user @user no s√© eso espero, y lo mismo que anulen eso de la prescribici√≥n de los delitos, no s√© si menciona algo de eso	neutral
Pero tambien ha sido el a√±o en el cual mas he viajado y conocido personas excelentes	positive
Me ir√© a dormir sabiendo que la √∫nica app de manga con la que leo no tiene actualizado ons	negative
@user jajajaja fui el primer fav de Od√≠n con cotill√≥n	neutral
@user En Octubre har√© cositas, un fuerte abrazo	positive
@user De peque√±o escrib√≠a con la zurda hasta que una profesora me oblig√≥ a hacerlo con la diestra	negative
@user jajajaja yo igual. La gente no sabe lo que se pierde	neutral
El amor incondicional es esa clase de sentimiento que busca la felicidad de otro ser, incluso a costa del suyo. Familia es quien te ama.	positive
Soy un chico muy perverso	negative
@user puedes ver el partido en directo en el Facebook de informe Bolorino	neutral
@user Hola Luis!! Vendr√°s a Barcelona a promocionar #TardeParaLaIra ?? Un abrazo crack y feliz d√≠a!	positive
@user @user @user todo el mundo es un poco racista, la cosa es mirarlo y arreglarlo, no negarlo si alguien te dice algo	negative
La √∫nica gran verdad, es que no terminas de conocer a las personas. #BuenDiaATodos	neutral
@user aww!! Gracias!!!! Muaaaaaaaaaak!!!! No me gusta el sol y estoy en plena auditor√≠a, pero la estoy pasando genial ‚Ä¶ Muak!	positive
"Recuerdo a un podemita al final de una discusi√≥n q me dijo en F ""y si nos tienen que robar por lo menos que sean otros""  #MarcaEspa√±a"	negative
Mi mam√° adopt√≥ una gata que dejaron botada al frente de la casa, si alguien necesita gatos me escriben, tengo 4	neutral
@user @user @user que buena noticia Roxi	positive
Despu√©s de una semana comiendo en M√©xico a un precio rid√≠culo... lo √∫ltimo q har√≠a es ir a la Feria Gasto-n√≥mica #lluviaencasa	negative
@user Espero llegar y encontrar esa impresora 3D	neutral
"@user es que apuntas lo que digo. Es cierto antes de empezar la liga dije que Llorente ""hab√≠a elegido"" muy bien"	positive
que cool todo mundo me deja en gris	negative
@user @user que feo tu corazoncito! Deja ser feliz a los dem√°s	neutral
@user  Ni en tus mejores sue√±os, te hubieras, imaginado, una encuesta con tantos votos eh.? jajajj cuando se moviliza @user	positive
No encuentro el mando de la tele y me estoy poniendo nerviosita	negative
@user en estas √©pocas no hay que decirle no a ning√∫n trofeo y es conmemorativo para todos los equipos que ganen en la jornada	neutral
@user yo te veo bonito	positive
Puede alguien acostumbrarse en 4 noches a algo? Porque me acostumbr√© a no dormir sola y ahora se extra√±a demasiado	negative
@user @user yo iba a preguntar lo mismo	neutral
Despues de trabajar duro me merezco mis caprichos	positive
Esperemos que todo empiece a tirar para arriba porque se necesita mucho para despegar un proyecto asi, y es el unico miedo que tengo	negative
@user buena idea, anis, pero ellos saben que yo ni un pancake puedo hacer bien	neutral
Cada vez que veo a los gemelos por la tele me entran ganas de meter mi brazos en ella y darles un abracito	positive
Hoy va a ser el t√≠pico dia en el que me estreso	negative
@user Tod@s deber√≠amos llevar en nuestro d√≠a a d√≠a, est√° frase, ya q tod@s somos inmigrantes en alg√∫n lugar.	neutral
#felizcumplemichi pasala bien con tus seres queridos exitos en todo en lo k te propongas y exitos en #Bioquimica tambien ) si se puede	positive
@user fresquita... lo √∫nico malo fue que nos quitaron el banco bueno	negative
Mi familia ya empez√≥ con villancicos a todo volumen 24/7 y yo que tenia mi musica puesta y me la quitaron	neutral
@user hola vengo de intagram  en verdad ya te seguia pero hola igualmenteüôÑ‚ù§Ô∏è	positive
@user se nos queda peque√±a, s√≥lo 300 de aforo	negative
Haikyuu deber√≠a tener alrededor de 4400 cap√≠tulos para vivir feliz hasta los 95 a√±os	neutral
me siento orgullosa de ser tu fan @user desde hace muchos a√±os ...ese speach lo dijo todo te sigo admirando	positive
Me largo de esta red social por unos d√≠as, hasta que encuentre paz	negative
@user podemos usar el t√©rmino.equipo pepino	neutral
@user @user no, si pagar le pagaba bien, tranquilo	positive
@user creo que soy la √∫nica que pringa trabajando todo el verano y todo septiembre	negative
El d√≠a del hombre pas√≥ desapercibido por las mujeres, si fuera al rev√©s no nos perdonan	neutral
@user jajajajajaja me meo que yo tengo mi novio y √©l tiene su novia y estamos los dos contentos	positive
@user @user y donde est√°n esos fiscales q los afinen bien un t√≠o mata 2 ciclistas en la puta calle q est√° pasando aqu√≠?	negative
@user √Ånimo, Jorge. Piensa en tus nuevas v√≠ctimas	neutral
@user Excelente, siempre me persigno cuando entro a uno	positive
Aah ya... Porque @user es el ser m√°s rastrero, ego√≠sta, infantil y GILIPOLLAS que existe en el mundo	negative
@user que no soy menoooor o si	neutral
@user @user bien sra presidenta, se predica con el ejm, muy bien!!!!	positive
Y ahora, volvamos a la realidad... ¬°ay Venezuela! Como me has hecho llorar desde lejos... con que tristeza digo que yo soy venezolano.	negative
@user es decir, que es por la tradici√≥n lo de decir esto, como muchas otras (arroz, etc), pero que no es tan big-a-deal	neutral
Por dicha no he le√≠do a nadie que diga que se exager√≥ con el hurac√°n. He escogido bien a qui√©n seguir	positive
Hola, me molar√≠a hcerme un cambio dr√°stico con mi pelo, lo que pasa es que no se hacerme lo que quiero y tengo que pedir ayuda	negative
Yo quer√≠a para navidad la jodida mascara de Buckethead, pero todos piensan que es un regalo de mrd	neutral
@user @user ya se no quer√≠a salirme de las aguas termales ma√±ana voy a Monteverde a ver que tal	positive
Quiero el pelo negro azulado y no s√© c√≥mo conseguirlo  los tintes de ese color que me he echado, no han hecho nada.	negative
@user @user nunca dije lo contrario	neutral
@user Ella es lo mejor de todo	positive
Buenos d√≠as bbs qu√© tal yo mal	negative
@user @user @user , y otros que seguro se me olvidan, tambi√©n os puede interesar para vuestro instituto o facultad univ.	neutral
Chema en esas y todos en la oficina deseando que vuelva a la oficina y a dirigir la empresa mejor...	positive
A ver cuando quedamos y hablamos de lo guapo que es nuestro se√±or Rajoy que ya toca  @user	negative
@user @user estas en lo cierto	neutral
Feliz Martes para todos.  P√°senla bonito y a sonre√≠r.	positive
.@user @user Las mayores atrocidodes surgen del idealismo bienintencionado. No me cabe duda de que son capaces de lo peor	negative
@user En edad internacional 19, en edad coreana 20	neutral
Viendo al gran #JoselitoYSuOrquesta en #WantanNight lindo jueves @user por @user	positive
Me he puesto a pensar una cosa y me estoy despollando sola en la habitaci√≥n. Que pena doy	negative
Ahora tengo que dormir llena de repelente	neutral
@user ¬°Es el mejor! Espero con emoci√≥n ese disco nuevo y deseo tener tiempo para digerir toda la discograf√≠a antes de morir.	positive
@user eso no es sielto	negative
@user Y que es muy bueno que alguien hable sobre el tema porque muchos no lo hablan debido a que es un tema considerado Tabu.	neutral
Mi anterior bio tambi√©n hablaba de #volar y esta noche ellos -y Twitter- me lo recuerdan...   #SoisGrandes üòò http	positive
@user @user yo ya estoy arruinada con tanto verano Berni	negative
Quiero un perro as√≠ porfiii.	neutral
@user Son dos frases. La una complementa a la otra. As√≠ se entiende mejor	positive
Me pongo al d√≠a con Re:zero en dos d√≠as y medio y ahora me dejan una semana intrigado por el final del capitulo. Esto no se hace eh	negative
@user Vieras que a mi lo del dresscode de mi brete no me molesta, s√≥lo quisiera poder te√±irme el pelo morado	neutral
"#2A√±osDeLegi√≥nHolk No importa que seas ""niu"" o ""old"" Si amas a LH , eres bienvenido a mi casa"	positive
@user @user yo ya en eso no me meto  sacar las cosas de contexto y llevarlas a tu terreno es algo diferente	negative
@user pero eso no es abstracto	neutral
Soy jodidamente feliz  Me encanta mi vida enserio, a veces no aprecio la suerte que tengo.	positive
Creo que alguien me ha bloqueado. Es una sensaci√≥n rara porque empezaba a tenerle cari√±o a esa persona y no lo entiendo. Me siento mal	negative
@user No te preocupes Yuya, te entendemos. Que te mejores pronto.	neutral
"@user dile a Alex que hay aceites para cuando te duchas que arreglan la piel como los ""codos"", ahora los tengo fin√≠simos"	positive
Han talado el abedul gigante que hab√≠a en la esquina de R√≠os Rosas con Castellana  ¬øAlguien sabe porqu√©? #Madrid	negative
Voy a cambiar mi vida, dejar√© de salir por un buen tiempo	neutral
"Las Palmas nuevo y modesto l√≠der de 1¬™ divisi√≥n empieza por ""L"" como Leicester...  #ah√≠lodejo"	positive
@user ah era hoy? ma√±ana durante el d√≠a puede llamarme y con mucho gusto a plena luz del d√≠a no en lo oscurito en barrios mierda	negative
@user desp√≠dete de todos, des√©ales feliz a√±o y bye bye	neutral
Se acaba un buen a√±o, y va empezar uno mejor, siempre con la.bendici√≥n de Dios	positive
@user no se si ser√© tan despreciable	negative
.@user ¬øMe dice garrullo, llam√°ndose Domingo? Esa es buena  @user @user @user	neutral
@user Ambientado tambi√©n en Italia, es una comedia sobre una serie de parejas y entuertos, con honor, clase social y mucho humor	positive
Soy el unico al que le da mal rollo la gente con gafas de sol? es que no sabes si te est√° mirando o no y pues	negative
Quiero entrar en alg√∫n grupo de WhatsApp feminista o lgtbfriendly	neutral
Lo mejor de la vida ver Skins	positive
@user claroooo o a varios solo que ya les vale ... PSOE roto etc	negative
@user @user @user @user @user @user Para explicar lo de los 6M nos pondr√° el profe documental de Youtube	neutral
acabo de hablar con alba y ya esroy un poquito mejor	positive
@user Pues espero que no lo digas por mi ni√±a o no voto mas  memeo, bueno cada uno tendra su opinion +	negative
@user y su canci√≥n: Se non te #VIDEO Publicado el 10 Nov del 2013 y aqu√≠ te lo compartimos	neutral
@user llego tarde, soy huge fan la empec√© en el 2000, crec√≠ con ella sube y cae tiene de todo como toda serie, temporadas favoritas...	positive
Muchos d√≠as de sol, calor y numerosos incendios. En Espa√±a hace mucha falta que llueva y parece que no queda mucho	negative
@user no las des, en serio.	neutral
@user con lo majo que eres	positive
Un√≠os a √©l en vez de venir a dar por culo a las feministas si tanto OS JODE nuestro movimiento	negative
y quiero ir de nuevo al Cosmocaixa	neutral
@user @user buena nana para dormir	positive
Cuando queres comprar muchas cosas pero eres pobre	negative
Si os interesa o teneis algun conocido que le interese el Airsoft. Vendo L96 (nueva) y G36. Mascara y mas cosillas. RT se agradece	neutral
@user @user Qu√© chulada! Mola mucho el post, chicas!	positive
Estoy sensible y lloro por todo y	negative
Quiero amigos que le gusten mis gustos musicales, ya tengo pero viven largo	neutral
@user T√∫ siempre sexy Nerea!! Qu√© tengas un maravilloso d√≠a! Besitos!	positive
@user a mi ya se me fueron los 2gb	negative
@user Lo pronunciamos pell√≥t as√≠ fuerte!! . Cl	neutral
Enamorada de Second to Last Love... Ver√© probablemente la japonesa luego.	positive
@user NOOOO omg siempre me pierdo los mejores fanarts	negative
Ay√∫danos a conocerte mejor para seguir mejorando  ‚úçÔ∏è  ¬øC√≥mo conociste #Microteatro?	neutral
D.O eres genial ...Feliz cumplea√±os y q sean muchos a√±os m√°s #E #EL #KPOp	positive
@user me perd√≠ esa encuesta, √∫ltimamente estoy mucho menos activo.   Pasad un buen rato en el directo	negative
@user illo que ya me han enviado 5 personas diferentes snpachats con palomitas	neutral
@user @user @user Nos encantar√° saber tus  impresiones sobre el libro. Seguro que Nora estar√° encantada tambi√©n.	positive
Entre todas las miles de personas a las que le pod√≠a haber pasado eso, ME PASA A MI -.-'	negative
Amigos, me sacaron la mierda hoy pero estoy feliz	neutral
Pr√≥ximo destino ......Londres  ,no puedo est√°s m√°s feliz ,ha currar al extranjero yupiiiii !!!	positive
JAJAJAJAJJA, me le cague por que si y listo ü§ò	negative
@user Hola , queria preguntarte si el nuevo cafe Chiapas, es el mismo shade grown porque voy a hacer degustacion pronto ...	neutral
@user @user buscando la mirada perfecta Roci	positive
"""Mae ma√±ana llego a las 10, cuidado te quedas dormida porque a las 10 estoy ah√≠"" -Liena, se qued√≥ dormida y no ha llegado."	negative
@user @user @user @user ohhh lo mismo! Tambi√©n con concierto, lo que no se, si ser√° el mismo	neutral
Cl√°sico d√≠a donostiarra para quedarse en casita con el f√∫tbol #Donostia #F√∫tbol	positive
Me quiero morir para no tener que aguantar esta puta calor	negative
FAV si crees que me gustan los penes (como no soy famoso y nadie le va a dar FAV pues tendre la consciencia limpia)	neutral
@user una de mis favoritas de tu galer√≠a, la luz que captaste es muy misteriosa adem√°s... me encanta!	positive
Y el da√±o moral que le hacemos a Amancio con nuestras cr√≠ticas? Seguro que est√° triste y no duerme bien por las noches	negative
Manuel Carrasc  -Uno x Uno me gusta  -Vale -Ok -ta luego maricarmen  -no me gusta pero, vamos a decir que lo respeto  -me se canciones	neutral
@user Otro para ti Javier, me ha hecho mucha ilusi√≥n tu respuesta. Gracias de coraz√≥n  feliz noche.	positive
Y sigan criticandome hablando paja de mi que yo seguir√© viajando y d√°ndome la vida que yo quiera.	negative
@user o compra fundas de m√≥vil transparentes y las pintas como una pokebola y hazes una pagina web donde las puedas vender	neutral
lo mejor de to es que me examino justo el dia de mi cumple pero bueno la vida	positive
@user Pero si t√∫ s√≥lo comes paellas-de-verdad, japo pijo yr a  cosas desas de subir a Instagram, homrepordios	negative
@user amiga siiii y la pobresa extrema sigue	neutral
Que graciosa va a estar la pretemporada	positive
vale acabo de ver algo muy desagradable gracias cris y buenas noches	negative
@user Quiero verte otra vez  vuelve ya de tu cvtre pueblo.	neutral
Como chiquito con juguete nuevo	positive
En pleno 2017 y hay servicios que s√≥lo se pueden utilizar con Windows...	negative
"@user @user @user @user ""Resultad Sobrevives"" lo de estar loco funciona"	neutral
@user As√≠ es un saludo desde Per√∫! La vida es mejor con un buen vino o un buen caf√©!	positive
Erito es una mala persona	negative
No se que est√° pasando conmigo ultimamente, pero extra√±o a toodooos	neutral
Hoy tuve un d√≠a muy lindo me chinearon mucho 2 amigos y el jueves uno que amo mucho.	positive
Utop√≠ audiencia estable, media de m√°s de 8'5 en Imdb etc... Pero fue cancelada. No se puede tirar tanto de la manta farmac√©utica	negative
@user Cuando veas una que te guste de color no negro tell me	neutral
Mira que cucada üòçüòçüòçüòçüòçüòçüòçüòçüòç Le he puesto hasta el lacito k llevaba el de ash  http	positive
Me ha explotado un vaso en la mano, que forma tan bonita de empezar el d√≠a	negative
@user  Que cabrones..... puffff  .... Bueno se empieza de nuevo no pasa nada jejej	neutral
@user @user @user @user Al final ha sucumbido el maldito a nuestra dura mano	positive
@user tienen muchos problemas de espalda, rodillas y tobillos  pero solo compiten hasta los 22 o as√≠. Con 22 ya eres viejo.	negative
siempre que intento ver una nueva serie en NF termino viendo stranger things.	neutral
@user alg√∫n d√≠a me mandaras un md y me dir√°s cosas bonitas como te digo yo  te quiero üò≥üíû	positive
@user Porque nunca nos toca un arbitro bueno? Hay alguno que sea bueno para el Valencia?	negative
Un meme de mi√©rcoles para un Per√∫ m√°s consciente #EsNiceSi retuiteas #YoCuidoElAgua	neutral
@user  Yo cuando pueda quiero tener el Omega Constellation,, con los num√©ricos romanos.	positive
@user somos m√°s felices sin ti	negative
La realidad es que ella ya no es mi mejor amiga	neutral
Fue muy bonito postular para el CEUP, hacer cosas que nunca pens√© que pod√≠a en cort√≠simo tiempo, de hecho me ense√±√≥ a organizarme. #feliz	positive
@user ya no tendremos el mismo	negative
Me encontr√© una tarjeta pegada en el cajero y llam√© al banco para reportarla, la due√±a puede estar tranquila #whatgoesaroundcomesaround	neutral
Ser el villano de la pel√≠cula es lo mejor	positive
En serio que feo ir al mall este d√≠a. Ma√±ana seguro estar√° peor.	negative
@user tendremos que probarlos y de paso hacer alguna video receta chicos  @user	neutral
Y los directos deber√≠an ser totalmente estables (ya que en Madrid sol√≠an darme problemas) Se vienen cosas chulas	positive
Muchas gracias queridos SPOILERS #TWD	negative
Ocupo ruedas nuevas para los patines	neutral
@user jajaja perd√≥n, la serie est√° muy buena	positive
Me retuitea gente que no conozco y sus amigos no tiene los mensajes abiertos y no s√© que haser	negative
Alguna buena moza que me diga a qu√© hora y qu√© d√≠as echan Teen Wolf	neutral
@user vente aqu√≠ a caceres y te llevo a un sitio donde ver√°s la luna preciosa	positive
"@user Qu√© f√°cil es quedarse calladito, bajarse los pantalones y no decir ni m√∫... Cu√°nta ignorancia en tu ""opini√≥n"". Saludos"	negative
Soy una atrevida ay  todos me lo dicen	neutral
@user @user ¬°Buen viaje! Hasta la pr√≥xima aventura  Un abrazo	positive
@user ugh siii, de lo peor	negative
Es tiempo de una nueva aventura	neutral
@user @user ¬°Permiso ninguno, por favor! La foto es de Miquel, y yo encantado de poder verla en mi timeline	positive
@user @user cabrooon siempre te acabas follando a mis novias/esposas!!	negative
Marca el valencia B el 0-1 en la DANI JARQUE, hay que decir que jugamos con 1 menos por expulsi√≥n m√°s que rigurosa de un defensor perico	neutral
@user Gracias a datos como esos, hoy d√≠a tenemos un mejor cat√°logo s√≠smico con datos hist√≥ricos	positive
@user maldito ataque de ansiedad tampoco lo soporto, es por eso que los dramas en emisi√≥n me hacen sufrir horrores	negative
Casi me aplasta un √°rbol pero lo bueno es que en la casa ya lleg√≥ la Navid√°	neutral
@user ya.. se le va, pero me gust√≥ igual  lo siento, sino.. BLME est√° bien adaptado o los libros de Sparks	positive
3 a√±os sigui√©ndote y ni una menci√≥n, con lo que te quiero  @user  #askalvarogango	negative
me llevo bien con los ex de @user jaja hasta jugamos pichangas @user #yosupereamiex	neutral
@user en francia prob√© un ramen de bolsa que era m√°s rico que Tokyo Ramen ll√©venme al primer mundo	positive
Todav√≠a son las nueveeee e e e e e e eeee Uf	negative
@user Yo he ganado recursos haciendo justo eso, demostrando que el colega us√≥ res√∫menes acomodados	neutral
Y en mi momento de alta autoestima/ego, les puedo asegurar que mi sonrisa se contagia  (en persona, obviamente)	positive
Que seriedad pues pap√°!! A ver el cabello con TINTE? Me da bien? MEJOR PREFIERO NATURAL! As√≠ me identifico	negative
La receta de la felicidad, es saber que quien no experimenta, crea, innova, no sera seguro de si mismo.	neutral
@user 2. Hace mucho tiempo hablabamos por skype por un amigo en com√∫n y estaba guay, adem√°s de que eres muy mona!	positive
Yo voy ciego y me vuelco a csa	negative
@user ese es mi estado continuo...	neutral
@user Slides preparadas !! (al menos la primera versi√≥n..	positive
@user ya pero 15 euros... Al final la pillare pero me quedo pobre ahora mismo	negative
Creo que pocas veces he estado tan enfadado como esta ma√±ana, pero bueno, entre Uncharted 4 y el ejercicio me han animado	neutral
Super Junior es un escape a todas las cosas malas que pasan en mi vida, es por eso que al apoyarlos no lo veo como una obligaci√≥n	positive
¬°¬°No a las agresiones sexistas durante y despu√©s de las Fiestas!!  #Sang√ºesa	negative
A ver que asi a lo tonto me quedan solo 2 dias en Galicia.	neutral
@user ... Buena elecci√≥n! Gracias por empujarme a verla antes que la saquen!	positive
@user pues es ego√≠smo, insolidaridad, y miedo. Aunque ya sabes que no ser√© yo el mayor fan de Podemos	negative
"""y recuerda que SIEMPRE ma√±ana ser√° otro d√≠a"" palabras de alguien que siempre estar√° conmigo"	neutral
Hoy est√°n participando muchas m√°s mujeres, lo que me alegra mucho. Ya sea para preguntas propias o para hacer preguntas por su pareja	positive
Tengo los labios super secos #anli	negative
@user con todas las cremas jajaja tmr tengo hambre jajajsjs	neutral
@user me has hecho llorar con tu video para Cate !! Que bello amor Lograste transmitir tus mejores sentimientos! Vibras para ambos	positive
@user Debi√≥ decirlo! No le parece chirriante que sea igual al texto de 7 Can√≠bales? Se lo digo desde el respeto.	negative
Estoy sola en un banco	neutral
@user @user No es perfecta, tiene sus cositas. Pero el balance es bueno, bastante bueno. Y claro, sales cantando	positive
Esta bien tener hermanos, siempre y cuando uno de ellos no decida ser subnormal perdido	negative
Buenos d√≠as y #felizmartes. Cu√°ntos de vosotros lleg√°is al final de vuestras #vacaciones? Y cu√°ntos las ten√©is a la vuelta de la esquina?	neutral
@user bueno, a veces es lo √∫nico que tengo, y hay algunos que merecen la pena	positive
Yo todo ilusionado porque he encontrado un disco duro externo en casa para meter toda la mierda del port√°til y es de dos gigas	negative
Lo bueno del fr√≠o es que puedo comer como siempre y echarle la culpa al mismo	neutral
@user Ojal√° mi Robbie Williams... Ser√≠a ideal teniendo una nueva era al caer. O Take That!	positive
üåº evan peters üåº  -casi siempre me equivoco y pongo evans peter  -dejadme -es muy sdasldjalsk	negative
Ayer inicie con mi proyecto de hacerme mi propia huerta	neutral
@user no te conozco, pero tras un vistazo en tw pareces guapa e interesante. √Ånimo, espero que puedas recuperarte poco a poco	positive
que cansado me tenes albacete... que cansado!!    sino vuelvo a rosario en verano........... ojo.	negative
Preparando la maleta, proxima parada #huelva #fiestasconamigas  üíÉüèªüëØüöÜ	neutral
@user Mis sentimientos y mi orgullo por el Valencia son muy grandes. Yo quiero lo mejor para el Valencia.	positive
"""√âl es raro, pero es hay q estar demasiado mal de la cabeza para querer estar con alguien tan da√±ada como yo"". -Yo, hablando con mi pap√°."	negative
@user sisi, xa lle vexo a cara ma√±an no examen	neutral
@user Ya lo ten√≠a fichado y tengo ganas de darle uso  ¬°¬°Gracias!!	positive
@user @user  #NecesitoElViajeAAndalucia bueno si un tal premio al mongol o algo as√≠, pero eso era malo	negative
@user Los equipos son igual de serios que en la liga que juegan	neutral
Hoy so√±√© que @user era mi profe de actuaci√≥n y fui extremadamente feliz.	positive
Que #Rajoy no logre la #investiduraRajoy NO ES NOTICIA, lo contrario s√≠... Pero ser√°n becarios los que est√°n en pr√°cticas	negative
@user uf ......qui√©n se atreve a juzgar .....yo me voy a dar una ducha fr√≠a	neutral
@user, experto en hacer reencuentros inolvidables since 1994	positive
A Piper no le gusta que robe en las casas ni a la gente, Piper se ha ido a la basura junto a alb√≥ndiga	negative
@user Faltan las canciones que cuando est√°s triste te hacen llorar y a la vez re√≠r cuando est√°s alegre	neutral
@user Va perfecto entonces, ¬°muchas gracias!	positive
La verdad esque por YT he hecho cosas malas y me arrepiento y pido perdon pero pff	negative
@user si conoces alg√∫n productor que quiera llevarse la obra, que se contacte con nosotros	neutral
@user ah bueno, eso duele menos que el dedo del pie heee jajaja calma calma... laura lo arregla	positive
New Balance podr√≠a dejar de ser el patrocinador de la Sele o sea, camisetas feas otra vez	negative
Va, aprovechad q estoy aburrido y de vacaciones, y me apetece dibujar tradicional, decidme un dise√±o de tattoo sencillo y mol√≥n	neutral
@user si al final acabamos hablando un rato, era muy simp√°tica  @user	positive
"Hoy me sent√≠ como grace de ""al fondo hay sitio"" cuando la atropellaron, solo que no fue de mentira y casi no la cuento que horrible"	negative
Yo con ganas de tirarle mi bater√≠a externa a @user para que no se le descargue el celular	neutral
Amo la nueva canci√≥n de Sof√≠a Reyes	positive
Ojal√° la capital este tan caliente como dicen esos q se quejan del clima caluroso!!!!	negative
@user Yo no te pido la luna solo pido que me toque la bonoloto, para salir de los problemas.	neutral
Ma√±ana va a ser un d√≠a guay	positive
Ma√±ana me sacan sangre y tengo que ir en ayunas. Dadme √°nimos ante esta situaci√≥n tan heavy que me est√° tocando vivir	negative
@user fui durante 11 a√±os comercial de una multi discogr√°fica y trabaj√© con Fnac. S√© lo digo.	neutral
Fin de la Misi√≥n #Lima-limon: Muchas gracias a tod@s por el cari√±o y por la buena onda!! El tiempo fue corto pero se repetir√° visita	positive
Silvia pesada deja de dar rt que me sale doble notificaci√≥n	negative
No me quiero ir bueno s√≠ pero no	neutral
@user buenos d√≠as, √∫ltimo d√≠a laboral, me voy a vacaciones una semana. √âxitos en sus vidas y que sean muy felices	positive
Casi siempre me hacen fotos sola y quiero fotos cuquis con gente	negative
Ya lleg√≥ Unidos Podemos, @user y @user acaban de llegar juntos al @user	neutral
@user no, llevamos una ruta pero nos dejan unos cuantos d√≠as libres, as√≠ m√°s c√≥modo, que voy con mi padre y pas√≥ de ralladas	positive
@user oye pero yo no soy tan burguesito sbs	negative
Igual no ir√© porque estoy m√°s ajustado	neutral
Perdon, las dudas en Twitter a traves de #askLFI  Las ayudas #ayudasLFI es una convocatoria de ayudas, muy interesnate tambien	positive
@user @user @user cabrones que sab√©is que soy pobre	negative
@user En ese caso, todo bien. Tengo derecho a equivocarme si su tweet es ambiguo Hahahaha. Saludotes	neutral
@user Se√±or tiene usted una invitaci√≥n formal a nuestra serie Mundo Chiquito. @user m√°ndale el contrato	positive
@user Capit√°n am√©rica, hipervitaminado, te he dicho ya que hoy no estoy feliz contigo?	negative
Jo, claro!! Estoy sin m√≥vil desde hace mucho, cualquier cosa ya sabes @user	neutral
@user Pero pero porque eres muy guapa	positive
@user Ojal√° que no Yo aun no entiendo bien qu√© motiva a Assange. Destrucci√≥n total?	negative
2:12 am, est√° semana he dormido 17 horas, hago examen de qu√≠mica a las 8 am y salgo del brete a las 10 pm	neutral
que bonitas mis ni√±as las amo tanto	positive
Fue la semana mas ocupada evershhh yyy no estudie conta yyyy no entiendo nada yyyy ma√±ana es el examen	negative
Im√°genes del verano en nuestra querida #Zaragoza.  http	neutral
@user Stranger y Mr. Robot ya las he visto, pero eres la segunda que me recomienda The get down, as√≠ que a por ella voy, gracias!	positive
Lo peor es que yo me march√© cuando @user se empez√≥ a relacionar con la gente de la disco, yo quer√≠a tomarme una copita con ella	negative
Yo solo quiero que me engria	neutral
Yo quiero m√°s lasa√±a de ayer! Cocinan rico donde me adoptaron ayer	positive
vos tampoco des fav que no me tenes contento	negative
@user yo soy totalmente puntual	neutral
@user @user Muy buenos d√≠as  Por cierto, ¬°muy buena la foto!	positive
tengo muchas ganas de mimitos, y sabia que pasaria y ahora pos  a ser fuerte o algo	negative
@user Disculpa, no estuvimos en Twitter  Si lo volv√©is a hacer no dud√©is en mencionarnos!	neutral
@user espero sobretodo tenerla con mi ni√±o  jajajaja. gracias guapa ‚ô•	positive
@user @user estoy cansado ya de salir a la calle y que todo el mundo me para para hacer fotos, esta vida es muy dura	negative
Aahhh bueno, gracias a todos por sus buenas vibras, s√≠ quede para el trabajo	neutral
@user me siento muy identificada con tus tweet y vi tu cuenta porque mi mejor amiga aveces da rt a tus cosas	positive
@user lastimosamente gran parte de entradas se ganaron los REVENDEDORES como siempre	negative
@user p√≥ntela y te das una vuelta por M√°laga porfa	neutral
El √∫ltimo d√≠a de trabajo, al fin	positive
Estaba dormida y me despert√© por un mensaje,ahora no puedo dormir.	negative
"@user  ""chatarra"" es a lo que llamas piezas de misiles de alta gama, bombas, cohetes, todas dise√±adas por √©l"	neutral
Y yo!! pero no soy famoso  Lugar muy recomendable y las de Colon tambien!! http	positive
Mi hermana y mi mam√° hablando con sus personas importantes y yo ac√° haciendo mi tarea de c√°lculo con dolor de cabeza	negative
@user empezando Python con @user emocionada	neutral
@user Tengo unas enormes ganotas de conocerte	positive
"""Bla bla bla...eres la mejor pero no te quiero en mi vida, bla bla bla.."" lo de siempre!"	negative
Y bueno las cosas llegan cuando no las dices..... recierto	neutral
@user Gracias  ya me pas√≥ una vez y los antibi√≥ticos fueron milagrosos, estoy deseando que vuelva mi madre con ellos	positive
@user no que eso es ilegal	negative
@user te doy un poquito	neutral
@user @user las palabras y las emociones que generan son muy √∫tiles para generar cambios	positive
Llevo toda la ma√±ana haciendo cosas y no he podido ver ni moon lovers, ni signal, ni nada	negative
Ay la canci√≥n de tercer cielo	neutral
"@user Gracias por lo de ""√≠dolo""  Aunque solo soy una persona normal y corriente que escribe libros"	positive
@user cucha, una independentista escribiendo en espa√±ol!! Por muy del Bar√ßa que soy, te vas a buscar la vida  grassias.	negative
@user que buena, esos alucinados que fingen ser Lobos, y esos que fingen ser gay y no saben nada de nosotros	neutral
@user @user @user gggg pues habr√° que hacer algo conmemorativo en tu bar	positive
Se me dan muy mal las despedidas	negative
Entr√≥ a trabajar a la 1:30 p.m y yo en San Carlos Mi t√≠o cree que voy a llegar puntual.	neutral
@user @user siiiii, y de nuevo estoy en lista para ir al programa. Y luego el concierto de OT	positive
Entiendo que mi tarjeta gr√°fica se muera, lo que no entiendo es porque puedo ver algunos v√≠deos y otros no...	negative
"@user A falta de varias suyas (como Big Fish, ya bajada) me quedo co ""Pesadilla antes de Navidad"" y ""James y el melocot√≥n gigante"""	neutral
@user bien!!!viva M√©xico,viva los pueblos ind√≠genas,viva una Am√©rica libre!!!	positive
@user no hab√≠a visto tu respuesta!S√≠, s√≠, s√© que es correcto, lo consult√© , pero es poco habitual, llamativo, algo friki... no?	negative
Ma√±ana se madruga para ir a trabajar a la casi frontera norte. Si puedo me paso y voy por To√±as y tostones	neutral
Un hastag por un buen motivo, dadle a tope venga  #demoslelavuelta	positive
lo q mas odio de ir al centro es cuando cojo el bus sola  vaya aburrimiento me siento sola	negative
"El pr√≥ximo v√≠deo es simplemente explicando c√≥mo participar para salir en ""Respondiendo en Verso"" especial 500.000"	neutral
@user eres un grande, la mayor√≠a de gente no sabe diferenciarlos y es muy sad	positive
Hoy estoy un poco triste	negative
@user @user @user gracias   Si lo malo de la verdad es que no necesariamente nos hace felices.	neutral
@user te deseo much√≠sima suerte en tu pr√≥xima aventura t√≠o	positive
@user Lo feo es llegar al reina sof√≠a y que los descuentos de estudiante sean para menores de 27 a√±os	negative
@user sii!! antes que entremos a clases tierna	neutral
Por esos amigos que les dices que estas triste y ya te est√°n planeando las salidas hasta los viajes a futuro con ellos Como los quiero	positive
@user Me apiado de ti, yo me entero de que existen porque t√∫ los encuentras. O sea, alguien los lee primero	negative
Quiero hacerle algo especial a David para que cuando lo vea sonria pero no se me ocurre nada	neutral
Lo consegu√≠, fin de inventario, despues de dos dias de duro trabajo, ahora a dormir, ya huelo laas vacacioness	positive
@user que yo recuerde, no le he faltado al respeto, pase usted un buen d√≠a. Salud y rep√∫blica	negative
Yo ahora podr√≠a estar en mi casa de zgz viendo los premios en la tele tan ricamente l tenerlos grabados pero no	neutral
Acampar es de mis actividades m√°s favoritas del mundo mundial	positive
Necesito que sea viernes para que paguen. Estoy en la miseria total	negative
Martita guapa verde Brandon  Se que no pega la foto pero  http	neutral
@user Muchas gracias!! Feliz por haber formado parte de esta edici√≥n del Master!	positive
Lo malo de no poder dormir, es que a estas horas no tengo a quien molestar, todos duermen.	negative
Mientras mi jefe no se entere todo ok lol Los dem√°s si tenemos sentido com√∫n	neutral
¬°Buenos d√≠as! Aqu√≠ andamos, con el S√≠ndrome post-Uncharted 4 :S Necesito jugar los 5 de golpe... Peeeero no hay tiempo	positive
@user Tu vida ha parido a un grandisimo hijo de la gran p... , un maravilloso hombre!!.	negative
@user @user @user @user @user el tiempo dir√° . Ojo xq a Ps las 3ras tb le vienen terrible. #Pdr4President	neutral
Felicidades a mi bonita @user  Espero verte muy pronto y que vengas de una vez a una quedada  Te amo magicamente bebe ‚ô•	positive
@user mica va a estar ne la 8g, porque sus palabras en ig me hace dudar, igual si sigue cbt peru y se queda alla mejor	negative
Hola me complacer√≠an con #ParaOlvidarte de @user por faaaaa Saludos desde Liberia @user	neutral
"@user en cualquier caso gracias por tu ""welcome back"". Qu√© c√°lido ha sido"	positive
En mi casa todos morir√°n el d√≠a que haya un terremoto. Nadie me hace caso. Yo la √∫nica zonza parada en toalla en la calle.	negative
@user de aqu√≠ nace una bonita amistad  Pero bueno, si la decpeci√≥n es solo por el software ni tan mal! @user @user	neutral
Como cuando soy muy chineada y me traen almuerzo al trabajo  Gracias @user	positive
@user No s√© si est√° traducido, yo lo busqu√© hace tiempo y s√≥lo lo encontr√© subtitulado	negative
@user en realidad si. Clarke aun esta ahi quiero ver q hacen con su personaje, asi q no se q hacer haha	neutral
@user conmigo siemprw puedes hablar	positive
@user @user te mato, ma√±ana por la noche m√°ximo eeh. Te dejo que descanses hoy	negative
@user @user esa es ground speed, ahi le influye el viento en cola que debia tener el avion, saludos	neutral
Hola buenos d√≠as, me he dormido a las 5 y algo y me acabo de despertar y se me ha ido el sue√±o	positive
@user Jo  no me parece bien porque se va a ir Yessica a la primera, pero bueno al menos ha llegado al TOP8, no la esperaba aqui.	negative
Aqu√≠ por lo menos no est√° solo ELF ... En ese entonces...pfff.... solo estaba Cloud	neutral
Menuda joyica @user que has reclutado para tus tierras	positive
Hubiera tenido novia y hubiera pasado en m√°s chill y menos Netflix estos 22 d√≠as de la casa sola	negative
Si ocupan gente para una mejenga yo estoy disponible	neutral
@user Te la recomiendo, parece mon√≥tona pero hay cap√≠tulos que vuelven a subir el inter√©s	positive
@user @user @user qu√© mazo utiliz√°is? No me dej√©is con la miel en los labios	negative
@user una pena, en serio, a√∫n no se saben las causas, verdad?	neutral
En mi cabeza, en mi cabeza vas dando vueltas! Estoy muy emocionado por algo GIGANTE que se me viene!!!!!!	positive
@user lo malo que el palmar√©s de los que se han ido era mientras jugaban en el @user	negative
@user Hmm no s√© qu√© decirte, mientras no dejes la jaula abierta no pasa nada  Pero se recomienda que salgan un ratito al d√≠a +	neutral
@user Siempre puedes levantar la vista y ver el cielo azul y rascacielos.	positive
@user Que cabrito   y te quito a√±os  @user perd√≥nale porque no sabe lo que dice... o si ? Abrazo a los dos	negative
@user @user @user sip, te entend√≠ por tu tuit anterior	neutral
Sigo imbatible ganando a Fifa siendo visitante en otras casas. Esta vez ha costado mucho m√°s, pues era en Fifa 13 de 360	positive
@user @user no estoy de acuerdo, las cicatrices siempre recuerdan dolor, sufrido o provocado	negative
superar un libro de Colleen Hoover con otro libro de ella es mala idea, ¬øverdad?  pues lo voy a hacer ahora	neutral
Hoy microaventura en #kayak con dos expertos kayakistas  R√≠a de Villaviciosa. @ El Puntal‚Ä¶ http	positive
Lo peor de estar malo y tirarse toooooodo el d√≠a durmiendo es que ahora por la noche no me duerme ni el tato...	negative
y lo peor de todo es que funcionaba maldita Jaco como te quiero	neutral
WORK FROM HOME!! Ser√≠a espectacular y poder verlas m√°s!  #ConMTVal727Tour	positive
@user Pero que a√∫n as√≠ no me creen	negative
Con lo tranquila que yo estaba...	neutral
@user mercado a,  erosky y dem√°s tienen compra online	positive
Por gusto redact√© un testamento para que Ale se lo publique a Steven ... Gracias Per√∫, me dejaste misio y encima Ale no publica nada	negative
Tratar√© de ser positiva este √∫ltimo mes, para que no me vaya tan mal como todo el maldito a√±o	neutral
@user @user uno de nuestros festivales favoritos!! Hemos ido dos veces	positive
no quiero q troye se haga famoso  q luego empiezan todas las de mi ciudad a mojabraguear üò°	negative
Mam√° haciendo limpieza  Esto no sirve, esto botalo, etc. M√°√°√°√° son mis peluches , ya est√°s grande, ac√° no hay bebes!	neutral
@user estar√≠a a un paseo en tren de Madrid, y tendr√≠a findes largos cada dos semanas...	positive
ponedme algo que triste soy	negative
@user @user @user @user el.partido estaba pa Lugano	neutral
@user feliz sabado para ti tbm,a los tiempos entro al twitter y es agradable que a la primera persona que vea, sea a ti !!!	positive
@user Te tengo que recordar quien menciono a quien primero? Igual por tener sangre ferrolana eres mas lentita	negative
@user la parte de acci√≥n se me hizo muy pesada. Pero los momentos bonitos son muy bonitos	neutral
@user @user Ver√≥nika es una gran actriz y sobretodo una maravillosa persona!! Deseando verla ah√≠!! Besos!	positive
Quiero hacer un brindis Por menos personas hip√≥critas en el 2017	negative
@user @user Ninguno de los clubes lo hizo oficial pero se dice que s√≠	neutral
@user @user bienvenido al lugar en el que una bufanda nunca sobra	positive
Rivera y Rajoy no han pactado que Nivea vuelva a lanzar pelotas de playa desde una avioneta, como cuando era peque√±o. Nos vemos el 25D	negative
Soy de esos que, a√∫n cuando la comida est√© lista y tenga hambre, si no me sirven me da pereza y no como	neutral
Se nos est√° volviendo costumbre del domingo por la noche, ver el episodio anterior de SNL y eso me hace recibir el lunes en un mejor mood	positive
@user pero despu√©s de ducharme tampoco se queda as√≠	negative
URGENTE!!! VENTA MY NAME TIKETS!!! Tengo dos tickets ULTIMATE VIP pero no podemos ir  los vendo m√°s baratos, contactad conmigo!!!	neutral
Esta tarde me voy a comprar un juego que estuve esperando much√≠simo tiempo... posiblemente lo suba esta tarde-noche  Yoshi aparece	positive
@user @user escr√≠bele cosas bonitas, as√≠ no te va a dar ‚ù§Ô∏è	negative
@user @user o al menos pasad fuentes! Yo estoy viendo para reciclarme un poco	neutral
@user @user Tu no tienes familia con huerta y perros no? Los tienen en unas condiciones estupendas	positive
Oye @user tiraros un descuentiyo asi del 40% aprox que quiero subir a bilbao y sale muy caro  todo sea por ser cliente fiel	negative
¬øy por qu√© con el morado o azul no pasa lo mismo? ser√≠a genial cagar de colores	neutral
Listo. A empezar con las metas del a√±o	positive
@user hacia ti no   En fin, ech√°n2te de menos, quiero ir a verteeee, seguro que me pones una excusa a mi tambien -_-	negative
si mal no recuerdo creo este es el √∫ltimo capitulo d√≥nde escucharemos a tanaka kazunari haciendo de ukai	neutral
Amo los vestidos largos y los enterizos	positive
@user yo estoy igual, he dormido nada o menos... Y en una hora en marcha a currar	negative
@user ahh no eso fijo... Pero en este caso en especifico hablo solamente de vestimenta	neutral
Hola @user gracias por la informaci√≥n, tomamos nota  Qu√© tengas un buen d√≠a	positive
Que os peten el ojete	negative
@user Como lo dijo @user, menores de 16 a√±os	neutral
@user S√≠, lo que imaginaba. Todos los d√≠as se aprende algo nuevo, gracias	positive
@user ay si, pero no puedo cambiar el username y soy un numero raro  aiuda	negative
@user algunos callaos pa que no nos digan reventaores la Yihad!	neutral
Ay qu√© bonito todo! Demasiado extra√±o no estar sufriendo a estas alturas Vamos Seleeeeee	positive
Otra vez quieren desnaturalizar el tema #BienestarAnimal, dejando en el texto de iniciativa popular s√≥lo a perros y gatos.	negative
@user m√°ndame tu direcci√≥n postal a pdeveraoficial@yahoo.es para que pueda mand√°rtelo, o habla con @user  Un besazo!	neutral
@user jajajaja si si. Buscar√© en Pinterest algo as√≠  gracias üòò	positive
En pleno 2016 ya no deber√≠a existir la siguiente conversaci√≥n: Hola! -Hola Como estas? -Bien, vos? (Esa conversaci√≥n q no pasa de ah√≠)	negative
@user ah wno no es que me pase nada es que cuando el Hype est√° tan alto y se habla tanto tengo la sensaci√≥n de que ya la he visto	neutral
que feliz voy a ser a las 3	positive
Nota menta las felicitaciones automatizadas en LinkedIn cantan mucho cuando te llegan todas a la vez	negative
Cuando todo es felicidad y falla un sector del disco de la laptop y se borran archivos muy importantes de la chamba	neutral
y el video de la campa√±a de este a√±o del juego fue muy bueno pero no lo tengo	positive
Que dizque el debut de CM Punk en la UFC fue tan corto que puede entrar en un v√≠deo de Instagram. @user debe estar muy triste.	negative
@user hombre pos claro. Lo dudabas?   Soy tortillero mayor del reino	neutral
@user El Valencia siempre a dado excelentes jugadores tanto a la Selecci√≥n como a otras selecciones.	positive
Siento que estoy tan gordo que en cualquier momento romper√© la silla de pl√°stico	negative
El verano pasado estaba ligerameeente m√°s gordita y la ropa que compr√© ya no me queda igual	neutral
@user justo cuando se terminan las fiestas de verano, me viene genial	positive
"@user ""surgen""  est√° el que se relaja con un plajo y el que nunca va a la caja pero farda de que saca un buen trabajo"	negative
En una propuesta/solicitud de servicio lo que debe quedar muy claro son los ENTREGABLES. Si esto no est√° claro, habr√° problemas.	neutral
11. siiii fue super gracioso teniamos que habernos sacado una foto	positive
@user que va t√≠o, a√∫n no lo he probado	negative
@user aaahm bueno, disfruta la vida por esos lares, yo me vuelvo a Rusia en breve	neutral
Mor√≠ @user me dio like #Bombon	positive
Ayer m√°s que nunca extra√±√© a mi amigo Rumors, ten√≠amos la casi tradici√≥n ir a Zapote los 25 juntos.	negative
@user eso es de Grammar 1, no de ingl√©s 7! de Ingl√©s 7 yo hice resumen el cuatri pasado	neutral
"¬°Buenos d√≠as! #YeimyTeMueve a partir de este momento. ""Escrib√≠ en tu coraz√≥n que cada d√≠a es el mejor del a√±o‚Ä¶"	positive
"""Contigo porque me matas y ahora sin ti ya no vivo"" -->Tal cual! Te mereces todo lo que has conseguido y conseguir√°s @user"	negative
"@user y, seg√∫n yo, miradas a los ojos que valen por mil (todo de manera independiente a la sustancia ""amor"")"	neutral
y ahors me puedo tirar como horas viendo videos de conciertos suyos pq me encanta como se mueve en el escenario y como todo de vd  mi ni√±o	positive
No se porque hay gente tan renegara donde dice que fue el peor a√±o.. no solo lloraron TAMBI√âN FUERON FELICES	negative
@user Es que en el Ojeando el a√±o pasado tampoco, tiene muchas canciones ya jajajajaja	neutral
@user Aqu√≠ seguir√° El Teide esperando tu pr√≥xima visita. Felicidades por la proeza	positive
Todo era mejor en la playa	negative
@user el mismo de que sale el juego ppppppero la campa;a 30 dias antes de que salga osea el 5 de Octubre	neutral
@user Hola bella Andrea!! Qu√© tengas un maravilloso d√≠a!! Besitos!	positive
Hablando en serio, como no apruebe matem√°ticas me tiro desde la ventana de mi cuarto, que es un d√©cimo y as√≠ no sobrevivo	negative
En versi√≥n extendida. 4 horas. Y no vamos ni por la segunda	neutral
Cuando no puedo dormir, escribo todo lo que preocupa en una libreta que alguien me regal√≥ y es como un somn√≠fero instant√°neo	positive
@user @user @user las de los usuarios? porque la verdad que SFV quita las ganas de jugar a los que somos mortales.	negative
@user no se cual de los dos estaba m√°s cansado. Y hasta aqu√≠ puedo leer...  #modoMayraGomezKempON	neutral
@user Ambas son mindblowing, l√°stima White Collar terminara as√≠ de repente, y esperando a la segunda par de la 5ta de Suits	positive
Ay, que ya he perdido el bus por primera vez este a√±o	negative
@user @user @user pero hombre, eso ya lo hab√≠a le√≠do  La pregunta es... ¬øCu√°l pretende ser el titular completo?	neutral
@user  -felicidades!!! üéâ -sales genial en tu icon -no te conozco casi nada -	positive
@user @user Soy un esclavo de fines de semana	negative
‚Üí ¬°Ya lo sabes, sigue a @user en sus Redes Sociales! Excelente semana para todos	neutral
@user me alegro mucho!! es importante darnos cuenta del gran valor que podemos aportar y encontrar nuestra misi√≥n	positive
Y lo que se sabe no se preguntan para el dolor de muchos no soy pita soy SCORT  no cobro dos lochas ni doy culo gratis como muchos.	negative
@user eso me lo dec√≠as hace un a√±o y medio pero en otro contexto	neutral
@user @user @user ¬°Qu√© bonito que nos recomiende un padre! Eu non falo moito o galego pero GRACI√ëAS	positive
@user yo tmbn me tienes abandonadisimo	negative
@user @user si, desde aqui se te v√© La Fosa de las Bermudas, clarito y con vegetacion	neutral
@user no creas. Pero me gusta tener a la gente enga√±ada  @user	positive
La vara es que ya tengo como 3 quiz, una eici√≥n, dos ex√°menes, un ensayo, y lo peor es que mis vacaciones ya casi acaban	negative
@user @user @user s√≠, es usual en Pa√≠s Vasco y zonas lim√≠trofes, pero no me cab√≠a lo √∫ltimo en el tuit	neutral
@user efectivamente  , un buena p√≠ldora viral muy ilustrativa.	positive
@user yo siempre deseo eso y cuando estoy libre;como hoy> ando desde temprano dando vueltas y sin sue√±o	negative
!Feliz a√±o nuevo! este 2017 sea realmente un a√±o muy lindo y maravilloso ^_^	neutral
De nuevo lo veo imposible con tanta menci√≥n @user #FollowSpree. Por favor, mi apoyo lo tienes siempre	positive
he so√±ado una cosa muy rara con los personajes de PLL y luego como que estaba en la real life y conocia a Shay y a Lucy y y y	negative
@user @user @user M√°s bien imposible. A no ser q se convierta al Islam, claro	neutral
@user que bien yuriko. Felicidades	positive
Y tambi√©n dice caca solo que no me ha dado tiempo a grabarle	negative
"@user yo tuve el pelo rojo ‚Ä¶ ._."" #YaChau ‚Ä¶"	neutral
@user dos para vos un gran abrazo homosexual ü§ó	positive
@user hola odiosa me hace falta	negative
@user jajaja claro como olvidarlo!ay ya quisiera pero llego a mi casa a las 10 11pm por mis clases y no puedo ni siquiera ver nada	neutral
VALE YA FUNCIONA ALELUYA he tenido que cambiar el boton de la palanza derecha, por el de la izquierda q estaba roto	positive
@user estar un poco pose√≠da nada m√°s	negative
@user Ser√≠a un puntazo que te dieran los domingos de descanso o que trabajases de ma√±ana y as√≠ tener la tarde libre para verlo	neutral
@user Que linda y grande que est√° Holly	positive
Porque si estaba bien me tiene que dar calentura de nuevo ??	negative
@user @user ta entonces me entendes porque no hablo chino amorrr	neutral
Estoy seguro de que todo va a salir bien, suerte viejita	positive
a mi me llegas a poner los cuernos y posiblemente no vivas pa contarlo porque te arranco la puta cabeza	negative
Estoy toda estresada para el examen de ma√±ana como que si lo fuese a perder jaja Pero ya pas√© el curso y todo	neutral
mi espalda esta bien chicos no os preocupeis  P espero que el juicio sea lento y me libre de la carcel http	positive
@user bueno,  es algo..  Cuando encima no sabes porque te pasan las cosas todo es un poco peor  lo dicho, muchos √°nimos	negative
@user lo mejor que tengo es uno de 200 o as√≠	neutral
@user Jajajaja en cuanto salga de mi bucle infinito con la casa, me imprimo los mapas a dos y lo estreno!!	positive
@user yo tengo que aguantar 4 ni√±os peque√±os, no s√© que es peor	negative
Quiero y tengo que ir a ver animales fant√°sticos antes que salga de cartelera	neutral
@user Para ser un filler tiene bastante chicha... XDD, si es muy bueno entra al Olimpo con el Duel, los 2 mejores filler	positive
@user bufeo a los bombarderos y que arreglen a los putos rammers que salen ilesos, si no no juego	negative
En cuanto se vaya fabi no pienso salir de mi casa en por lo menos tres d√≠as	neutral
Hoy estoy muy feliz! Podre subir videos de nuevo, mi grabador ya no me da error Volvere con todo y con un super evento por los 1000	positive
"@user @user @user  ""Cosa Nostra"" en estado puro... Ni Don Vito lleg√≥ tan lejos..."	negative
@user @user @user @user @user quiero un polo as√≠	neutral
@user vas a ser un gran comunicador	positive
El colmo de tener que madrugar y tardar en quedarte dormido, o perderte en los mundos de la lectura	negative
@user Son las grandes promesas nuestras	neutral
@user Espero que te guste  Escocia es precioso!	positive
@user t√∫ norte, yo sur  - levante, humedad, mosquitos, cal√≥ azotado por levante pero al menos tienes playa...aqu√≠ no hay de eso	negative
Doght es amable,Doght es cari√±oso,todos quieren un Doght,disponibles,en ninguna parte	neutral
"Al parecer tu casita no es tan ""ita""...iSe ve divina chinita @user! Que felicidad por uds. - seguro Dormy tb est√° re feliz"	positive
Ojala yo present√°ndome para el concurso de shawn pero como vergonzosa se nace y  seguro que no me dejan participar pues aqui estoy	negative
@user me ha pasado algo similar te entiendo cari√±o	neutral
@user es que Nacho est√° haciendo una cadena graciosa	positive
@user la web que ten√≠as para ver los pokemon que veian tus rastreadores ya no funciona? Que llevo dos d√≠as entrando y ya no va	negative
alberto que tal por punta?	neutral
¬°Hoy habr√° nuevo campe√≥n!, que pase lo que sea, que @user sea campe√≥n o que @user pierda #CarlsenKarjakin	positive
@user Es que se lee cada cosa , menos mal que a ese lo deje de seguir cuando termin√≥ la temporada pasada .Mi salud es lo primero	negative
@user s√≠. Se desat√≥ una lluvia intensa y me empap√≥ las √∫nicas zapatillas que ten√≠a y ahora ya no puedo salir a comprar comida	neutral
#EVDLV @user es el hombre perfecto	positive
@user si lugar de incalculables arrochadas	negative
Aveces cuando leo sus tuits y no entiendo algo, me dan ganas de preguntarles para entender mejor. Pero soy t√≠mido y me quedo con la duda	neutral
@user ya sabia yo que si	positive
oir a @user  y a @user que haran directos del wow pero no se acuerdan que el server lo mas seguro ni que vaya  jaja	negative
@user jajajaa sii, aunque acabo en un a√±o comunica y convalido mis 3 a√±os de derecho, sumado a los electicos que ir√© llevando	neutral
@user pero si es preciosa	positive
en japon√©s no se escucha tanto	negative
Dice tu pap√° que esto pasar√°, dice tu mam√° que t√∫ me olvidar√°s... @user van 20 a√±os, y el amor sigue intacto y ser√° hasta la muerte	neutral
@user Bueno, me piro a la piscina , que hace un d√≠a estupendo	positive
Confirmao tengo el pie roto, he notado como el puto hueso se mov√≠a	negative
@user aw ! reci√©n veo esto, sorrry ! tu pues me dices algo y luego queda en nada vamos hoy a la reu de mi prima? le dije a Mari	neutral
@user @user hoy tocaba ir al del oeste, por cambiar. S√≠, el cambio es a mejor	positive
Qu√© depresi√≥n me entra, de seguro gana gente que solo dio RT porque s√≠, por probar suerte y no verdaderos fans	negative
Yo quiero una rosa eterna	neutral
"Cada vez que escucho ""Instituciones"" de Sui Generis se me escarapela la piel por lo hermosa que es y tambi√©n me acuerdo de ti"	positive
No puedo apoyar la planta del pie casi y tengo que irme a trabajar todo el dia enterito	negative
@user Pero retomas y ya (y bueno, lo que dices, es mi raz√≥n para no ir a un gym, por eso prefiero entrenar en casa )	neutral
@user Ves qued√°ndote con los sitios bonitos que hay que ver que en unos meses estoy yo por all√≠ para el SSS	positive
@user y √©s una lastima porque tiene muy buenas ideas de dise√±o y al no pasar por Java rinden guay...pero MicroSoft y sus cosas	negative
@user Denada y muy op lo del 6.16	neutral
"Las eresiones mas comunes de un pa√≠s, muestran su cultura, en Costa Rica es ""Pura Vida"" nada que pueda agregar"	positive
Hoy nos toc√≥ de √∫ltimos en el Festival Navide√±o de PZ y lloviendo. Adivinen c√≥mo qued√©.	negative
No me llamo Laura pero te casarias conmigo?  #ElRaboDe8cho @user	neutral
PPK hizo una menci√≥n especial a todos los j√≥venes que marcharon anoche. La lucha no fue en vano. #MensajeALaNaci√≥n #LaEducaci√≥nSeRespeta	positive
Lo que se enoj√≥ cuando le dije que me iva a ir a pachanga :v jajajajajaja lindo amiguito result√≥ ser	negative
@user ya no puedo tomar - cero alcohol- ayer estuve internada en la cl√≠nica como 6 horas.	neutral
@user querida, veo tu tuit ahora!!! No nos vimos, pero fluimos en un mismo sentir	positive
Ya es oficia nos quedamos sin Konoplyanka en @user   Eso s√≠, ser√° una alternativa barata a Reus en la Bundes http	negative
@user @user Muy pero que muy bueno. Lo dejaron solo al pobre chaval en una batalla contra Afganist√°n	neutral
Bienvenida a los juegos mentales	positive
Siempre las mejores personas son las que m√°s sufren  #GetWellSoonSelenaFromSpain	negative
Extra√±o tener a mis padres juntos	neutral
@user ya  Si alg√∫n d√≠a soy rica te llevo conmigo a verlo a donde sea, promesita üëâüëà	positive
@user ingrato, solo porque usted s√≠	negative
S√≥lo piensa q diste todo... y duermes tranquila	neutral
Que bueno que le gustara @user @user	positive
Yo hasta ahora veo el v√≠deo del ping√ºino no lo puedo creer. ¬øEs normal que est√© tan triste? D√≠ganme que ustedes tambi√©n lloraron.	negative
@user mira el hilo, que est√° explicado  es el primer planeta (b) de la estrella Pr√≥xima Centaur Pr√≥xima Centauri b	neutral
@user que va t√≠a, muchos son viejos de mi madre, otros del chino. Los que me encantan y me estoy comprando son los del Kiko	positive
Mi mejor amigo me quiere revender un cup√≥n para un fds en un Hotel en Chincha. Qu√©, voy sola o qu√©? te pasaste de pendejo @user	negative
Al principio √©l no te gusta , pero te acaba gustando y cuando te deja lo extra√±as	neutral
Una semana siendo vegetariano. Es un peque√±o gran logro para m√≠	positive
Luego la rara soy yo	negative
@user perdida ya no tomo coca.	neutral
@user Muchas gracias  Muy feliz y dulce finde	positive
T√∫ que he ido a cenar a mar de cristal y me he inflado y me duele la barriga	negative
@user hace una semana que se sabe  yo ya espero la edicion completa del juego	neutral
@user Tienes un buen KI. Para luchar contra los malos en Chicago PD.	positive
Estaba el autob√∫s Benidorm-Madrid al lado con las puertas abiertas y me ha tentado subirme y volver.	negative
hace mucho no e tenido que ver mi nombre en otras cuentas por que sera? a cierto yo le dije que no lo hiciera Gracias por hacer caso	neutral
@user Pues s√≠, es precioso como bien puedes ver en el v√≠deo	positive
@user Hay que hacer algo contra los Incendios Forestales, ya basta, estamos jodidos.	negative
necesito hacerme una sesi√≥n de fotos de estas en plan bonitas	neutral
"@user Jejeje te has explicado muy bien, tranqui, y si prefieres hablar por otro sitio, lo hacemos  Pues Sue la ""reservaron"" +"	positive
sabes que tu vida es muy puta cuando empiezas las clases en menos de una semana	negative
Pero solo cojo 5 d√≠as porque me cambio de curro y	neutral
Mi palabra preferida para este 2016, fue gratitud. Todo funciona mejor agradeciendo.	positive
@user A mi tampoco me va, bueno, te queda cerrar los ojos sin dormir o joderte y sufrir	negative
@user si alg√∫n d√≠a quieres echar una ojeada al plan de transportes de Madrid de 1988 ya sabes	neutral
Hoy hice el gol de mi vida, perdimos 8-1 pero hice el gol de mi vida	positive
#LaPoderosaKeiko solo puede tener poder en el 4to pa√≠s m√°s ignorante del mundo: Per√∫	negative
@user Monsefuana, tienes que configurar eso. Jajajaja. No se puede vivir en paz con el carrete lleno de memes. Te dar√© los tips.	neutral
Uno tiene que abrir burbuja #feliz s√°bado tuiteros..disfrutar del coctel maravilloso que sigue, la felicidad.	positive
@user gracias, yo tambi√©n estoy triste porque no te vi	negative
cual es su mejor recuerdo juntos? #BntResponde	neutral
Se pone interesante la cosa, ganas de evolucionar para tener pokemon fuertes en casi todos los tipos	positive
Mae yo soy tan idiota que tome jarabe por que ten√≠a mucha tos y ahora estoy como si estuviera borracha y no puedo estudiar	negative
clrealy no es una indirecta	neutral
Me esta encantando la animacion encerio :,) Cuando veo el final me da un poco ganas de llorar :,) Bueno solo me falta background y texto	positive
@user ah mae que duro eso en este d√≠a	negative
@user @user Brutal... Y al parecer los que hacen de periodistas, tambi√©n siguen con su grupo de wassap un a√±o despu√©s	neutral
@user bonito d√≠a para hacer un tweet con esta foto	positive
Ptmr hoy se presenta tr√©bol clan y recuerdo que en gotica se present√≥ y fue la √∫ltima vez que lo vi y hice mi cagada claro	negative
¬øMa√±ana stream?  ! Espero que mi internet no se vuelva loco como antes, aunque estos dias funciona bien!	neutral
@user muchas gracias ni√±uca, t√∫ tienes una gran sensibilidad por eso valoro mucho tu opini√≥n. Feliz noche	positive
"@user y con ""las conozco"", me refiero a Maria y Krisbell . Mandale mis saluditos, somos ingratas todas"	negative
Bueno, Yixing tuvo pocas l√≠neas como siempre, pero no voy a andar de pesada. Al menos no esta vez	neutral
Este a√±o la quiniela perfecta de los mundiales da como premio las 3 skins definitivas, interesante...	positive
al final me ha dejado llorando y pues bien  yo que estaba hoy pensando saltos de los feliz que estaba. Al pelo todo	negative
Vamos a pasar a√±o nuevo a la playa No? Bueno	neutral
Mi pap√° emocionado hasta las l√°grimas con los tenores... hay conciertos que se quedan en el alma para siempre.	positive
@user @user te lleguen a entender y a respetar. Muy malos tienen que ser para obligarte a comer algo a la fuerza	negative
Voy asi: Silvio Rodr√≠guez, Ismael Serrano, Cristian Castro (homenaje a Jos√© Jos√©) y el Buki... el asunto es serio	neutral
@user Agradecidos. Nos miras con buenos ojos  @user	positive
me mantengo optimista pero se me hace dif√≠cil a veces de verdad	negative
Regres√© de la playa hoy y literal todo el d√≠a he dormido, y a√∫n sigo con sue√±o	neutral
@user have fun Antu! Los mejores deseos	positive
@user Pos s√≠ que eras t√∫ limitada en encontrar formas de no aburrirse en clase	negative
"Pablo contin√∫a su hilo, imprescindible.  Luego haremos crowfunding entre todos para hacerle un ""Medium""  http"	neutral
Sin duda ha sido la semana m√°s larga del mundo a su vez ha sido una de las m√°s bellas	positive
@user la pr√≥xima vez que vaya a Madrid no estar√°s en mis planes. Maldita	negative
¬øConoces la pubalgia relacionado con la lesi√≥n de Messi? El doctor Quesada lo explica en el video siguiente  http	neutral
@user hombreee, poco a poco, los 5 primeros minutos que montes en bici te sabr√°n a gloria  as√≠ que √°nimo que todo llega	positive
A√∫n no estoy listo para una nueva mam√°	negative
Para mi mam√° toda la ropa que escojo es fea hasta que me la ve puesta	neutral
Voy con demasiados sue√±os locos. Y demasiados, siempre son pocos  #Yolo #mondaymotivation	positive
La operaci√≥n de Carmen me tiene muy triste	negative
@user @user @user se conserva la misma cuenta. Pero el programa ser√° distinto	neutral
@user  Buenos dias y feliz domingo  abrazo‚ô°	positive
@user @user Conmigo no los tiene abiertos porque me bloque√≥	negative
Entre lo positivo, est√° el hecho de que no tendr√© esas responsabilidades extra que adquir√≠a s√≠ yo quedaba electo. Pero mae yo quer√≠a	neutral
@user oye, 7/8 no est√° nada mal	positive
"@user estaba en momento ""odio eterno"" necesitaba compartirlo  adem√°s yo hace poco que tengo canal y no me siento NADA identificada"	negative
Como te elicas algo que no viste venir, ¬øC√≥mo?	neutral
@user un placer guapa!! @user es un sol!! bueno, los dos los sois	positive
Qu√© triste ver que el odio por una mujer est√© por encima de la raz√≥n	negative
@user @user @user yo solo quiero saber si tienen mi libreta y los llaveros de llamas que les di son 2, blanca y negra	neutral
@user Yo, he probado con pisco, y buenazo tmb, ah.	positive
Que tristes son los velorios y entierros, mi Pap√° est√° llorando peor que un bebito recien nacido	negative
Nominada por @user   Aqu√≠ van nuestras pelis y nuestros taggeados.  http	neutral
Cosas q debemos usar para simplificar nuestra vida: el cerebro, sentido com√∫n, una sonrisa y eliminar a qui√©n no nos interesa. Simple	positive
@user @user me parece que sueles reclamar demasiados sobrentendidos	negative
@user jajajaja f√°cil,o derrepente ya nos lo cambiaron por uno nuevo	neutral
@user tu ventilador me mira con cara seductora.	positive
@user @user porque al final siempre llegan a lo mismo: es que ella debi√≥ asumir m√°s su lado femenino	negative
@user reci√©n me conectooooo Juan est√° enfermo ma√±ana te prometo que te recojo	neutral
El sol echa el cierre a un d√≠a estupendo en  #VillardeOlalla #Cuenca Preparados para otra noche de fiesta  http	positive
hoy me han tra√≠do a mi perra despu√©s de seis d√≠as sin verla y est√° to nerviosa y m√°s delgada	negative
Ma, mira... - Qu√©? La Paca? S√≠, c√≥mo supiste? - Porque es lo √∫nico que haces.	neutral
Creo k es la primera vez k estoy deseando k llegue septiembre de una vez	positive
@user a mi me gustaba antes. Ahora todo es super cuadrado y feo	negative
@user las tuyas y las nuestras  ajajajaj	neutral
@user gracias ni√±uca es preciosa, te prometo que me has alegrado la tarde con este detalle tan Bello y enternecedor. Mil besos	positive
Que duro iniciar el d√≠a con noticias tristes	negative
@user yo estaba todo feliz	neutral
@user sep, mi familia es MUY lectora y mi c√≠rculo de amistades tambi√©n	positive
@user yo nunca la he podido ver entera porque literalmente me duermo	negative
@user La carta compuesta es un factor m√°s. Tambi√©n est√° la #sinastr√≠a que ayuda a suavizar una compuesta dif√≠cil	neutral
@user No s√© si saldr√° algo relacionado con Escocia, pero los paisajes son incre√≠bles	positive
Creo que soy muy rencorosa	negative
@user Una vez mi prima me bes√≥ sin previo aviso. Ese fue mi primer beso, y nunca he vuelto a tener uno	neutral
@user ojal√° sigan juntos mucho tiempo	positive
Quiero entrar en tantas clases pero soy pobre.	negative
@user ay no mms ARELIIIII.A los a√±ooooos sdfjksf te extra√±o we	neutral
Ha vuelto @user con energ√≠as renovadas. Los lunes por la noche el Doctor Amor y su consulta te esperan en su #periscope	positive
@user Prohibirlo, no. Se pueden hacer campa√±as, pedagog√≠a... y no aplaudir como est√°n haciendo muchas pseudo-feministas  @user	negative
Mi √∫ltimo trabajo por obra y gracia de @user @user @user, un spot para el @user #megapanic  http	neutral
Nunca es tarde para hacer un sue√±o..con una mente so√±adora, un pu√±ado de ganas, fe y un coraz√≥n de amor, todo es posible.	positive
No deb√≠ cogerme la cara con las manos suciaaaaas!!	negative
+ a VOSOTROS, y siempre intento daros bola y responder a vuestras cosas.  Pero bueno, se ve que no es suficiente	neutral
Creo que lo mas jodido del 2016 ya me ha pasado y ya estoy lista para lo que venga! jodidamente bien	positive
"@user "" En alg√∫n momento empec√© a mirar m√°s al suelo que al cielo "" "" Estoy harto de llorar, as√≠ que intento sonre√≠r """	negative
lo mejor es que son conversaciones normales y corrientes sin ning√∫n √°nimo de ligar pero  simplemente porque no se ligar	neutral
@user por supuesto amigo m√≠ que pases buen domingo	positive
Que horrible sensaci√≥n cuando se te atasca una pastilla en la garganta #Meduele.	negative
@user Mi ciudad bonitaa llena de nieve fijo  , gracias, es que pensaba que solo estaba en netflix	neutral
Esas costillitas se ven demasiado buenas... Ya quiero cenar!	positive
Creo que mi amor plat√≥nico de tw es gay y me acabo de poner tan triste	negative
"@user @user @user @user @user a m√≠ como a veces me piden ""la firma escaneada en el doc""..."	neutral
@user ya yo voy de vuelta, pero le dej√© la pampa lind√≠sima	positive
Si es que lleg√°is aqu√≠ desde mi Favstar del cret√°cico y claro, luego no me dur√°is ni un suspiro. Que mis neuronas no son como antes, jop√©	negative
@user justo vi en Ig que lo ten√≠as y te quer√≠a preguntar. Cuando lo hagas, espero el review! Y s√≠, yo tb tengo varios pendientes	neutral
@user @user no importa con esa linea como sino juegas nada, seguir√°s siendo buenisimo ( con cari√±o jeje  )	positive
@user LOL miguez tu eres guapo no le hagas ni caso no ves que es VASCA y alli NO SE FOLLA pero no es culpa tuya	negative
Buenos d√≠as!!!! mi pensamiento esta ma√±ana al despertar es que si o si tengo que ir a dar un paseo al parque y disfrutar de la naturaleza	neutral
@user bueno no es tan mala, tiene muuuchos elementos de las primeras dos pel√≠culas (eso es lo mejor) y le agregan otros nuevos	positive
@user @user @user @user Pero son los periodistas de La Naci√≥n, ud dijo que eran los due√±os de la verdad y vea.11 ideal	negative
Vale: MAE HOY CONOCI UN MAE SUPER GUAPO, SUAVE YA TE ENSE√ëO UNA FOTO *5 min despues me lo ense√±a* Yo: Valeria ese es mi ex Jajajaj siaa.	neutral
@user es que son super perfectas para la otra DIOS NECESITO QUE ALGUN DIA SE CONFIRME	positive
@user pero me jode no encontrar un pantalon pitillo que me quede PITILLO , y es horrible porque mi vida son los vaqueros	negative
Dibuj√© a Chikorita (mi pokemon fav) y lo malogr√© con 'mi t√©cnica de pintar con acuarelas'...tmr!	neutral
Haces que se vaya mi melancol√≠a, me devuelves de nuevo a la vida	positive
@user los √°bacos si est√°n permitidos. Sobre todo porque la mayor√≠a no saben usarlo	negative
@user Xinia de mi vida ten√≠a toda la intenci√≥n pero se me hizo imposible al final del d√≠a	neutral
@user En lo relativo a la secesi√≥n mi estimado @user es un amante de las marcianadas. Pero debatir con √©l es entretenido	positive
Si, yo soy un cabron y no tengo orgullo	negative
@user Un poquito. Pero es normal porque es oscuro.   Anyways, sigue vi√©ndosete un poquito pelirrojo. ^^ Reflejos o algo as√≠.	neutral
@user pues todo muy bien   Eso s√≠, muchos cambios desde la ultima vez que hablamos üòÅ	positive
@user voy a ir con un √°rbol de Navidad en la camisa a taller solo para arruinar su d√≠a	negative
Gracias a todos por regalarme sus comentarios a mi columna de hoy. Invaluable obsequio para m√≠.	neutral
Estoy emocionado por primera vez realice una llamada internacional a Chile.	positive
Con este d√≠a, cuatro y el tambor en la playa. Qu√© mala es la vuelta a la rutina para algunos...	negative
@user buenas tardes! Se puede pasar?	neutral
Bueno, pues vamos a recuperar el tiempo perdido. Empezare por descargarme el Manchester City - West Ham, a ver que tal	positive
@user l√°stima que la foto de la derecha eclipse un texto certero!	negative
@user jajajaja tiene pinta m√°s bien de que lo hicieron colombiano por el acento	neutral
@user muchas gracias mariaa! Tenlo claro que te avisar√©!  un beso!!	positive
Shits happens! En el concilio de Nicea se debe haber fumado de todo o no me lo explico  http http	negative
@user @user estamos iniciando combate, en cuanto est√©s disponible avisa y te apuntamos para la siguiente ronda	neutral
@user @user asi tiene que ser .. yo m alegro solo si el barca pierde en algo qe influya a madrid cmo la liga ayer tuani	positive
@user @user IA no lleg√≥ a ser social. Fue un espacio social de dinamizaci√≥n, muy √∫til, pero con fecha de caducidad. Y abrumador.	negative
Y es jvsto en ese preciso instante en el cval le dices a tv pap√° Qve qvieres ser Dj y al final tome la decicion de mandarte a la mrd	neutral
¬°¬°Entramos en el mes de septiembre con las pilas cargadas!! Bienvenidos de nuevo a vuestra cl√≠nica dental de confianza	positive
Lamentable informan que muri√≥ Gabriel Badilla. #RIPGladiador	negative
@user Y Noel significa Navide√±o, pedo tambi√©n lo asumimos. Pero alguien lo tuvo que poner por primera vez	neutral
Dios guarda para mi lo mejor por que mi fe en el siempre perdurara por la eternidad. Quien busca encuentra y no se conforma con poco.	positive
Broder, que pinxe tr√°fico hay en Salaverry, por UPC. No jodas, voy a llegar tarde de nuevo	negative
Imposible no subir de peso aqu√≠ ( Chiclayo y sus comidas )	neutral
@user  pues ma√±ana sales por la noche es solucionao'	positive
"@user Que casualidad que la primera llamada que le hacen al ""arruinado"" la coge,pero las otras no.No ser√° que es el mismo. Un abrazo"	negative
@user Ayyy, no deb√≠ haber tuiteado esto. Olvid√© que estabas por ac√°, no me odies ( Hablo en serio, no es sarcasmo )	neutral
@user no existen palabras para agradecerte tant√≠simo que me das...as√≠ que s√≥lo puedo decirte...GRACIAS!!	positive
Obviamente las preguntas tienen que ir en el e-mail, no ENCIMA del v√≠deo ni nada parecido, sino no podr√© usarlo	negative
Yo pensaba que el descanso tambi√©n iba a ser para el fandom, PERO NO! nosotras nunca descansamos Re100 robado #VideoMTV2016 Niall Horan	neutral
@user ahi voy , cambiando h√°bitos y haciendo un nuevo estilo de vida	positive
@user @user No le ense√±es, que lo aprenda como lo hicimos los dem√°s! Yo tambi√©n queria tu coaching...	negative
@user abcesos de pus en la espalda, pero coge el alta el d√≠a 8.	neutral
En paseo hay un raptor 700R special edition a $ 12 000 y es una BELLEZA . L√°stima que no tengo $ 12 000	positive
Me he sentado en un hormiguero	negative
Alguien me explica por qu√© dicen 'Casimiro' a @user siempre? Es as√≠ la pronunciaci√≥n en portugu√©s o qu√© pasa? Que alguien me aclare	neutral
@user estar√°s super mona  cuando pueda lo mirar√© yo tambi√©n. Me molar√≠a grupal de 'chicas Spidey'	positive
@user tio me estoy rallando, necesitamos comunicado oficial de lo que ha pasado	negative
@user mi camara es lo unico que permite que no la cambie	neutral
@user ok, vea el lado positivo, tiene un motivo para hacerle drama el resto de si vida.	positive
Qu√© pobre soy no puedo ver los VMA	negative
@user Ya bueno, es lo que hay	neutral
@user Esta bastante guay porque es muy flexible en cuanto a horarios y tecnica que quieras explorar	positive
En la vet pq Aslitan est√° enfermito ...Hay una Sra. que est√° llorando pq a su perrito lo est√°n operando	negative
@user me agarran de buen humor por fin de a√±o.	neutral
Un AI The 100 ser√≠a lo mejor.	positive
No se me enciende el ruter	negative
Hoy es el √∫ltimo taller de a√±o	neutral
que bueno , dan m√°s mg a m√°s jajaja pero wee	positive
Veo que s√≠ la depresi√≥n tropical se convierte en hurac√°n se llamar√° Otto. Que comience el MemeFest!	negative
Tan Rico escuchar m√∫sica con aud√≠fonos de tapones pero tan malo para m√≠	neutral
@user solo recuerda que Iman es tranquila	positive
Este cuarto se siente muy vac√≠o sin mis amiguitos y su bulla	negative
A pesar de nuestras limitaciones humanas, el Se√±or quiere obrar de maneras asombrosas a trav√©s de nuestras oraciones..	neutral
@user parece, parece razonablemente jajajajaja  Bon dia. Egun on!	positive
Y los tres reyes magos llegaron con oro,incienso y mirra Melchoro Alan, Toledo vastadehuasquear y Ollanta nadinevagastar, de odebrechlen	negative
Hace poquito me dieron las 12 uvas para las 12pm y ya s√≥lo me quedan 5	neutral
Gracioso q se puedan acercar hasta los videos jaja	positive
Se me a escapao un dragonite y arcanie sin nivel con bayas frambu y superball	negative
ten√≠a un mensaje directo y estaba	neutral
Que bonitos que son los zorros	positive
@user De las impotencias m√°s grandes. Entiende uno qu√© significa la resignaci√≥n	negative
- Hola insomnio, c√≥mo est√°s? - echale la culpa a la comida - ok	neutral
Me siento m√°s ignorada que de costumbre lo bueno es que soy estudiante universitaria y en vez de lamentarme puedo aprovechar el tiempo	positive
@user sigo siendo feo pero es que cuando me conociste no ten√≠a el pelo rojo	negative
@user La felicidad tambi√©n es algo seguro solo debemos buscarla en las peque√±as cosas de la vida.	neutral
Que buena vibra me transmite @user	positive
Alicante 36,5¬∞C a la sombra. Que bien voy a estar los primeros d√≠as de clase.	negative
Esta semana ha sido tan chachiosa que ya puedo decir que el verano se ha acabado de una manera decente  y lloro	neutral
Buenos d√≠as, esta noche es noche buena, Feliz navidad para todos	positive
Sin comenzar y ya el 2017 con malas noticias... No vamos a tener GoT este a√±o	negative
@user @user @user @user Ah! No se, yo uso sickrage que no entiende de divisiones	neutral
Viendo Looking, Queers as Folk y as√≠, me doy cuenta que nunca he tenido un grupo de mejores amigos gays. ¬øalguien me adopta?	positive
@user chiqui, chill con el colacao que me est√°s poniendo nerviosa con tanto grito de may√∫scula	negative
40 min. tarde al brete, pero ya entren√© y la goc√© en el gym. Pobre la familia del mae que falleci√≥ en el accidente, les deseo mucha paz	neutral
@user Tengo la curiosa fortuna de que en estas semanas solo puede ver las etapas del finde	positive
@user te juro que no me acuerdo solo s√© que alba hizo el v√≠deo inmit√°ndole, no recuerdo absolutamente nada del original	negative
@user de hecho lo confirmo, los caminos y las casitas son las mismas	neutral
Buenas noches @user ya tenemos ganas de verte el mi√©rcoles üòª te queremos!! s√≠ te tengo abandonada jo  te echo de menos üíú	positive
@user esa palabra es de Yaco , asi le decia a Patricio y yo creo que el no es el mejor personalmente	negative
Mi madre me deja ponerme rubia pero no el pelo morado	neutral
@user Enhorabuena por los geniales resultados econ√≥micos de r√©cord del trimestre pasado, hac√©is un gran trabajo	positive
Iba a decir otra cosa peero si digo lo que siento, me detienen	negative
No he visto el nuevo episodio de #TWD	neutral
Es que me lo como de lo bonito que es	positive
@user es triste que sea as√≠. Y lo es	negative
Es incre√≠ble y tal pero no , no voy a ir al TH	neutral
No puedo creer que en unas horas sere egresada!!! 21 a√±os,2 carreras,estudios en europa,excelente trabajo Gracias Dios!	positive
@user dr que tratamiento,medicina natural..para las alergias como al aire acondionado, o agentes de este tipo..es una pesadilla	negative
‚Äî¬øA d√≥nde vas tan maquillada? ‚ÄîA una fiesta, mam√°. ‚Äî¬øEres el payaso? ‚Äî¬°MAM√ÅAAA! ‚ÄîJAJAJ√Å, c√°llate y hazme re√≠r o no vas. ‚ÄîOk.	neutral
@user Amo los Lunes libres	positive
Llego a la casa a las 9:20 caminando, no hay comida, todos est√°n dormidos, ma√±ana tengo clases a las 8am, todo esta bien	negative
Mis demonios internos me dicen tatuajillos pero mi corona me dice no	neutral
@user Oh, nice nice, yo estoy vi√©ndome por cuarta vez Kill Bill	positive
@user muy triste  La prensa es lo que es. Un medio oportunista, en muchas ocaciones, que por vender, lo que sea	negative
Por cierto @user podria hablar contigo por md? Gracias	neutral
@user #seestrenasietevidas Ser√≠a un gato tipo Garfield porqu√© soy un poco vago y porqu√© me encanta la lasa√±a!!	positive
Mg y pongo un adjetivo super repelente a vuestro nombre	negative
@user Aunque te extra√±o mucho y quisiera abrazarte y besarte con todo mi amor y cari√±o	neutral
@user se muestran solitos, no est√° dif√≠cil la cosa felizmente	positive
@user @user @user lo bueno y lo malo, ojo. Que a nosotros fijo que nos quitan alguno.	negative
Estoy a punto de comprarme EL VESTIDO para A√±o Nuevo, lo malo es que si lo compro los d√≠as que faltan me matar√© haciendo cardio y abs	neutral
Hoy queremos felicitar por su cumple a una de las mejores personas que hemos conocido gracia al #p√°de #RafaGuerrero  @user	positive
@user Yo adem√°s vengo de una ma√±ana de nataci√≥n y una comida que me ha dejado en una modorra importante. Y tengo que repasar	negative
@user Ps porque t√∫ lo eres conmigo	neutral
Que ladilla, yo soy chevere	positive
@user @user Todos somos asesinos por nuestra codici√≥n de humanos ya que total depende de nuestras acciones	negative
Solo porque UNA persona diga que me conoce y opine sobre c√≥mo soy, y convenza a otra de ello no significa que sea as√≠	neutral
@user Congratulations Dr. Alejandro eres orgullo peruano. Dios no te eligi√≥ para gobernar porque el congreso esta manchado	positive
@user el final volviendo a la aldea es quiz√° demasiado tierno	negative
@user @user no ! Seg√∫n UMM√©xico, ese no ser√° el nuevo single	neutral
@user @user @user @user @user @user @user gracias  me lo paso genial haci√©ndolo!	positive
@user pensba q iba a hacer @user una reflexion profunda de las q me hace a mi pero	negative
@user t√≠o peguemos al Lau  Sigues teniendo mi primer grinder?	neutral
@user hola teneis algun proximo evento por madrid? Mi amiga es muy fan vuestra y nos gustaria saberlo  gracias	positive
Esta ceniza me tiene mala ya. Ando con alegr√≠a y me arden los ojos, no puedo usar lentes de contacto.	negative
@user ya lo s√©  te tengo que contar mi vida que ahora hay muchas cosas nuevas y y y y	neutral
Vale mi cuenta de Twitter a llegado a lo mejor, me sigue una psic√≥loga cristiana	positive
OMG esta no he acertado, premio para Calvin que tampoco est√°  1 de 2 aciertos #VMAs	negative
@user Son un esc√°ndalo los 4 juntos? hay fotos?	neutral
@user tiene que dar un gustazo dibujarte tus propios posters.. te envio Amanda	positive
Lo peor de mi cumple es que ese d√≠a empiezo mis clases de nuevo!!	negative
@user Hola Julio, para que las pizzas lleguen en las mejores condiciones, marcamos la pizza, no la cortamos	neutral
@user @user me dejo congelado. Por algo es el amo de los ratings!!!	positive
@user justo esta ma√±ana no ha podido insultarlos porque estaba en comisaria AMPLIANDO LA DENUNCIA POR ACOSO	negative
Agradece todo, cada momento, cada situaci√≥n, sea positiva o negativa, ya que la positiva nos hace felices y la negativa nos hace sabios	neutral
Acabo de descubrir a Filip van der Cruyssen y sus increibles #fotografia de #retratos ...yo quiero   http	positive
@user pero del practico ya? No me dijiste que hac√≠as pr√°cticas.	negative
Totoro casi listo #Imelda #torta #totoro #cake #designcake #pasteler√≠a #lima #dise√±o‚Ä¶	neutral
@user me encantan los VAPES gracias por estar ah√≠ todos los d√≠as y alegrarnos	positive
Ahora s√≠ conejito, ll√°mala y m√°ndala a la mierda de mi parte	negative
@user b√°√±ate con agua fr√≠a para que la temperatura de tu cuerpo sea menor que la del ambiente	neutral
Lo bueno de la vida es que te hace coincidir con personas realmente incre√≠bles	positive
@user na, que son las fiestas de mi pueblo y me hallo a 1000km, en mi puta casa, con catarro y sin planes	negative
@user de parte de mi hermana ella dice que por que no te vuelves a pintar de rubio que asi de rubio te queda mejor piensalo	neutral
@user Gracias a ti hoy soy muy feliz Descansa, que sue√±es bonito. Te quiero un mont√≥n	positive
@user no creo que hayan dise√±ado una tipo propia	negative
@user Que tampoco ahora mayor√≠a absoluta, eh?	neutral
@user estamos condicionados por nuestras lecturas  Vienen tiempos gloriosos	positive
Me volvieron a dejar sola	negative
Hazme un favor y has lo posible por no cruzarte conmigo este a√±o	neutral
@user @user Abrazote enorme!! Sos un √©xito!	positive
Hoy una mosca no me dej√≥ dormir y me cago en su puta vida	negative
@user Que ya ha empezado tio	neutral
Fue un buen momento en familia	positive
@user Ni que fueran c√°maras de cobalto. Tengo mucho tiempo de no broncearme por unas manchas en mi cara, son solo ganas de verme mejor	negative
@user @user q pasa con VY1884 y VY1885? Mi madre sta en berlin y no sabe si el avion sale hoy  any info?????	neutral
‚ö† me pareces un ni√±o muy gracioso jajaja y me encanta hablar contigo a ver si hablamos mas	positive
lo √∫nico que quiero es que mi gato aparezca, no quiero vivir sin √©l, necesito escucharlo y verlo	negative
Y bueno, fue un a√±o nuevo diferente. Pero se acab√≥ y ahora toca volver a la realidad	neutral
Venir a Murcia y no pasarte por el MUSU a por un buen bocadillo de lomo es delito. #Musucomotequierojoderperoatusbocadillosm√°s.	positive
@user @user el problema que ya no hay 2x1 en grandes ni tampoco los puntos Hut, son dos p√©simas noticias	negative
Pasan los a√±os pero las resacas siguen siendo un misterio. Ayer tom√© ron puro y me he levantado tan pancho, tan fresco. Aqu√≠ no pas√≥ nada	neutral
@user felicidades pareja!!! Peazo abuelo va a tener tu hijo....estar√° pletorico	positive
@user me duele la pierna del pu√±etazo que me diste aye, en dos sitios, agresivo	negative
@user No se me ocurre m√°s que que est√°s guap√≠sima, por eso no valgo para la seducci√≥n	neutral
Que rico es dormir con el sonido de la lluvia	positive
Desear√≠a que aurin no estuviera sucia y mojada para que duerma cnmigo	negative
@user Me sab√≠a la versi√≥n femenina  Mujer refranera...mujer pu√±etera...	neutral
@user por la lucha y el aprendizaje obtenido, ¬øte suena? ;), todav√≠a no s√© notas pero son lo de menos	positive
Comenzando mal la semana enfermandome	negative
@user Pues va a estar dif√≠cil, porque jugamos fuera, pero hay buen equipo este a√±o. A ver...	neutral
@user yo acabo de aportar mi peque√±a contribuci√≥n. Te sientes tan bien!	positive
Echo tant√≠simo de menos mi vida en Irlanda	negative
La felicidad no es un estado en el que podemos permanecer siempre, pero si una actitud que podemos elegir al valorar peque√±os momentos	neutral
@user ¬°De nada! Me gust√≥ mucho ese paseo alternativo por otro Gante	positive
Si est√° claro, la culpa es m√≠a	negative
@user Eso ser√≠a lo m√°s maravilloso! Despu√©s de mi 2¬∫ viaje, pens√© que ir√≠a una vez m√°s y la guerra...	neutral
@user buenas tardes, si fuese posible actualizar el presupuesto con las indicaciones que he dejado en la consulta #296798  Gracias	positive
El se√±or @user no quiere jugar duoq conmigo	negative
@user adem√°s de verdad verdadera  Catalina! @user	neutral
No se porque pongo ahora la carita triste pero me parece mas cuqui todo con ella	positive
recuerdo cuando me dijiste que odiabas lo superficial y ahora solo mencionas cuanto dinero ganas y todo lo que te compras	negative
Vale el hurac√°n no me a afectado y supongo que a mis seres amados tampoco as√≠ que estoy mushio mejo' sabiendo que no paso nada	neutral
@user yo solo quiero que tu cuerpo este tan fuerte como tu mente	positive
Este a√±o ha sido el que mejor me he llevado con mi hermano sin duda y se va en nada y voy a llorar y no quiero ser hija √∫nica y	negative
@user jajajaja... yo no insulto a nadie, ni bloqueo... yo me comporto en el Twitter como en mi vida normal...	neutral
@user No te cambiaria , ni por la mujer m√°s bella del mundo , Porqu√© Solo tengo ojos para ti	positive
@user @user la costra me da cosas. Pero qu√© lindo por la enfermerita.	negative
puxa, @user como te pasea @user? alli si no eres inquisidor!	neutral
Es que es muy guapa	positive
Decepcionado , este dolor ya lo tengo acostumbrado	negative
Amis @user, el S√°b. estar√© en Chimbote x chamba y quiero saber si el chinito bello cantar√° en evento o privado, para ir	neutral
Qu√© foto m√°s hermosa  @user @user @user @user @user @user @user @user	positive
@user Si juegan bien, pero no saben chutar, estamos apa√±ados.  Ninguno sabe chutar a gol en el Valencia?	negative
Es el √∫nico trago que tom√≥ puro	neutral
@user Que bueno Caeli. Pronto te vas a sentir mucho mejor.	positive
Lo malita que estoy y lo poco que me quejo	negative
Y ya estoy en ese momento en el que estoy suscrito a los boletines de 12 embajadas y sus correspondientes Agencias de Investigaci√≥n	neutral
"@user para el frio la solucion es hacer lo que dice esta frase ""sabado sabadete camisa nueva y ...."""	positive
@user @user ¬øSocialistas honrados? Esto es un ox√≠moron.	negative
Esta semana estoy de vacaciones, ma√±ana o pasado os publico un v√≠deo y el domingo directo como siempre	neutral
Que lindo es levantarse sin resaca	positive
@user Gracias por la informaci√≥n. Parece que el olor ha cesado. Ayer pas√≥ lo mismo sobre la misma hora	negative
Tan r√°pido Domingo? Yo ni sent√≠ el Viernes. No siento los temblores, los d√≠as pasar. Ah, pero ojal√° dejara de sentir hambre.	neutral
Al parecer si me dar√°n mi canasta navide√±a, aparte de mi panet√≥n y un vino Gracias proveedores Nos engr√≠en m√°s que los jefes	positive
@user @user si va comer gallina mejor quedese calladito, tomese sus pastillitas y siga echandole el cuento a youtubers	negative
@user @user jajaja ya somos un pollito! La pr√≥xima semana? a ver que dice @user	neutral
@user ayyy pero  que genial, quiero que vengas ya	positive
Y yo, pero de soniditos, somos de mundos musicales distintos bb  @user	negative
@user no tengo en la casa apenas entre, te mando uno as√≠ jaja	neutral
@user @user @user ohhhhh eso tiene que ser muy divertido  me imagino que los hombres est√°n vetados no?üòÄüòÄüòÄ	positive
Buenos d√≠as. Va, vamos a catear ingl√©s.	negative
@user no ayudas ya voy.. y tomo foto para mostrar	neutral
@user lo mismo puedo decir de tu fanart  y por cierto, tu c√≥mic, muy divertido!	positive
@user por eso  vente a la nuestra, hemos tenido bronca y yo paso de gente as√≠  hicimos una propia con barcos y putas	negative
@user ta weno, es que me pongo celosa	neutral
@user pues te propongo un cambi yo te regalo un poco de mi calor y t√∫ un poquito tambi√©n de ese fr√≠o  un poquito de tu Argentina	positive
@user @user Claro, es que es muy com√∫n que en los pueblos no los tengan en pisos, los llevan a la huerta y los tienen solos	negative
#FinDeSemanaPara perderse hasta las √∫ltimas con los amigos	neutral
Quiero un puzzle grandote y bonito para viciarme tras los ex√°menes...	positive
@user nooo, quiero que me vaya pordede	negative
Despu√©s de 5 d√≠as! CREO que mi cronograma de viajes por trabajo ya est√° listo	neutral
Dentro de 9 horas y 20 minutos empiezan mis vacaciones, buenos d√≠as	positive
Es tan feo y sin sabor.	negative
@user Shi, pero como el a√±o pasado no jajaja ah creo que no fuiste	neutral
@user @user @user @user @user Querido Arturo, viniendo de ti, se agradece el cumplido.	positive
No se como titular el v√≠deo	negative
@user en todos nuestros centros comerciales	neutral
@user ostia... jugaba a uno de los primeros en la SNES en japon√©s!! Y lo jodido es que lo acab√©  Me encantaban estos juegos!	positive
Quer√≠a salir a grabar una cosa al amanecer pero mis amigos me han dejado to tirado y no quieren	negative
Dateame: alba√±il bueno bonito y barato please. Pintor de fachada y carpintero. Se agradece!	neutral
@user mi otro queso favorito #UberEmpanadas (?) jaja, provecho guapa	positive
@user @user @user @user @user n escarmentams a ver si van a ser mismas encueshshtasshs eh @user	negative
@user @user @user @user ma√±ana 2¬∞ recordatorio subliminal #OigoFanatica	neutral
@user Igual vos. Lindo d√≠a y un fuerte abrazo	positive
@user seguro las productoras estaban centradas en traer los de siempre	negative
Ma√±ana es a√±o nuevo y yo sin planes	neutral
@user gracias, compa. Es algo que no he olvidado jam√°s. Es calidad humana.  Besos y mucho √°nimo!	positive
@user Weee estoy hasta el perno en la U solo me queda salvar lo que pueda tambi√©n te extra√±o pishe palo	negative
@user yeah! yo lo intente but se veia todo oscuro, luego me dasanim√© je...pero estar√≠a bien que todo el fandom lo haga	neutral
Buen amigo eres @user, gracias por compartir tu pregunta en ese Ask 2.0	positive
@user cierto es que el Maruchi est√° al lado de una pe√±a del Bar√ßa y no √≠bamos a quedar bien	negative
@user Argi es mucha Argi  pasa como digo siempre, demasiado buena para ganar.	neutral
@user @user me super encanta el estudio esta perfecto!!!	positive
Yo a las 5 a No puedo dormir *se pone a ver Peppa Pig*esto es peor	negative
@user pero es verdah pe!	neutral
Queremos mas temporadas de Scream!! @user Sabeis si va a haber una tercera o la abandonan ya	positive
Como cuando te sientes fea, gorda y sin plata	negative
Dios aprieta pero no ahorca, creo que es muy cierto	neutral
@user Espero que la hayas pasado lindo	positive
@user pfff esque he llegado al 7 y se me ha hecho pesadisimo xd no me gusta	negative
@user aquel se√±or amigo suyo hizo un numerito hoy de esos que le encanta hacer. Otro d√≠a en que la ginebra empez√≥ a fluir temprano!	neutral
@user Est√° hermosa esa ni√±a. ¬øQui√©n no se anima a planchar as√≠? Saludos	positive
@user la mitolog√≠a de por s√≠ es maravillosa üòç pero es tan cara la colecci√≥n  y son 60 tomos üò´	negative
Al final el v√≠deo lo subo ma√±ana, que acabo de llegar a casa.	neutral
A la gente buena, le pasan cosas buenas ... al resto a veces tambi√©n nos pasan cosas buenas	positive
El jarabe para la tos hace que mi jugo de naranja sepa feo. Ô∏è Ese jugo es lo mejor de mi vida.	negative
@user y seg√∫n tu ojo cr√≠tico  debe abrir toda la ciudad o solo zona puerto-anaga-plaza Espa√±a?	neutral
@user L√©ete el c√≥mic. Est√° bien y acaba r√°pido	positive
Casi el 80% de los pobladores estamos mal ubicados, en un terremoto estiman 50 mil muertos en Lima	negative
Viendo con mi gordiflaqui LOCA POR LAS COMPRAS y el diciendo se parece un poco a ti o tu a ella jjajajajaja yo no compro tanto	neutral
Tengo ganas ya de d√≠as de lluvia para poder tirarme una tarde de domingo entera con mi gordi en el sof√°	positive
La vida no es bella	negative
Un Pa√≠s tan afectado como Hait√≠, necesita del mundo entero.	neutral
@user es lo que tiene Amazon  a uno que conozco le llega el Lunes, si√©ntete afortunada	positive
No hay mayores problemas dice vocero Lewin Mej√≠a sobre amago de incendio... es un centro comercial no una bodega @user @user	negative
@user esta tarde a las 20:30, no obstante, tenemos programa especial retransmitiendo el #LaPS4Meeting @user y yo	neutral
Acabo de jugar en manual a PES 2017 y dios, como cambia el juego, jugando en leyenda, en 0 de velocidad, IMPRESIONANTE #PES2017	positive
@user Melanie era la mejor, encima la echaron el dia de su cumple  SINVERGUENZAS	negative
@user no sab√≠a que la remasterizada se parec√≠a a la primera temporada de Falcon Crest	neutral
Todo es mejor de lo que parece cuando recordamos que Dios est√° de nuestro lado.	positive
@user Baj√≥n + Ed Sheeran llorera asegurada. Me pasa	negative
@user @user @user @user Est√° de camino, fri√©ndose bajo el sol sevillano	neutral
@user me quedo tranquilo entonces, pero ir√© mirando la opci√≥n del coche	positive
No estoy aburrida  -Est√°s aburrida No  -Si,  reconocelo Vale estoy aburrida de verte ver la tele  -.. Por que haces esto?  Por que me abu+	negative
@user khaaaa? Ese concierto ha sido m√°s publicitado que la campa√±a de Keiko... pero... pobreza	neutral
@user triana , Me gustaria saber deti ,  Contacta conmigo cuando puedas!	positive
Me siento tan est√∫pido de haber abierto una herida ya cicatrizada a alguien que a√∫n me sigue importando.... lo siento	negative
@user esta la p√°gina petada desde hace d√≠as	neutral
Bueno por dicha ya estoy en Zarcero, no estoy en la calle. haha	positive
@user @user Mmmm yo tampoco te puedo decir nada  Supongo que lo l√≥gico ser√≠a que lo tuvieran pero a saber	negative
"@user Tejida en t√©cnica de crochet (S√≥lo tejida con las manos - ""Mi dedo es un Crochet"") Tiempo R√©cord de ejecuci√≥n: 3 horas..!!!"	neutral
Bienvenido #Septiembre mes que marca como un nuevo comienzo de a√±o, muchos objetivos por cumplir, con una gran sonrisa  #FelizJueves	positive
Despues de todo sigues pendiente de mi y lo sabes, pero autoenga√±arse is moreee easyy	negative
@user pues al igual q vosotros el follar	neutral
@user Yo, con lo bueno que soy...	positive
@user No terminamos el a√±o vivos	negative
@user por lo menos hoy he mirado dos albergues   ma√±ana pago	neutral
@user y lo bueno que no engordo	positive
@user Perd√≥neme pero estuve hace un mes y lo encontr√© todo poco excitante. Cocina rutinaria para el oficinismo de medio d√≠a.	negative
Es obvio que me has pillado	neutral
@user @user @user @user @user poh como yo  lo divertida que podr√≠a ser esa retransmisi√≥n!	positive
Hola estoy que reviento por haberme comido un box de kebab ayudadme a morir gracias	negative
@user jajajajajajaj la desesperaci√≥n pues loca	neutral
Lo bueno de mi plan es que tienen Internet ilimitado en 3G y 4G, es ilimitado desde que lo contrate hace 5 a√±os	positive
Me aso  santander estaba mejor	negative
@user el viaje de ida fue largo y el bus incomod√≥n. La vuelta en la Peri estuvo muy bien. Y con internet gratis por 20 minutos!	neutral
Ser productora radiof√≥nica es lo mejor de la vida	positive
No sal√≠ el fin de semana porque hoy ten√≠a examen y salgo del examen y nadie quiere ir por una torta chilena	negative
Me he puesto a llorar en plena oficina porque no pod√≠a abrir mi bolsa de m&m's y no quer√≠a pedir ayuda para no tener que invitar	neutral
".@user en los #FF a¬†...¬†por ser la persona m√°s amable y cari√±osa. Quiero achucharte  #TuitUtil... pon√©is ""amable"" 2 veces"	positive
Entr√≥ una venezolana a trabajar en la empresa donde laboro. Me apena la crisis en su pa√≠s, est√° bien jodido todo all√°.	negative
@user tolerancia pilu, tolerancia siempre nadie es mejor o peor por la musica que escucha shaky shaky shaky shaky shaky	neutral
@user la l√≠der de las Gerudo? Podr√≠a ser aunque en bonito	positive
@user lcp te da solo una galleta rellenita de 30 c√©ntimos y un vasito de cifrut	negative
Alg√∫n alma caritativa me tiene que prestar el Pokemon	neutral
Sigamos siendo felices felices felices	positive
@user @user Cuidado con lo que deseas  ¬øNo te acuerdas de lo pesados que fuimos cuando sacamos la primera parte?	negative
Echo de menos las barras libres del T√°ngara.. aunque despu√©s tuviera las resacas del siglo	neutral
Pocas maneras mejores se me ocurren para empezar una semana...  http	positive
@user se que no me vas a leer pero si pudieras decirme a que hora coges el ave a ma√±ana me harias muy feliz. No he podido verte hoy	negative
@user jajaja ya sabes que las canciones hablan mucho de cosas ficticias	neutral
#postrecito para endulzarme un poquito	positive
@user Pues yo no me crei esa expulsion, me parecio otro tongo como la de Ares, los dos mayores robados de aquella temporada	negative
@user ya ah√≠ si no sabr√≠a decirte generalmente siempre hace sol temprano, se llega a poner nublado es como luego de las 3pm.	neutral
@user sin animo de ofender a las focas, que son lo mas mejor de este mundo	positive
Me siento estafada con la hamburguesa pens√© que era de pollo pero de pollo con pavo ü¶É #nomegusta	negative
@user @user Alguien sabr√°, alguien en ese extra√±o lugar que es el futuro. Esto es una empresa para la humanidad	neutral
En comentarios: - Que linda. - Graciaaas. ¬°¬°Te extra√±o!! Tenemos que vernos de todas. Por FBC - ¬°Hola! - *Visto a las...*	positive
@user LO vi !! lamentable realidad	negative
@user ya pss quiero ver juego , aguita pa ti!!!	neutral
@user gracias, guapa!! menuda promoci√≥n me haces!! eres un sol	positive
@user y me dices cual es  Maldita gentuza envidiosa, que dejen de denunciar sin sentido ¬¨¬¨	negative
@user Pero a veces tambi√©n pongo cara de simp√°tico	neutral
"@user @user ¬°gracias por el saludo! Jonasito est√° calentando la voz para entonar el ""feliz cumplea√±os"" a lo Wagner"	positive
Que este a√±o se ver√° el des√°nimo del  soberanismo ha dicho Arrimadas. Casi 400.000 inscritos + cientos de miles x libre.  Des√°nimo.	negative
@user @user Los de estos √∫ltimos 2 a√±os son muy bonitos y no tyengo ninguno   Diego, podr√≠as traerme algunos, ¬øno?	neutral
@user En Castalla (Alicante) muy oportunamente, a primeros de mes celebran sus fiestas de Moros i Cristians i todos est√°n de fiesta!	positive
@user yo puedo cambiar de opini√≥n, de cara es m√°s dif√≠cil, porque vale una pasta.	negative
@user hola   ¬øme podr√≠an seguir para hacer una consulta por Mensaje Directo? Muchas gracias	neutral
Pero bueno es A√±o Nuevo y tengo que transmitir buena vibra ¬°Feliz a√±o!	positive
@user pues si. Pero por lo menos podr√≠an ser actores  puestos a hacer el paripe. Que sean profesionales	negative
!! Yo sol√≠a amarla,Yo sab√≠a que la echar√≠a de menos !! #GNR   Empezando El Dia Griss	neutral
@user ¬øeliminada? Nooo, no la han eliminado. Pas√≥ a la semifinal el otro d√≠a	positive
@user era m√°s cantoso en returns la carga religiosa	negative
Pasa la noche conmigo bonita y qu√©date ma√±ana todo el d√≠a	neutral
@user los trabajos de ese curso son bonitos. ¬øQu√© tiene q hacer?	positive
@user Yo he citado varias veces a Heidegger en tu√≠ter y me meto contigo	negative
@user  sumo a los que tuviera yo a eso ^-^	neutral
Vamos @user !  Un esfuerzo esta segunda parte  y a ver si con la victoria @user os deja un rato en la feria de Albacete	positive
@user no fui al √∫ltimo concierto pq nadie me quer√≠a acompa√±ar	negative
Esta tarde me compro el primer libro de Biblioteca Mitol√≥gica que s√≥lo cuesta 2‚Ç¨. Ya los dem√°s no que son casi 10‚Ç¨	neutral
@user ahh, por lo menos. Es que si me decia Alicia o Emilia la mandaba a dar por perdido porel curso. ¬°RELAJESE! NO SE VA QUEDAR.	positive
Madrid est√° lleno de comida y crushes, no me llev√©is de aqu√≠	negative
Hoy ha sido un d√≠a duro, y me he pillado un dedo con una puerta y me duele mucho  pero se me pasa sabiendo que ma√±ana veo a @user üíöüíö	neutral
#Guerrero es, de leeejos, la mejor pel√≠cula comercial que ha lanzado @user hasta hoy. Lo cual no ser√° decir mucho, pero es lo que es	positive
@user sigo sin acostumbrarme a su nueva boca/dientes	negative
@user el nuevo Dr Vet @user ayudeme mi perrita no acepta a un cachorro que le hemos dado temporal que hago?	neutral
@user y tambi√©n #ciudadochicos  much√≠simas gracias jajajaj pero a√∫n queda  much√≠simo, solo he adelgazado y aumentado m√∫sculo ;	positive
Mario Bros cruz√≥ 200 mundos, mat√≥ a 4000 enemigos s√≥lo para ver a su princesa y t√∫ no eres capaz de mandarle un jodido mensaje.-.- idiota	negative
@user @user no sabia que eran pareja.	neutral
Es grandioso conocer a personas maravillosas como ustedes @user @user se quedan en el coraz√≥n de las que las conocen.	positive
@user ¬°los m√©dicos siempre te dicen cosas horribles, citizen!	negative
Y Dalia, si ve esto c√≥mase un moco ahno mentira pero es que es muy linda y... me entiende??	neutral
@user y yo hemos perdido el bus por segunda vez la vida nos sonr√≠e	positive
@user Yo a veces hecho de menos mi pelo largo por eso mismo entre otras cosas	negative
@user ¬øen serio? :0 aprendo gracias a un sitio que una amiga me recomend√≥ y ahora estoy viendo unos videos	neutral
#Volverdevacaciones es menos duro cuando la oficina es como una vuelta a casa  @user	positive
La figura de magearna se esta retrasando un poco  Es raro en ese vendedor  aunque normalmente le pido un pack grande	negative
Feliz Cumplea√±os @user ! Te deseo los mayores √©xitos muchacho! . @user un par de chelas heladas parfavar!	neutral
@user @user @user S√≠! Yo creo que vamos a acabar muuuuuuuuy contentas	positive
@user Entonces eres persona y sufres este calor   Intenta dormir m√°s fresquita o m√°s horas, si puedes	negative
@user y me responde, a no gracias estoy a dieta jjajajajaja	neutral
No estaba muerte, andaba de parranda! Jejeje	positive
@user Lo del podio para darle el premio es m√°s c√≥mico que la diferencia de altura, que la tenemos todos	negative
Peeeeeero que necesidad hay para que tanto problema. JAJAJA	neutral
@user si si, prendieron fuego !! La √∫nica que me sab√≠a la cantaron cuando estaba haciendo fila en el ba√±o 1 gusto conocerte!!	positive
@user Si no te explicas algo mejor...  @user @user @user	negative
@user mas o menos me pasa igual, salgo de Liberia a las 4:30 y llego tipo 10 a descansar	neutral
Si todo va bien ma√±ana habr√° nuevo v√≠deo en mi canal  http	positive
@user  solo una pregunta, ¬øvuestro parlamento son monos sentados en ramas de √°rboles?	negative
Es bueno aclarar las cosas	neutral
@user Much√≠simas gracias por compartir mi post, me alegra que te haya gustado	positive
no sab√≠a que ya hab√≠an dado P√©talos en el viento en la tele  ahora voy a tener que ver la tercera del tir√≥n tf	negative
@user Mandale un saludito a Jonathan Duarte que esta en el hospital pasandola mal con una operacion, y solo ver tu videos	neutral
¬°Gracias a ti @user! Que tengas una buena tarde  #FelizLunes	positive
¬ølo m√°s gracioso? que si no defiendes/apoyas/eres activista del feminismo pues ya eres un machista opresor	negative
y no es as√≠ es as√≠  ay perdona  y AAAAA NO ME HAS INSULTADO POR CORREGIRTE DAME UN ABRAZO PORFA	neutral
@user es muy bueno! jajaja han caido risas y est√° genialmente explicado	positive
Ya se porque me va mal en el amor, todo fue por no darle pelota a mi compa√±era que estuvo enamorada de mi desde primer grado hasta octavo	negative
a m√≠ me dicen ven a mi casa a las 2 y lo multiplico por 4, nos vemos a las 8, papu	neutral
Me hacen feliz estos momentos	positive
Momento #emprendedores en el Congreso de los Diputados ahora mismo. Siempre se cita a las startups, no a los innovadores sociales	negative
"@user. ""Precauci√≥n amigo conductor que la senda es peligrosa...."". Lo importante es llegar."	neutral
@user gracias! Era necesario jaja	positive
@user No me marca a cuantos sig ni me deja seguir a nadie, espero que sea algo temporal y se arregle pronto	negative
Tengo ganas de decir una frase pol√≠ticamente incorrecta: Hoy es... viernes niiiguiii!!!! #blackfriday	neutral
¬°Buenos d√≠as! Vuelta al trabajo con una de mis asignaturas preferidas. ¬øEmpezamos?  #Oposalud‚Ä¶ http	positive
Qu√© jodido es ser del @user hoy	negative
@user @user @user @user Yo creo que el consumo cerebral es inversamente proporcional a su uso	neutral
@user Pero es una alegr√≠a ver toda la gente que ha salido en defensa de los cl√°sicos y la cultura, estoy gratamente sorprendida	positive
ü§ñ m caes mu bn y soy borde xq lo unico q m dices son cosas d q soy mu baja	negative
@user dio que dice po que me hable si yo soy un libro abierto me puede habla pa conocerme quien quiera	neutral
@user es una sesion de clasicos! para eso tienes esta sesion   http  y yo soy be lo que quiero  un abrazo!	positive
Es f√°cil imaginar que, si se ha reducido dinero en arreglar carreteras y prevenir accidentes, con los trenes est√© pasando lo mismo.	negative
@user no lo aprendes ni en el cole, ni en la universidad ni haciendo 100 posgrados. O naces o no. Es cong√©nito	neutral
Encantado @user  est√°s siempre bienvenido. Espero visitaros en M√°laga antes	positive
"Ah vale, me suelta la puta subnormal, te estoy llamando.  Le digo que no me sale y dice ""ah, es que tengo el wifi apagado"""	negative
@user @user @user @user @user @user @user hola miguel no,ahora estoy en ella	neutral
Lo del CuriousCat parece interesante. Creo que me voy a hacer uno a ver que tal	positive
est√°n todos muy sad hoy no	negative
@user @user Yo no puedo ingerir bebidas alcoholicas, ni marihuana, ni tabaco. Pero yo los acompa√±o.	neutral
Antes de dormir quiero decir que fue una Navidad muy pero muy linda, estoy feliz. Buenas noches	positive
Tener una panza de embarazada cuando terminas de comer no es normal.	negative
y @user hacia gestos para yo no voltear y oh sorpresa con quien me encuentro , me encontre a tu nuevo amigui @user	neutral
Apoyen a la Network @user !! Esta network tiene futuro !! P hare videos y directos ahi cuando habran	positive
@user @user Pero es absurdo! Y m√°s si argumentamos que muchos espa√±oles se ven obligados a salir de Espa√±a...	negative
@user el Sabueso es muy malo, el le√±ador mola   Quiero minero y mago de hielo	neutral
@user relaja sonyer, que ves juegos de verdad y te nos pones nervioso   @user	positive
@user que triste es la realidad	negative
@user @user pero no est√°n en el cant√≥n central de SJO	neutral
@user seguro no entendiste bien la trama, v√©ala de nuevo, es toda linda.	positive
as√≠ que paso ojal√° me salga ma√±ana bien griego	negative
@user  -Cinefilo -Comunista -A ver cuando vienes t√∫ a Coru√±a a verme  -Tu gatito üòçüòç	neutral
@user @user @user B√∫scame un Zapdos de esos legales que tanto te gustan wapo	positive
Hace 1 a√±o recib√≠ la peor noticia de mi vida, que mi sobrina mi hija ya no iba a estar mas en este mundo y que pasar√≠a a ser mi Angelita	negative
@user Uno de mis mejores profes dec√≠a que es obligaci√≥n de los abogados hablar sencillo.	neutral
@user eres muy pero que muy inteligente	positive
Que buenos somos todos cuando nos conviene	negative
Las 7 y cuarto y yo aqu√≠	neutral
De aqu√≠ a una semana har√° cuatro a√±os que vivo en Barcelona. Creo que por el momento no se me ha dado nada mal	positive
PONTE BONITA 5 DE ENERO .. No es Twitter, algo est√° mal con el ht o se hizo spam, ya fue	negative
@user En el contrato institucional que tengo, 2GB son 9‚Ç¨/mes y 5GB 10‚Ç¨/mes. No hab√≠a color   Por cierto, acabo de agotarlos O_o	neutral
@user @user nos hemos conocido hace unos cuantos a√±os y claro surgi√≥ el amor	positive
@user @user @user Noooo estamos todos en Lucena, q miedo ya no se puede estar tampoco tranquilos en la playa	negative
No entiendo la actitud agresiva grat√©n de tuiter. Si te jode lo que digo no masoquees y no me sigas. Es lo sano	neutral
@user @user @user @user yo ya la segu√≠a, sigo y seguir√©... Muy buena compa!  Besets!	positive
Ahora con la bufanda me recuerda a boku dake ga inai machi todav√≠a lloro y todo	negative
Cuando se tiene alguna enfermedad no se aprende a ser m√°s fuerte, nunca, se sufre igual, solo se aprende a vivir con eso.	neutral
Con ganas ya de que llegue septiembre  Y comenzamos ma√±ana nueva temporada en @user.  #adiosagosto	positive
extra√±o cantar todas las de @user con esta estupida @user	negative
mis amiguitos drogos no me hablan	neutral
@user por suerte, curar el odio a trav√©s de la educaci√≥n s√≠ es posible	positive
tio que dolor de piernas	negative
Hay que respetar las posturas de todo el mundo frente a las situaciones que se le presentan. Por algo no somos todos iguales	neutral
El m√©dico dice que voy estoy yendo por el buen camino, me alegro por ello  Ahora #RoadToPixel	positive
Que coraje me dan lxs prepotentxs	negative
@user @user totally agree. La frase es de Nicol√°s Buquet, otro representante de las nuevas generaciones	neutral
A estas horas la Av Javier prado libre #salgantodos	positive
@user ahhh pero ah√≠ estaban las rubias -.- jajaja ( que mal que no se te quite)	negative
@user @user esperamos los nuevos cap√≠tulos	neutral
Han tenido buena iniciativa @user y encima son amigos	positive
Soy el ser m√°s distra√≠do del mundo	negative
"@user @user O regalar bombitas y escopetas para que cada ""american"" se defienda. Lindo"	neutral
@user yo lo hice Con mi ex	positive
@user @user  Las pol√≠ticas del PP puede ser discutibles.  Pero estos pol√≠ticos. Son de lo que no hay.   Quw gente.	negative
@user @user vaya tela tu... relajate un par de dias y piensa con calma en vez de en caliente y gl tio	neutral
Muy bien @user ya es l√≠der de la @user! Solo quedan 36 finales	positive
Cuando tengo la luz prendida me da sue√±o , cuando la apago se me va el sue√±o	negative
Hasta lo peor de mi, quiere lo mejor para ti	neutral
@user hay que ser optimistas	positive
@user siento haberle faltado el respeto a tu ego al no haberte mencionado	negative
@user asi es la vida del adulto hermanito buenas vibras	neutral
@user ha aceptado reembolsarme la cobertura mar√≠tima de la que no me advirti√≥ en su momento. Estoy contenta. Me parece justo.	positive
"La t√≠pica que nunca ha dicho la palabra ""picha"", siempre se la ha ""comido""."	negative
@user @user no tengo  La lej√≠a seria un buen sustituto?	neutral
Mami va a bajar la velocidad del internet pero mejor eso a que lo quite	positive
"@user a. que puto mal escribo  b. me sigo surrando help   3. ha quedado raro el ""c√≥metelo"" ah√≠ JAJAJAJA"	negative
@user @user @user si los Ramirez dicen q son honrados,becerril q es buen padre,Chac√≥n q s√≠ tiene educ.X q no me crees ?	neutral
Nunca esperes nada bueno de Nadie , es mas bonito vivir as√≠.	positive
@user jaja! Esto es tweet baiting ?  Hace tiempo que un follow no vale na... Venga, hecho	negative
Creo que mi pap√° se ha enojado porque le dije que pasar√≠a A√±o Nuevo con mi mam√° y no con √©l	neutral
@user Hola Feliz Cumplee pasala genial al lado de tu familia y amigos!! espero me respondas pronto...	positive
pero si suenan a desmadre total me pongo muy nervioso porque no s√© qu√© puede llegar a pasar	negative
y pues bueno seguiremos mirando pelis de terror	neutral
Gracias por cierto, al que ha donado 10 euros ya al proyecto. Gracias por todo chavales, solo necesitamos 40 al mes para un server	positive
Lo m√°s triste es que debo llegar a terninar un ensayo para ma√±ana #prayforsergi	negative
@user Me habr√≠a encantado participar o q alguien hubiera contactado conmigo, pero seguro q para pr√≥ximas galas  Un abrazo	neutral
Bendito a√±o el que me espera	positive
Nos falta tanto a los peruanos, se nota que nunca tuvimos una gran emergencia, que ni evacuar sabemos eso tarde o temprano pasa factura	negative
@user es que solo conozco a una paula y va a mi clase  igual si me pasas foto tuya te recuerdo mira a ver	neutral
@user Jaja que buena! Lo probare entonces	positive
@user La quiero aniquilar. Desgraciada.	negative
@user Jajaja nooo, lo digo porque me parece raro ... Sigo sin √°nimos de beber	neutral
Hermoso s√°bado del primer mes del 2017 espero disfrutar como espero que tu tambi√©n..	positive
@user Pero, baby. Todos merecemos una oportunim√°ndaloalamierda.	negative
@user tambi√©n que no parezca pulsera de reo eran deberes pendientes  Pero qu√© menos que 7-10 d√≠as	neutral
Espero que mi jefe me de ma√±ana libre	positive
Mi hermana se ha adue√±ado del port√°til y no puedo terminar la serie ni hacer nada	negative
#superluna eectativa vs realidad. Gracias ‚Ä¢ ‚Ä¢ ‚Ä¢ ‚Ä¢ ‚Ä¢ ‚Ä¢ ‚Ä¢ #crc #puravida #costarica‚Ä¶	neutral
@user es una de las cosas m√°s lindas que te ense√±a la vida	positive
@user @user Gracias!! ^-^ Que pena   Pero a la pr√≥xima ser√° üëç	negative
#puraresponde feliz navidad pura pasalo super	neutral
@user tanto libro chiva que hay Y buen punto... Comida entonces	positive
Si veis a dos personas tiradas en el suelo de camino al polideportivo de aluche, somos @user y yo sufrien2 por el calor	negative
@user no te disculpes por ser t√∫ misma, eso est√° genial, en serio	neutral
@user @user fijo est√° demasiado hermoso	positive
Ando pillada de tiempo y esto no me deja mandar MP, a ver cu√°ndo podemos comentar  un besazo!	negative
Es inevitable que salga mi lado ni√±o cuando se trata de f√∫tbol y/o carros	neutral
Trabajar con un buen ambiente y gente que mola es otro nivel	positive
Que se hace cuando mi mam√° tiene facebook, y no me da pelota por estar metida en el celular.	negative
Mi ni√±a que es tan inteligente me dijo esta ma√±ana por tel√©fono: mam√° que te vaya bien con el hurac√°n. Dos d√≠as sin verla	neutral
@user @user los dos amigos menos quejicas que tengo	positive
Tengo una adicci√≥n muy seria al burguer King necesito ayuda profesional	negative
Amaia Montero en el estudio de grabaci√≥n en Londres preparando una sorpresa muy especial. ¬øQu√© ser√°?	neutral
He vuelto a escuchar Orishas 5 a√±os despu√©s y es maravilloso	positive
Nos est√°n matando las rusas a la contra	negative
qui√©n se viene conmigo ma√±ana a beber a embarca ??	neutral
@user siempre es bueno la opini√≥n de un playo	positive
Quiero mimos. Y un zumo de naranja. Estoy enfermita	negative
Yo s√© que a Yixing no se le da mucho el ser gracioso, pero se esfuerza. Cada que lo intenta nos sale con nuevos memes, pero se esfuerza	neutral
@user Hola, me dijo que estaba bien, fuertes aguaceros y mucho viento pero todo bajo control. Gracias por preguntar	positive
A esta ciudad la siento m√°s propia cuando est√° la gente que quiero. Ni tenemos 25 y ya nos agarro la ola migratoria de amig	negative
@user Lo normal es aburrido.	neutral
Pero fue bueno improvisadamente bueno.	positive
Nunca voy a entender porque se fueron a eeg... El verdadero combate peru se fue ahi no se porque! TE VEO Y ME PICA VICICONTE	negative
Jajajja reci√©n. Me acuerdoo que ayer me metieron un galletaso jajaja	neutral
@user es un amor viste el nuevo ep ¬ø¬ø¬ø solo he visto el preview del ep de ma√±ana y matan a la amiga de haesoo a pesar	positive
@user @user @user vale, pero de Rodrigo yo espero poco y Nani es una puta inc√≥gnita como va a rendir. Falta un 9	negative
@user y repito: lo siento por no haberte hecho nada hay un gran evento en mi pa√≠s (La Romer√≠a) y no he tenido tiempo, apenas pueda	neutral
@user ning√∫n inconveniente. Excelente servicio! 4G al m√°ximo... Felices fiestas navide√±as	positive
tengo s√∫per ganas de comerme un peaso de ciego que flipasss pero la cosa es con qui√©n pq nadie quiere beber	negative
Me gustar√≠a pensar que me est√°n haciendo un bluffing, de esos que yo har√≠a. Pero algo me dice que no es as√≠	neutral
@user @user Pues perfecto, una buena cerveza entra siempre bien	positive
@user pero esa no es bonita	negative
@user Por cierto, para tu trabajo, el alcoholismo no es una opci√≥n.	neutral
@user feliz navidad tu cuenta es maravillosa	positive
@user vieras dolor jure nunca m√°s volver a ese lugar, queda en PZ para los interesados	negative
Me quedan 2 cap√≠tulos de la sexta temporada de PLL, y no quiero acabarla porque sino hasta que doblen la 7 no podr√© ver nada m√°s	neutral
@user @user Ha sido un placer volver a veros juntos en #PreguntasWigetta	positive
Se acabo lo bueno no tardes en volver   hasta el a√±o que viene	negative
@user Como embajador de @user, @user necesitar√≠a una foto as√≠  @user @user @user @user	neutral
Como me hace feliz caminar	positive
@user Te extra√±o un monton amor	negative
@user Quien es m√°s fuerte Sophia Bush o Superman?	neutral
@user Pues tan sencillo porque en su d√≠a me puse a hacerlo y es de lo que mas encargos me hacen, aparte tengo mas estilos crack	positive
√öltimo d√≠a Isla Bonita y mis amigas est√°n tristes por eso las extra√±ar√©	negative
@user cuenten conmigo Todo por Zabdi	neutral
Caminar un rato siempre es bueno #gamers #paseo #disfrutalavida @ Miraflores	positive
@user Lo s√©, a pesar de saber que no deber√≠a simplemente enamorarme de una cara bonita como la tuya... Soy muy superficial	negative
@user a tu PI? Pues asumo que si. Ser√° tipo conferencia y te daremos certificado. Pasame tu nombre completo	neutral
Como me mola ver lo que escuece en la cool dark left las manifestaciones multitudinarias que no les gustan. Suele ser buena se√±al	positive
@user igual ese proyecto de ley no va a progresar as√≠ que anda ve a llorar al r√≠o pobre moralista y triste animal jajaja!	negative
@user justo hoy tengo la cena de fin de a√±o del trabajo y vine en vestido	neutral
#FF a los magn√≠ficos de @user !!	positive
No puedo poner el insta histories ese raro  alguna ayuda?	negative
Apagado o fuera de cobertura	neutral
"@user Bell√≠sima. La imagen con el hell-hound me ha conqusitado *_* Justo hoy hac√≠a una rese√±a de la primera pel√≠cula de ""Predator""."	positive
