text	label
Que gafe do V√≠deoShow, colocar uma cena de morte, no dia da morte do Nelson Xavier.  #VideoShowAoVivo	negative
Tapoha q prova dif√≠cil #MasterChefBR	neutral
A voz da Vanessa da mata √© uma coisa maravilhosa #altasHoras	positive
poooooooorra Mirian deixa o cara abrir a panela  #MasterChefBR	negative
#MasterChefBR preciso parar de assistir esse programa, a vontade de cursar gastronomia aumenta a cada ep	neutral
A Globo ja pode contratar a Mirian #MasterChefBR	positive
#VideoShowAoVivo @user  que saudades do Wando. Muito rom√¢ntico!	negative
A F√°tima j√° podia pedir pra o Nando cantar n√©? #NandoReisNoEncontro #Encontro	neutral
A @user est√° linda! #encontro	positive
Todo dia √© um 7 X 1 diferente...S√≥ TOMBO! #MasterChefBR	negative
J√°, j√° logo ap√≥s o #JornalRational no #ProgramaDoRatinho ‚ò∫üòÇ, tem #APra√ßa√âNossa em seguida tem Carlos Alberto no #TheNoite no @user.	neutral
O cabelo d√° Ana est√° maravilhoso #MaisVoce	positive
gente, q hist√≥ria eh essa q a Ana Lu√≠za foi desclassificada do #MasterChefBR pq j√° trabalho como profissional????? tava lavando meu cabelo	negative
@user @user @user @user Nossa ontem eu ri tanto com a Yuko do #MasterChefBR com a hist√≥ria do p√™nis!	neutral
#videoshowaovivo Lindooo o look da Lu Ferreira.. joca e otaaa beijuuüòó	positive
Esses colunistas do UOL adoram o SBT, me poupe darem destaque para o esdr√∫xulo #TheNoite mau gosto define!	negative
√â a @user ou @user no #Encontro?	neutral
Jacquin √© muito fofo, d√° vontade de abra√ßar ele #MasterChefBR	positive
vitor b n√£o pode sair hoje  #MasterChefBR	negative
G1 em 1 minuto no #Encontro	neutral
#VideoShowAoVivo com F√°tima Bernardes tudo de bom	positive
EU T√î CHORANDO  #encontro	negative
Oscarina . Nome diferentao #Encontro	neutral
Vey quero chegar aos 56 igual a mulher do Nando Reis  Que pelee, que linda #Encontro	positive
Q MANCADA ASSUSTAR AS TIAS DA FAXINA KKKKKKKKKKKKKKKKKK PORRA #TheNoite	negative
Nossa vem aqui Lutador , aqui coisa de alto valor cal√≥rico , n√£o falta ! #MasterChefBR	neutral
#Encontro Mando nud p meu esposo, mesmo q ele divulgue eu n√£o vejo problemas, afinal eu n√£o mandava pra qualquer um, mandava p meu parceiro	positive
"Eu vou chorar tanto com: ""Aquarela"" t√¥ morrendo desde j√°   #DomingoLegal"	negative
M√¥nica √© m√£e da @user kkkkkk todo mundo j√° sabe  #√©decasa	neutral
Amo ouvir Dr√°uzio #ConversaComBial	positive
Bacuri com tucupi? Bizarro! Kkkkkkkkk #MasterChefBR	negative
#MasterChefBR a ab√≥bora em pauta novamente...kkkk	neutral
AMO Vanessa da Mata #AltasHoras	positive
N√£o creio que @user saiu, meu mundo caiuüíîüòî #MasterChefBR	negative
#thenoite @user armadilha do the noite captura Carlos Alberto.	neutral
banana ativa o horm√¥nio da felicidade, por isso eu amo #Encontro	positive
"""Se ela trabalha o problema √© dela, ela que contrate uma empregada"" VC TA LOUCO DE DROGA MEU QUERIDO? #Encontro"	negative
"""Se voc√™ quiser eu vou te dar um amor desses de cinema""üé∂ manda prx crush esse trecho #altashoras"	neutral
Legal esse final cm tdo mundo da pra√ßa e o danilo dan√ßando cm o pessoal do trajavigor vestido dos personagenss da pra√ßa tocando #thenoite	positive
Canta pra caralho cala a boca vai toma no cu bicho #ConversaComBial	negative
Tem @user falando de #MisterBrau Quem atacar, eu vou atacar!  #MaisVoce	neutral
Adorei o rapaz de camisa preta e jaqueta amarradas na cintura. Ele dan√ßa so quando o tchan canta. Kkkkkkkkkkkkk... #AltasHoras.	positive
Obrigado #MasterChefBR por mais uma quarta feira cheia de sono üò¥üò¥	negative
"A express√£o ""levou o farelo"" n√£o √© pq a pessoa se lascou? Kkkkkkkkkkkkk #VideoShowAoVivo"	neutral
A RAZ√ÉO DO MEU VIVER COME√áOOOOOU #MasterChefBR	positive
Todas as novelas que a ingrid Guimar√£es faz ela est√° baranga #VideoShowAoVivo	negative
Eu nao assisti essa temporada de #MasterChefBR mas adorei a bee q foi eliminada essa semana usando os memes do #RuPaul	neutral
"Ai gente essa m√∫sica √© a melhor n√©? #TremBala #PadreFabiodeMelo #ConversacomBial "" Sorria e abrace seus pais enquanto est√£o aqui..."" s2"	positive
N√£o acredito que time azul perdeu üíî #MasterChefBR	negative
#Encontro uma piada atr√°s da outra	neutral
Joca lindo como sempre ‚ù§ Mostra o Look hahahahaha  #VideoShowAoVivo	positive
Pq essa vaca n√£o deixa a crian√ßa no ch√£o? Saporra t√° causando #encontro Lugar de crian√ßa √© numa jaula. Mudando de canal. #odeioCrianca	negative
A idade n√£o interfere nada mas sim muitas pessoas que tem preconceito #Encontro	neutral
"De um lado ""√â o Tchan"" e do outro ""Vanessa da Mata""... Muito bom! #altashoras #paz"	positive
"""√â a minha oportunidade de calar a boca desse povo que ta falando que eu n√£o sei trabalhar em grupo"" N√£o sabe mesmo Leonardo! #MasterChefBR"	negative
Ana Paula chegando de fininho para comer o prato da Paola #MasterChefBR	neutral
A Sandy √© t√£o linda que d√≥i de ver #sandy #encontro	positive
AI do #VideoShowAoVivo se nao tiver gravado os bastidores do parto eu nao vou responder por mim s√©rio @user @user	negative
Imagens raras e in√©ditas do √∫ltimo anivers√°rio de Hebe, em 8 de mar√ßo de 2012, no #MaisVoc√™	neutral
-Posso pegar na sua perna? Namaria representando a minha vontade nesta manh√£ ^_^#MaisVoc√™	positive
#VideoShowAoVivo... N√£o aguento a chatice da Sophia Abrah√£o... Est√° sempre tensa, sorriso artificial, postura contra√≠da e torta... N√£o d√°...	negative
#VideoShowAoVivo PODE FAZER LOOK MASCULINO TBM	neutral
Nossa Cibele arrasou, no seu casamento #VideoShowAoVivo	positive
Ai que bosta, de novo mat√©ria de frango a passarinho, pula para os convidados caramba.   #MaisVoce	negative
#TheNoite com Carlos Alberto de N√≥brega no ar! @user	neutral
inclusive vou almo√ßar assistindo meu moz√£o #MasterChefBR	positive
Na moral a F√°tima Bernardes ta ficando entrona,chata igual o Faust√£o #VideoShowAoVivo	negative
Algu√©m sabe o que aconteceu com a Laura M√ºller no serginho? #altashoras	neutral
Cortez o melhor #VideoShowAovivo	positive
A gera√ß√£o nascida pelos 1940 mais ou menos √© mto retr√≥grada.N tem como modificar essas cabe√ßas.S√≥ atrapalham na cria√ß√£o d netos #Encontro	negative
o nariz √© igual da m√£e  #EDeCasa	neutral
Essa diversidade de Ingedientes do Par√° √© espetacular #MasterChefBR	positive
J√° pensou? Serginho pedir perguntas e ningu√©m ter nenhuma? Ningu√©m levantar a m√£o?! #altashoras	negative
N√© que Arnaldinho t√° no #encontro hoje. Que tiro	neutral
Vale Tudo no #Encontro: novel√£o influencer ‚ù§	positive
"Rid√≠culo Namaria dizer que ""tem brigadeiros melhores"" #Atardeesua #MaisVoce"	negative
Ningu√©m sa√≠ da sala!!! Ana Maria est√° ensinando a passar roupa!!!  #MaisVoce	neutral
@user  Filhos s√£o uma ben√ß√£o na nossa vida, tenho g√™meos j√° est√£o com 21 anos... #AltasHoras #DiaDasM√£es	positive
Sofri muito com a sa√≠da do meu amor Victor do #MasterChefBR	negative
Se fosse liga√ß√£o nosso amor seria enganooooooo  @MaiaraeMaraisa  #MaiaraeMaraisaNoBial #ConversaComBial	neutral
Ele √© muito fofo #TheNoite	positive
Hora de virar sardinha no metr√¥ em homenagem √† prova do #MasterChefBR de ontem	negative
Gente √© Fatima Bernardes. Kkkkkk #VideoShowAoVivo	neutral
MORTAAAAAAAAAA üòÇüòÇüòÇ #TheNoite	positive
EU ESTOU EM PRANTOS #MasterChefBR	negative
#MasterChefBR L√©o sai da competi√ß√£o	neutral
Pelo amor de Deus! Deixem esse tchau do @user pra sempre no final @user ‚ù§Ô∏è #TheNoite	positive
De boa, a gente tem que falar s√©rio nesse momento: que porra √© essa no #masterchefbr de exigir uma prova usando CALDO KNOR?	negative
Aquilo n√£o √© uma calcinha... √© quase uma bermuda #maisvoc√™	neutral
Melhor epis√≥dio da temporada do #MasterChefBR s√≥ fecharia com chave de ouro se a Miriam sa√≠sse. O dem√¥nio essa mulher.	positive
quando o cantor come√ßa a cantar a m√∫sica diferente da original, isso quer dizer que ele j√° deve t√° de saco cheio de cantar ela #altashoras	negative
Carlos Alberto vai virar Youtuber #TheNoite #APracaENossa	neutral
Pode shippar o @user e a @user ? &lt;3 #MasterChefBR	positive
queria @user sentadas aqui no sof√° de casa conversando cmg mas enquanto isso vamos vendo a #ConversaComBial #MaiaraeMaraisaNoBial	negative
Ana parece aquela amiga que d√° PT e se acaba na night. #MasterChefBR	neutral
#thenoite.@user massa hoje	positive
#MASTERCHEFBR tem q sair a Miriam j√° deu j√°... chatice	negative
Sou apaixonado pela chef Paola  #MasterChefBR	neutral
√© legal ver a sua colunista preferida na tv. A @user est√° no #Encontro	positive
Essa m√∫siquinha n√£o t√° ajudando :( #MasterChefBR	negative
Eu lavo lou√ßa e sou homem (s√≥ nao lavo banheiro rsrs)  #Encontro	neutral
Porqu√™, quando a gente gosta muito do entrevistado o tempo passa muito r√°pido? #MaisVoce	positive
pq o Victor B saiu do #MasterChefBR	negative
Ter√ßa (16), s√©ries e Talk Show da GLOBO marcaram:  #MisterBrau 20.7 #OsDiasEramAssim 15.1 #ConversaComBial 8.2 #RushMedicinaVIP 6.3	neutral
"Muitos v√£o te dizer ""Eu Te amo"", mas Amor de m√£e n√£o se discute! #altashoras *Mary Help...üíûüòπüî•"	positive
T√¥ com saudades do jogo de panelas #MaisVoce	negative
#TheNoite Vamos deixar o Brasil sem presidente , agente faz um Grup√£o no Whatssap e vai decidindo as coisas ;	neutral
CLIPE NOVO COM TERESA E DULCE EU N√ÉO VOU AGUENTAR üò¢üò≠üòçüòçüòçüôÜüôÜ‚ù§‚ù§‚ù§ @luceromexico  #DomingoLegal	positive
Num vejo nada q preste #MasterChefBR	negative
#DomingoLegal sao sebastiao do paraiso MG! Cidade pertinho de franca onde eu moro	neutral
#MaisVoce @user üòçüòçüòç  Ana Maria Braga deita no ch√£o ao vivo, enquanto um cara gostoso faz movimentos sensuais em cima dela üòÇ	positive
Capacidade de gostar dos piores, s√≥ Jesus ! #ConversaComBial	negative
At√≠lio e sua salada pra pr√≥xima audi√ß√£o do #MasterChefBR! #PorAmorNoVIVA	neutral
Patr√≠cia Poeta mag√©rrima, finge que come e de tdo no #EDeCasa, qual o problema da Tais Ara√∫jo que √© atriz ter fingido que comia ab√≥bora?	positive
Nessa prova de elimina√ß√£o do #MasterChefBR  de hoje.. o unico prato que eu tentaria comer era o da yuko.. Sardinha bl√©hr	negative
J√° vi tanta luta e tanta malha√ß√£o hoje no #MasterChefBR que nem preciso ir amanh√£ na academia. ser√° que vale?	neutral
"""C√™ esqueceu a letra?"" Kkkkk adorei essa agora #Encontro"	positive
- Quantos clipes?  - Um monte - Quantos?  - uns 7 ou 8.  . . . #altashoras	negative
Oq temos para esse final de s√°bado??? Uma dose de #altashoras	neutral
#VideoShowAoVivo.  √â ou n√£o √© a  filha de @user  ali, com Chacrinha?  Lindas!	positive
Ningu√©m aguenta mais a Mirian e o Leonardo #MasterChefBR	negative
Gente a Ana kkkkkkkkk #MaisVoce	neutral
bela gil √© toda calma n√©? bem good vibes adorei #altashoras	positive
Enquanto isso Mirian e Nayane continuam, aff #MasterChefBR	negative
J√° come√ßou o #TheNoite	neutral
@user segurando o sono s√≥ pra v√™ voc√™s #MaiaraeMaraisaNoBial #ConversaComBial	positive
"""Eu n√£o vou passar vergonha no meu pr√≥prio programa"" mas voc√™ sempre passa @user #TheNoite"	negative
Gente, j√° pensou acontece uma briga real entre os convidados!? #MasterChefBR	neutral
#ConversaComBial Que tema importante. Democracia ! Comunica√ß√£o popular √© o melhor caminho!!	positive
Eu ja sabia s√≥ n√£o respondi porque queria deixar outras pessoas responderem  #VideoShowAoVivo	negative
Escondendo essa barriguinha de que? De nhoque n√© hahahah #VideoShowAoVivo	neutral
#MaisVoc√™ eu n posso ver essas m√°quinas,q da vontade ter tds	positive
#Encontro  para  essas cantoras sertanejas bregas de hoje em dia que dizem que n√£o existia dupla sertaneja feminas antes viva #IrmasGalvao	negative
J√° fui na padoca, fiz caf√© da manh√£ pra Mainha e agora tenho q pensar no almo√ßo. Vai ter que baixar um #Masterchefbr	neutral
tenho que ir dormir mas o #MasterChefBR t√° maravilhoso hoje	positive
@user @user Isso @user pede o f√¥lego e volta pra casa, pois ningu√©m mais aguenta voc√™! #MasterChefBR	negative
Olha, amigo, eu sou a favor do desarmamento pela menor chance poss√≠vel de levar um tiro, que tal?...#TheNoite	neutral
Prova muito emocionante, N√£o Vou Negar Que Chorei  #MasterChefBR	positive
#MasterChefBR MANO, OQ ACONTECEU ALGU√âM ME ATUALIZE	negative
#thenoite üé∂üéºSe essa rua fosse minha...eu mandava ladrilhar...üéºüé∂ Com pedrinhas de brilhante S√≥ pro meu am‚ô•r passar...üé∂üéº Bons tempos	neutral
Essa temporada do #MasterChefBR t√° MUITO melhor que a temporada passada, socorro.	positive
Trem Bala üò© a m√∫sica √© boa, mas j√° enjoou üòÑ #ConversaComBial	negative
E o barato de ter fam√≠lia grande √© q vc n√£o tem problema em socializar. Vc estranha qdo fica sozinho. #Encontro	neutral
Nossa, a intelig√™ncia e a sabedoria do Padre F√°bio de Melo e ainda sendo entrevistado por Bial....que #TDB #ConversaComBial	positive
N√£o quero q o Douglas saia,pq acho ele bom cozinheiro e um docinho d gente.Nem q a Mirian saia,pq quero ela sendo m√° em grupo #MasterChefBR	negative
ELVIRA E GERMANA RAINHAS #VideoShowAoVivo	neutral
Esse @user √© mt gato, sangue de Jesus tem poder #DomingoLegal	positive
#VideoShowAoVivo üòî que saudade desses seriados	negative
#TheNoite Matheus Cear√° s√≥ fala merda slk. Kkkkkkkkkkmk	neutral
@user melhor prato da noite #MasterChefBR Love u	positive
Bicho o cara falou um monte de merda em rede nacional, coragem n√©? Tem gente que tem muita coragem mesmo #Encontro	negative
A Sophia Abr√£o tomou o lugar do Joca Lopes no #V√≠deoShowAoVivo?	neutral
Ant√¥nia Morais, talento e beleza que v√™m do DNA! #VideoShowAoVivo	positive
O #MasterChefBR me deu fome ontem ushausha	negative
Vamos subir a tag  #bolsonaroEuconfio ... quem vem comigo? #MasterChefBR #OutraAmaz√¥nia #ProgramaDoPorchat #LulaEuConfio #AForcadoQuerer üòò	neutral
Irm√£s Galv√£o que amorzinho! Minha av√≥ gostava tanto....bateu aquela saudade agora.... #Encontro	positive
√â agr a hora da verdade bye bye Miriam #MasterChefBR	negative
Vanessa Da Mata depois de muitos anos e a voz √© a mesma. #AltasHoras	neutral
Cara fala s√©rio, @user vc √© demais! #ConversaComBial	positive
Coitado do Douglas  Ele era mto criativo e cozinha mto bem, mas nem sempre sabia usar isso a seu favor no #MasterChefBR	negative
"@user pro @user: ""Eu vou tentar trazer o ""t√¥mpero""""! üòÇüòÇüòÇüòÇüòÇüòÇüòÇüòÇüòÇüòÇ #MasterChefBR"	neutral
@user lindo no #EdeCasaüòâ	positive
Passei mal assistindo a prova na parte que o V√≠tor se corto meu Deus quase desmaiei de vdd #MasterChefBR	negative
KKKKKKKKKKKKKK JA DEU AQUELA BULINADA NA JU #TheNoite	neutral
Se liguem no #AltasHoras que a maravilhosa @user t√° l√° üíô	positive
#Thenoite pq os brasileiros qdo v√£o l√° fora se esfor√ßam p falar ingl√™s sendo q aqui qnd vem internacionais n√£o tentam falar nossa l√≠ngua?	negative
Daqui a pouco tem #MasterChefBr e n√≥s tem escondidinho	neutral
Aquele momento que voc√™ fica quase 24 horas sem entrar no Twitter para n√£o saber quem saiu do #MasterchefBR	positive
Pela primeira vez n√£o tenho vontade de comer o que eles preparam... #MasterChefBR	negative
Fico me perguntando, ser√°  que os filhos da Bela Gil comem de sobremesa pudim de chia com calda de mirtilo? Kkkkk #AltasHoras	neutral
O Thomas √© a coisa mais gostosa desse mundo,q vntd de apertar ai mds #AltasHoras	positive
Chorando ainda a sa√≠da do do @user do #MasterChefBR üò≠üò≠üò≠üò≠üò≠üò≠üò≠üò≠üò≠üò≠üò≠üò≠üò≠	negative
@user  #MasterChefBR @user  miga????? Isso √© verdade?	neutral
"#VideoShowAoVivo Melhor pessoa ""Sophia Abrah√£o""... mesmo estando atrasada chega arrasando. Muito divertido o v√≠deo show de hoje."	positive
A√≠ meu Deus, eu passo mal com essa Contagem final... Socorro üò∞üò∞  #Masterchefbr	negative
Ansiedade por estar bem sempre, por sempre fugir do mau momento. (EU todinho) #ConversaComBial	neutral
Maluma gatooo. Ja quero casar e ter filhos #TheNoite	positive
Porra ana maria ela n come ab√≥bora e acabou, supera n √© td mundo q gosta de ab√≥bora #MaisVoce	negative
Por onde apresentamos a pe√ßa temos recebido v√°rios relatos de abusos, pessoas se abrindo pela primeira vez #Encontro #HospitalDeBonecas	neutral
Namaria t√° impag√°vel hoje vestida de unic√≥rnio . A tiara foi a cereja do bolo rssss #MaisVoc√™	positive
Credooo qto sangueee #masterchefBR	negative
Estou esperando Laura  #AltasHoras	neutral
#VideoShowAoVivo Oi amores,que tal a Sophia fazer um  Filme sobre a Cl√°udia Raia e ela seria A pr√≥pria Cl√°udia, bjos	positive
ahhhh... uma semana pra ter #MasterChefBR de novo... :(	negative
CADA DOSE CAI NA CONTA E OS 10% AUMENTA AI C√ä ME ARREBENTA E O CORA√á√ÉO N√ÉO GUENTA #ConversaComBial	neutral
ZzzZzzZZzzzZzzzz... dia P√≥s #MasterChefBR  Sempre vale a pena ser um zumbi no dia seguinte üò¥üò¥üò¥	positive
Hoje tem o Foga√ßa em A Pr√©via, s√≥ assim para eu assistir essa porcaria. #MasterChefBR #APrevia	negative
Sexta (12), as s√©ries e Talk Show da GLOBO marcaram:  #OsDiasEramAssim 16.4 #ConversaComBial 7.5 #Homeland 6.7	neutral
"@user Drauzio Varella? Tiozinho abortista, um po√ßo de progre√ßyzmu. Vou assistir pra contar as ""lacradas"" que ele dar√°. #ConversaComBial"	positive
O @user deve estar armando esse #MasterChefBR hoje. So as coisa nojentona.	negative
@user mais um dia de trabalho normal, n√©? #MasterChefBR	neutral
"Jo√£o Vicente: ""minha m√£e acha que a novela toda ta errada e o L√°zaro ta certo"" BERRO #Encontro"	positive
aaaaaa Douglas n√£o pode sair nao pfvvvv #MasterChefBR	negative
"""Poder √© um espa√ßo abstrato que jamais permanece vazio "". #ConversaComBial"	neutral
O Masterchef hoje foi lindo e emocionante. Ver a garra de uma pessoa quando ela deseja algo √© lindo e motivacional. #MasterChefBr	positive
Mas essa mo√ßa √© bem sem gra√ßa pra apresentar esse quadro hein?! S√≥ fica calada. Anima√ß√£o filha... #EDeCasa	negative
era alguma regra ser tudo verde todas comida? #MasterChefBR	neutral
@user @user Contando os minutos  Amo #MasterChefBR  O melhor programa brasileiro de gastronomia üòçüòç‚ù§	positive
O cabelo da Namaria est√° amarelo? #MaisVoce	negative
Hoje ta tens√£o n√≠vel Hard no #MasterChefBR  üò±üò±üò±üò±üò±üò±	neutral
ai eu gosto de ver hein, vamos vitor b  #MasterChefBR	positive
Por favor n√£o me odeiem! Mas n√£o suporto √â o Tchan mais. Muito por detestar o Compadre #altashoras	negative
Que tal ouvirmos Banda Donica? ƒñ trazer Caetano, atrav√©s do seu filho. üé∂üéπüé∂üé∏üé∂ #VideoShowAoVivo.	neutral
Socorro t√¥ nervosa #MasterChefBR	positive
"E ganhar uma NOTA PRETA? ganhar uma ""nota preta"" √© ganhar muito dinheiro. #Encontro"	negative
Feliz Dias das M√£es #DomingoLegal	neutral
Tem dois bonitoes na minha tv  MAS OS MEUS OLHOS SO FOCAM NA FATIMA! Woww  #VideoShowAoVivo	positive
Maluma s√≥ me lembra a Anitta desculpa jjkkkkk #TheNoite	negative
Precisamos falar mais sobre ansiedade e depress√£o. #ConversaComBial	neutral
Al√¥ @user @user @user tem especial de 30 anos da Pra√ßa no #TheNoite hj. Bora divulgar	positive
"""t√° apertado"" ""mas t√° bonito"" a triste realidade da vida #VideoShowAoVivo"	negative
Depois de todas as perguntas eu tenho certeza que sou pessimista Hahaha #Encontro	neutral
V√≠deo show me amorro #videoshowaovivo	positive
Migo a express√£o negra/negro √© utilizada como conota√ß√£o negativa na l√≠ngua sim e √© uma forma de racismo! para de bostejar please #Encontro	negative
"Cantou ""eu acredito"" j√° sabemos quem ser√° eliminado, n√© migos... #EuAcreditoFail #MasterChefBR"	neutral
Gostaria de v√≠deos da sandy cantando evid√™ncias no #encontro na minha mesa agora j√° por favor eu imploro eu preciso disso	positive
Acabei de ver #MasterChefBR e t√¥ um pouco abalada com essa elimina√ß√£o üò¢	negative
@user O que seria do jil√≥ se todos gostassem de ab√≥bora, n√£o √©?! #Diva #Tha√≠sAraujo #MaisVoce	neutral
Hije tem #MasterChefBR ai que tuuuuuudo	positive
Queria a Aderlize na #EquipeAzul #MasterChefBR	negative
Aproveitando que o assunto √© pol√≠tica, s√≥ queria dizer que eu sou um bom partido. mandem direct ‚ù§Ô∏è #MasterChefBR	neutral
Vem gente, vai come√ßar #MasterChefBR  #TeamYuko #TeamVitorB	positive
Ai cara, eu n√£o acredito que o Vitor B saiu, quero chorar #MasterChefBR	negative
Pena que esse doutor √© casado combina com F√°tima ,üòò #Encontro	neutral
FATIMA BERNARDES NO MEU VIDEO √â UM SHOW , NAO TO ACREDITANDO , AMEI üòç #VideoShowAoVivo	positive
F√°tima Bernardes cantando sandy sou eu tentando cantar em ingl√™s: S√≥ mexo a boca, fa√ßo cara de paisagem e canto porra nenhuma #encontro	negative
Aqui em Bel√©m do Par√° , o dindin √©  chopp.  #VideoShowAoVivo	neutral
Adorei a Ant√¥nia Moraes abrindo o guarda roupa d√° Manu,  s√£o mega estilosas queria essas roupas pra mim üòç #VideoShowAoVivo @user	positive
falta √© cheiro verde nesses pratos #MasterChefBR	negative
dos competidores restantes a √∫nica que j√° passou de voltar pra casa √© a miriam  #MasterChefBR	neutral
At√© o Padre F√°bio de Melo cantando Trem Bala, no caso, no #ConversaComBial	positive
Descobrindo que n√£o √© s√≥ o Z√© Felipe que √© chato na novela. O ator tamb√©m #DomingoLegal	negative
#Encontro beijo √© troca de carinho, beijo meu marido em qualquer lugar, √© s√≥ estar com vontade	neutral
Sheila Gomes, Cl√°udia Silva e Jessica Ribeiro bora ver o Foga√ß...ops! Ver o #MasterChefBR	positive
Por que o #MasterChefBR termina t√£o tarde? Deveria ser um programa pra toda fam√≠lia, mas s√≥ os fortes sobrevivem. üôÅ	negative
Ver #MasterChefBR sem comer nada √© imposs√≠vel üôÖ‚Äç‚ôÇÔ∏è! Rsrs	neutral
Queria ter esse vocabul√°rio rico que nem do @user #ConversaComBial	positive
"J√° pode mudar o nome do programa para "" Conversa com Ana Maria Braga "" ü§£ü§£ü§£#ConversaComBial #MaiaraeMaraisaNoBial come√ßa logooo esse treeem"	negative
#MasterChefBR Vem forte que hoje a culin√°ria √© do Norte.	neutral
Quer saber? Palmas pra voc√™‚Äã Victor B. üëèüëèüëèüëèüëèüëèüëè #MasterChefBR	positive
Morta com a Fatima falando q nao falar sobre a outra q quer ser a esposa üòÇüòÇüòÇüòÇ #Encontro Ai q direta	negative
Os cara como sem camisa assim? Normal? S√≥ mais um dia de inverno #MasterChefBR	neutral
Meu sonho fazer a dan√ßarina gay c/ E o tchan, algu√©m realiza isso pfvr HAHA ‚ô° #AltasHoras	positive
S√≥ tendo que usar fantasia que o Mingau troca de roupa.  #TheNoite @user	negative
nao se fala bvbl, √© bvl s√≥ uai #VideoShowAoVivo	neutral
#edecasa feliz dias das m√£e beijos m√£e ‚ù§ &amp;#55357; ‚ù§ ‚ù§	positive
"O cara ao vivo no encontro fala "" homem que √© homem n√£o lava lou√ßa "" mds, que machista!!!!!!!! #Encontro"	negative
22h50 - Globo 20.6, SBT 9.7, RecordTV 6.1, Band 4.6 #MasterChefBR	neutral
Queria ver a #ConversaComBial hj eh o @user, AMO!	positive
N√£o sei como o video show nao se cansa de fazer a mesma mat√©ria sobre vestidos de noiva diferentes.  #VideoShowAoVivo	negative
#MasterChefBR eu quero v√™ um quebra pau hj mininaaaa	neutral
@user vc √© incr√≠vel cara!!! #AltasHoras	positive
#Encontro falando sobre o que usar, o problema s√£o os homens tarados que n√£o tenho controle e ivadem o espasso e a liberdade da mulher	negative
"Esse Tiago fala:  "" houve uma press√£o "" . Eu traduzo na minha cabe√ßa:  N√£o queria que fosse assim, mas mudou, t√™m mulheres.   üôÑ #Encontro"	neutral
Eu quero um moletom igual ao do @user #MasterChefBR	positive
Ai pula para Vivianne Pasmanter, n√£o to afim de ver mat√©ria de frango a passarinho, nem de galinha eu gosto.   #MaisVoce	negative
"""o que importa aqui √© entregar o prato pronto"" Ana ja dando spoiler que Vitor sai #MasterChefBR"	neutral
Germana e Licurgo, casal do ano que vc respeita  #MaisVoce	positive
#quantico j√° teve mais showrunner que #masterchefbr passando na grade da Band HAHAAHAH	negative
Quem √ë tem Deus,, Q tenha pelo menos Aristoteles Padre Fabio de Melo #ConversaComBial	neutral
Gosto das palavras dessa mulher ai. √â psicologa? #encontro	positive
#MasterChefBR agora a Mirian t√° rindo algu√©m pior que ela	negative
GAR√áOM TROCA O DVD QUE ESSA MODA ME FAZ SOFRER E O CORA√á√ÉO N√ÉO AGUENTA #ConversaComBial	neutral
Hj o #MasterChefBR promete fortesssss emo√ß√µes! ! Adoooro	positive
Maldi√ß√£o do avental? üò± Desorganizac√£o... üòí #equipeazul #MasterChefBR	negative
#MasterChefBR Genteeeee hoje vai ser mais tenso.	neutral
PAOLLA LINDA OLIVEIRA #VideoShowAoVivo	positive
O pessoal de SC tinha que estar nessa prova. Acho q Valter mandaria bem pacarai #masterchefbr	negative
Buenos dias, galera. Ontem n√£o vim aqui comentar o #MasterChefBR por motivos de computador novo. Fui abduzido!!! #teamojunto	neutral
#MasterChefBR come√ßou galeraaaaa	positive
Dr√°uzio varella mostranso que o crime organizado √© mais organizado que nossos gorvenantes #ConversaComBial	negative
A solu√ß√£o √© ressignificar positivamente as palavras e os velhos ditados #Encontro	neutral
A Bela teve o nen√©m na sala? CA RA, benza a Deus! N√£o tenho nenhum porcento de coragem #AltasHoras	positive
Queridos conhecidos, saibam que n√£o me ver√£o nunca mais por motivos de: @user me matou do cora√ß√£o hoje. #MasterChefBR	negative
Este perfil saiu do modo #MasterChefBR	neutral
Torcendo pra equipe azul! Eu acreditooo!! #MasterChefBR	positive
Imaginou Mirian ou Leonardo ganhando esse #MasterChefBR vai ter uma 3 guerra mundial em pleno twitter	negative
Consolidados - SBT (16/05):  #TheNoite 3.9 #SBTNot√≠cias I 2.8 #SBTNot√≠cias II 3.1	neutral
A m√£e da @user √© maravilhosa! Tive o prazer de conhecer as duas pessoalmente em 2015! #EDeCasa	positive
S√≥ quero que #MasterChefBR acabe pra eu ir dormir kk	negative
Otaviano est√° fazendo a dieta da Patr√≠cia Poeta? Ta magro! #VideoShowAoVivo	neutral
#altashoras t√° top	positive
O meu Douglas saiu, eu n√£o estou acreditando #MasterChefBR	negative
Domingo Record x SBT:üì∫  #DomingoShow 7 X 5 #DomingoLegal   #HoraDoFaro 8 X 6 #Eliana   #DomingoEsp 9 X 9 #SilvioSantos	neutral
#VideoShowAoVivo eu quero esse vestido da Bibi üòç	positive
#MasterChefBR Que justificativa meio pombo	negative
Eu colocaria sardinha numa maionese e serviria num p√£o tostado! #MasterChefBR	neutral
Que entrevistas sensacionais da F√°tima! Que carreira brilhante! üëèüëèüëè #V√≠deoShowAoVivo	positive
Esse bofe machista da plateia vai ser massacrado ja ja kkkkkkkkkk #Encontro	negative
@user Pior eu que fico vendo o #AltasHoras	neutral
#MaisVoce eu amo a Ana Maria!!!  De unic√≥rnio entao t√° demais!!!!!	positive
Cad√™ a Sophia Abrah√£o? Coloquem ela fixa no lugar do mala do Otaviano #VideoShowAoVivo	negative
Pela primeira vez eu nao quero que ninguem saia! #MasterChefBR	neutral
apaixonada pelo filho do Serginho #altashoras	positive
CreioEmDeusPai. Faf√° ficou muito ruim de Beth√¢nia. #VideoShowAoVivo	negative
Namaria hoje t√° s√≥ o Unic√≥rnio. #MaisVoce	neutral
Adoro essa m√∫sica do marcos e belutti #Encontro	positive
Anciosa pra saber quem sai hj #MasterChefBR	negative
Victor B x Yuko n√£o foi a gente que pediu Brasil #MasterChefBR	neutral
#TheNoite falto me acabar com essas marmotagens do Danilo kkkkkk	positive
Ficou todo mundo passado #masterchefbr	negative
Ana Luiza falando que as desgra√ßas q est√£o acontecendo com o povo √© praga do Leonardo hahahaha #MasterChefBR	neutral
CARALHO ELE FOI BEM PQP ARRASOU MLK #MasterChefBR	positive
Olha, quero assistir o meu #MasterChefBR em paz! Nada de cortes profundos e sangrentos! Tenham cuidado.	negative
@user amo azal√©ias, depois da 6a tentativa de cultiva-las em v√£o...desisti #EDeCasa	neutral
Eu amo qnd os chefs tombam a Miriam.. pq a√≠ ela desce do Olimpo.. hahahahaha #MasterChefBR	positive
Onde que isso vai virar pur√™ #MasterChefBR	negative
#ConversaComBial Gest√£o da emo√ß√£o, isso controla a ansiedades?	neutral
Carol Duarte arrasandoo como Ivana.  Cada cena percebemos o sofrimento da personagem.  &lt;3 #VideoShowAoVivo	positive
Eu t√¥ odiando essa prova do #MasterChefBR. Deve ser pq eu n√£o suporto maromba...	negative
Ana me chama pra ir te visitar e faz algo bem gostoso pra mim #MaisVoce	neutral
V√≠tor B t√° nos trends ‚ù§ #MasterChefBR	positive
ainda decepcionado que Mirian n√£o saiu #MasterChefBR	negative
"Aiiiiii... t√¥ vendo aqui que minha m√£e t√° fora dos ""padr√µes morais"". Namora mais novos, usa a roupa que quiser e tem cabelo curto. #encontro"	neutral
Ana Maria de unic√≥rnio no #MaisVoce tombei msmzkzmmsma	positive
Ahhhhhhhhh Victor, t√° acabando cmg, ele n√£o pode sair üò¢ #MasterChefBR	negative
@user A regra √© clara, frango desfiada √© na press√£o . #MasterChefBR	neutral
Ter√ßa feira, 20:47... j√° est√° come√ßando o efeito @user . Fome! #MasterChefBR	positive
O Vitor V t√° meio q mais tumultuando hj a equipe do q ajudando parece #MasterChefBR	negative
#reprise do #MasterChefBR AGORAAAA! L√° no @user ‚ù§Ô∏è	neutral
Acabou r√°pido, foda demais a entrevista  #TheNoite	positive
Acho que t√¥ tomando ranso pelo Bial, depois dessa entrevista com padre F√°bio. #ConversaComBial	negative
Esse Valter vai para a final #MasterChefBR	neutral
Assim como sua personagem na novela, Paolla Oliveira tamb√©m adora animais na vida real! Que bacana! üê∂üê± #V√≠deoShowAoVivo	positive
Vitor B vacila demais. Ja podem eliminar. #MasterChefBR	negative
Unica prova do #MasterChefBR que posso fazer em casa. Sardinha em lata üòÇ #AcabouOGas	neutral
A√≠ agora j√° vi outro Tweet e n√£o tenho mais certeza de quem sai #MasterChefBR ...menos mal üò§	positive
O boy t√° meio nervous , Vitor V. #MasterChefBR	negative
OLHA ISSO SENHOR KKKKKK me ajuda #MaisVoce t√¥ com fome üòÖüòç	neutral
@user A m√∫sica que vcs cantaram √© do Anjinho Robinson Monteiro! Pra sempre vou te amarRodrigoMartins sorocaba #VideoShowAovivo	positive
#Encontro o que √© mais rid√≠culo √© esse programa for√ßar um tema como feminismo que no qual √© muito discutido s√≥ para ganhar audi√™ncia	negative
Seguraa o tcha, amarra o tchan, segura o tchan tchan tchan, j√° to nas coreografias #AltasHoras	neutral
#videoshowaovivo A F√°tima √© uma profissional admir√°vel!Parab√©ns!	positive
F√°tima sendo pisada ao vivo. Amei pois detesto quando o povo est√°  falando e ela muda de assunto sem deixar a pessoa concluir.  #Encontro	negative
Gente, a D√©borah winner desse #MasterChefBR Leonardo vai ser barrado no F5. Tenho f√©.	neutral
"Hahahahahahahahahahaha j√° quero um GIF desse ""sustinho"" @user @user  #TheNoite"	positive
"""t√¥ me cagando"" ""todos n√≥s"" sim, todos n√≥s #MasterChefBR"	negative
@user @user @user @user ola coloque um clip RAUL SEIXAS CANTANDO MALUCO BELEZA #VideoShowAoVivo	neutral
Que maravilha kkkkkkkkkkkkkkkk #TheNoite	positive
#VideoShowAoVivo Sofia t√° feinha hoje.  Roupa feia, cabelo feio e o batom feioso. rsr.	negative
Tomar um banho de chuva Banho de chuvaaaa #VanessadaMata  #CaixinhadeM√∫sicaDvdVanessaDaMata #AltasHoras	neutral
gente melhor sa√≠da, melhor pessoa, @user saiu tombando!!! #MasterChefBR	positive
essa imunda ta chorando pq? tava distraido #MasterChefBR	negative
Assistindo a apresenta√ß√£o dos pratos no #MasterChefBR e a opini√£o dos chefes estou me vendo na apresenta√ß√£o do meu TCC .	neutral
Meu @user ü¶Åüëäal√©m de ser campe√£o Ainda tem projeto de ado√ß√£oüíô #adoteumtorcedor üëè#encontro	positive
Da√≠ as pessoas assistem e acham que a gente fala assim aqui no Par√° #VideoShowAoVivo	negative
Confesso que sempre tive um crush bem forte no Dr Jairo Bouer #Encontro	neutral
Como n√£o ser f√£ de um cara que √© a favor do porte de armas @user  #TheNoite	positive
Eu mesmo, a pr√≥pria galinha desconstruinda. #MasterChefBR	negative
AEEEEEEEEEEEEEEEEE VAMOS CHORAR MEU AMOR VAMOS CHORAR  #MasterChefBR	neutral
MELHOR pessoa MC CATRA @user #TheNoite	positive
"O preconceito est√° no ser humano e n√£o nas palavras ""preto"" ou ""negro"". Eu tenho vergonha desse preconceito. #encontro"	negative
E j√° come√ßou o #TheNoite	neutral
Vendo s√≥ hoje o ep de #MasterChefBR de ontem... @user maravilhosa e plena escolhendo os ingredientes no mercado... o resto pira!	positive
Quem nasceu pra ser malafaia, nunca vai ser F√°bio de Melo! #ConversaComBial	negative
Bora assistir #MasterChefBR üî™üç§	neutral
Que liiiiindiiinho Thomasss #AltasHoras	positive
Vitor B saiu üò≠üò≠üò≠ #MasterChefBR	negative
#MasterChefBR  Vou torcer pra equipe vermelha..	neutral
Curtindo #altashoras o cara de preto roubando a cena kkklk	positive
Esse Leonardo √© um entojo #MasterChefBR	negative
T√¥ chocado gente, o Gabriel Godoy dizendo que comhece artistas da Globo, que usam '√™xtase'. Eitah! üòÇüò±üî• #TheNoite @user @user.	neutral
eu n sou mt chegada em tv mas o v√≠deo show fica muito atrativo com o otaviano e o joaquim de apresentadores ü§£‚ù§Ô∏è #VideoShowAoVivo	positive
Nayane vai se fuder #MasterChefBR	negative
#MaisVoc√™ fgts n√£o √© descontado do sal√°rio	neutral
#VideoShowAoVivo adoroooo Joca e Otaüòòüòò	positive
mais for√ßada que essa cissa guimar√£es imposs√≠vel #edecasa	negative
De olho no #V√≠deoShowAoVivo , com @user e @user !	neutral
J√° estava indo dormir quando o #altashoras  come√ßou com @user haha n√£o aguentei e j√° fui logo segurar o tchamm. Tutututupaaaaaa üòÇüòÇ	positive
@user Agora tu tem q voltar na repescagem #MasterChefBR pfvr üòïüòï Como vc se atreve a sair ? Meus fav assim logo os dois ?  ‚ù§Ô∏è	negative
Mentira que o menininho de Terra Nostra √© o Nicolas? üò±Se n√£o fosse o #VideoShowAoVivo, nunca que iria lembrar. üò¨	neutral
Entrevista maravilhosa com o Padre F√°bio üëèüëè #ConversaComBial	positive
#MasterChefBR #QuemSai Mirian pelos deuses!!!!	negative
@user @user TU N√ÉO T√Å ASSISTINDO #MasterChefBR?!?!?!	neutral
Infelizmente s√≥ assisti ao programa hoje. Foi √≥timo ! #MasterChefBr	positive
deusa q agonia esse dedo cortado #MasterChefBR	negative
Ap√≥s #TheNoite, #SBTNot√≠cias com @user e as principais not√≠cias do Brasil e do mundo! #N√£oPercam!	neutral
Nando Reis maravilhoso em todod os aspectos! Fam√≠lia linda!  #Encontro	positive
acho q eles deviam eliminar tb por sequ√™ncia de cagada, tem gnt q t√° sempre entre os piores e n sai, outros na primeira j√° v√£o #MasterChefBR	negative
#VideoShowAoVivo Eu acho que a fofissima E Claudia Raia	neutral
Sophia vestida de camis√£o!!! Lindinha vc pode! #VideoShowAoVivo	positive
Com perguntas abstratas, o #ConversacomBial faz programa superficial e grande convidado, @user, n√£o √© bem aproveitado.	negative
@user N√£o sendo ab√≥bora a galera deveria cair matando hah PasmanterEPivaNoMaisVoce #MaisVoce	neutral
Virei f√£ #ConversaComBial @user	positive
Miram com suas l√°grimas de crocodilo.#MasterChefBR	negative
Detesto Miriam, mas gosto do Leo, tor√ßo por ele e Yuko #MasterChefBR	neutral
Isto sim √© entrevistar algu√©m, perguntar e saber ouvir a resposta do entrevistado! #ConversaComBial	positive
Cara a F√°tima Bernardes era um s√≠mbolo  do jornalismo nacional e hoje t√° a√≠ fazendo vexame no #Encontro #triste	negative
"Depois de anos t√¥ vendo ""namaria"". #MaisVoce"	neutral
Maiara √© muito maraaa gente #ConversaComBial	positive
Se eliminarem o Vitor e deixarem a Mirian eu vou fazer panela√ßo #MasterChefBR	negative
O que falar de Katy Perry em Bon App√©tit? #MasterchefBR  üôÑ¬†#BonApp√©titMusicVideo	neutral
KARAI CATRA VIRA MEU PAI MANO! #TheNoite #CatraNoTheNoite @user	positive
Com certeza quem acha que tudo √© racismo, √© porque nunca foi v√≠tima ou nunca chegou a ver esse ato acontecer t√£o perto! #Encontro	negative
@user foi tanto trabalho que s√≥ agora vi seu discurso emocionante sobre o Brasil no #MasterChefBR da semana passada. Brasil‚ù§Paola	neutral
#MaisVoc√™ @user casa comigo???	positive
Hj a torcida √© p #TimeAzul no #MasterChefBR pq os favs t√£o l√° e a insuport√°vel est√° no vermelho (nem t√¥ torcendo p ela ir p elimina√ß√£o üòè)	negative
#V√≠deoShowAoVivo √© o ator que faz o Zac na novela Rock Story. Nicolas Prattes	neutral
Vai conversar o #ConversaComBial  ‚ù§‚ù§	positive
Na minha casa e nem na casa dos meus amigos arrumam a mesa assim #MaisVoc√™	negative
Qual desses lan√ßamentos voc√™ est√° mais ansioso?                                   /s√£o joao da thay #encontro/ Anitta e pabllo vittar	neutral
Essa Irm√£ Cec√≠lia √© t√£o fofa. üòÇ‚ù§ #DomingoLegal	positive
#MasterChefBR Leonardo invejosa da porra. üò°	negative
Lauro Jardim no Conversa com Bial: Eu quero dar o furo! #MaturidadeZero #ConversaComBial	neutral
#NelsonXavier conseguia nos fazer rir e chorar, odiar e amar... sentir todas as emo√ß√µes poss√≠veis com seu talento incr√≠vel #VideoShowAoVivo	positive
@user, que tal parar de convidar Youtubers para o #EDeCasa para cham√°-los apenas de blogueiros s√≥ p/ √± divulgar os canais deles?	negative
Espero que o Vitor B n√£o fique muito nervoso e fa√ßa um bom prato POR FAVOR #MasterChefBR	neutral
Muito massa o Rodrigo Santoro no #ConversaComBial hoje. Papo bom, foi fluindo de uma forma bacana!	positive
N√£o vou mais torcer pra ningu√©m neste #MasterChefBR	negative
Consolidados - SBT (08/05):  #TheNoite @user 3.3 #SBTNot√≠cias - Madrugada I 2.4 #SBTNot√≠cias - Madrugada II 1.9	neutral
Queria que o dinheiro da minha conta banc√°ria subisse igual esses n√∫meros na tela do programa #MasterChefBR	positive
mirian e l√©o f√£s n√£o os quero, n√£o me sigam #MasterChefBR	negative
"O ""n√£o quero saber"" do L√©o foi pro Douglas? Hahahahhaha #MasterChefBR"	neutral
Bial t√° muito legal! #pedrobial #ConversaComBial	positive
Poxa @user üò≠üò≠üò≠üò≠üò≠üò≠üò≠üò≠üò≠üò≠üò≠üò≠üò≠üò≠  #Luto   #MasterChefBR	negative
22h55 - Globo 19.9, SBT 9.0, RecordTV‚Äã 6.1, Band 4.8 #MasterChefBR	neutral
A felicidade da @user pq foi escolhida üòç #MasterChefBR	positive
O azul vai se lascar???????? #MasterChefBR	negative
23h29 - Globo 13.7, RecordTV 6.7, SBT 6.6, Band 6.3 #MasterChefBR	neutral
Bial moderninho mostrando os memes do momento üòÇüòÇüòÇ Tragicom√©dia pol√≠tica üáßüá∑ üòÆüòÆüòÆ #ConversaComBial	positive
MINHA GENTE que ep foi esse no #MasterChefBR ??? Vem c√° victor, deixa cuidar de voc√™ nen√©m!!	negative
Eles t√° tomando ch√° de hibisco com a comida? #MasterChefBr	neutral
Se a Paola me olhasse assim eu j√° estava com a vida ganha #MasterChefBR	positive
Namaria devia mostrar Caio Castro  vestido de unic√≥rnio qnd saltou de paraquedas #MaisVoce	negative
Por isso que eu vi que estava mto cedo pro  #MasterChefBr acabar, sempre acaba perto da 1h	neutral
ainda bem que tem a Ana Padr√£o pra fazer merchan, caldo knorr em receita de chefs? #MasterChefBR	positive
Fiquei com uma dorzinha no cora√ß√£o quando o Vitor B. foi eliminado, eu estava torcendo por ele e ele √© um gato  #MasterChefBR	negative
Amanh√£ vou ter que procurar o programa completo no YouTube. Perdi metade da entrevista, pelo visto #TheNoite	neutral
Amoooo essa m√∫sica! #tremBala  #ConversaComBial	positive
ANA MARIA BRAGA DE UNICORNIO KKKKKKKKKKKKKKKKKKKKKKK AINDA DAN√áANDO KKKKKK  #MaisVoce	negative
5  4 3 2 1  *6 DA MANH√É*  #masterChefBR #ChefSensei	neutral
L√©o Lins b√™bado √© uma das coisas mais engra√ßadas que j√° vi #TheNoite	positive
Da equipe azul s√≥ salva a Yoko. #MasterChefBR	negative
Legal o app falado no #conversacombial pena que tem que ter cel atual pra baixar üíî	neutral
Aguardando ansiosa o inicio de #MasterChefBR	positive
Ter√ßa-feira √© o dia mais dif√≠cil pra acompanhar os talk shows BR, #ConversaComBial e #ProgramaDoPorchat v√£o ao ar praticamente juntos.. =S	negative
#VideoShowAoVivo voc√™s sabem o que significa lagartcha aqui no Rio Grande Do sul?üòÖ	neutral
Eu sou a Sheron kkkk ia fk chorando. #encontro	positive
#ConversaComBial Se Pe.F√°bio tem atitudes diab√≥licas, imagines eu! #VidaSufrida üòûüòû	negative
Ter√ßa (16), os infantis e Talk Show do SBT marcaram:  #MundoDisney 4.2 #BomDiaECia 5.9 #ClubeDoChaves 6.3 #TheNoite com @user 3.9	neutral
Bial melhor pessoa ,mostrando os meme da internet sobre o Temer   #ConversaComBial	positive
Esse neg√≥cio com ervilhas ficou estranho. #MasterchefBr	negative
Hj √© dia de qu√™? Em? Em? #MasterChefBR	neutral
#VideoShowAoVivo ... Ahh que saudades da piadoca do jocaaa rsrsrsrs lindos beijos ‚ù§	positive
"Nossa, eu sou p√©ssimo em expressar sentimentos pessoais, sejam bons ou ruins. N√£o consigo direito nem em texto, imagina ""ao vivo"". #encontro"	negative
Q del√≠cia esses pratos inspirados no par√° mas infelizmente a minha √∫nica op√ß√£o em casa √© o miojo #MasterChefBR	neutral
#AltasHoras Amo coentro ‚ù§‚ù§‚ù§	positive
O que fazer quando voc√™ n√£o quer que nenhum que est√£o na prova de elimina√ß√£o saia? #MasterChefBR	negative
Viva o amorrrrr, n√£o posso ver um pretinho que me tremo toda #Encontro	neutral
#MasterChefBR o programa que me faz sentir mais fome ainda kkkk	positive
uma pena que quem saiu hoje do #MasterChefBR tenha sa√≠do	negative
#MasterChefBR AAAAAAAAAAAAAAA EITA SENHOR	neutral
#VideoShowAoVivo oi seus lindos..adoro o#videoShowAoVivo	positive
Equipe azul t√° meio desesperada #MasterChefBR	negative
Vai come√ßaaaaar #MasterChefBR	neutral
#VideoShowAoVivo chorei vendo isso	positive
#MasterChefBR Agr o embuste da Mirian sai	negative
Gosto do #TheNoite  porque n√£o corta os palavr√µes, j√° o Porchat corta!	neutral
Acabei de receber uma mensagem no whats, dizendo que minha faca do #MasterChefBR chegou no @user  Depois de 6 meses de espera ;D	positive
Tudo que Ana Maria faz no programa de diferente, tem cara que vai d√° merda viu #MaisVoce	negative
Vai na f√© VALTER! #MasterChefBR	neutral
Que tal a gente analisar tamb√©m o look do @user e do @user ? Acho que nem precisa pq os dois est√£o lindos #VideoShowAoVivo	positive
"Pedro Bial um baita de um tioz√£o dramatizando ""esses memes""  #ConversaComBial"	negative
#MasterChefBR eu lavei o peixe kkkkkkkk	neutral
N√£o √© nada f√°cil lidar com a Ansiedade... eu que o diga... üëª#ConversaComBial	positive
Gente a equipe azul est√° muito desorganizada #MasterChefBR	negative
Augusto Cury falando tudo o que tem no livro dele... #ConversaComBial	neutral
Que o amor de m√£e nunca falte em nossas vidas   #AltasHoras	positive
J√° estou sofrendo ao lembrar que a season premiere de #HouseOfCards ser√° no mesmo dia de epis√≥dio de #MasterChefBR. üò≠	negative
23h20 - Globo 14.6, SBT 8.7, RecordTV 7.0, Band 6.2 #MasterChefBR	neutral
Quando o Dr. @user falar, voc√™s por favor escutem. Sempre. Que aula. #ConversaComBial (e que programa)	positive
Levei um spoiler na cara agora de #MasterChefBR pqp vai pro inferno	negative
Meu Deus do c√©u Victor, n√£o decepciona esse Brasil hoje, pelo amor #MasterChefbr	neutral
queria tanto que houvesse repescagem. Seria uma maravilha ver o cafajeste de volta na competi√ß√£o #MasterChefBR	positive
Esse ai vai dar trabalho pro pai   #altashoras	negative
Nicolas Prates √© o bebe de Giuliana em Terra Nostra #VideoShowAoVivo	neutral
A vozzzzzz t√£o meiga üò≠  #DomingoLegal	positive
Esse epis√≥dio est√° errado desde quando a Miriam e o Leonardo ganharam a prova  #MasterChefBR	negative
Quem est√° torcendo para a Mirian ou o L√©o serem eliminados hoje? #MasterChefBR	neutral
AI SENHOR üò≠üò≠üò≠@user #MaiaraeMaraisaNoBial #ConversaComBial	positive
#MasterChefBr EM NOME DE JESUS N√ÉO ELIMINA MEU CRUSH EM NOME DE JESUS	negative
"Ainda que o porte de arma diminu√≠sse o fato de ""eu tenho arma ele n√£o, sou melhor...."" e fizesse pensar duas vezes+ #thenoite"	neutral
#ConversaComBial  Bial como sempre dando show	positive
Encontro com F√°tima e #AltasHoras s√≥ tem conversa fiada. Na F√°tima tem tanto papo furado q √± d√° tempo d cantar uma m√∫sica inteira. + M√öSICAS	negative
@user Eu jamais teria maturidade p trabalhar c Juninho Bill sem pedir p ele ficar cantando as musicas do Trem da Alegria  #TheNoite	neutral
Ainda bem que temos o #V√≠deoShowAoVivo para matar um pouco as sdds do ator Domingos Montangner!	positive
Essa elimina√ß√£o vai ser muito triste, adoro todos #MasterChefBR	negative
N√£o pude de #MasterchefBr ontem... Ou eu dormia cedo para acordar bem ou via todo e levantava um caco.	neutral
Tema absurdamente importante abordado no #Encontro	positive
#VideoShowAoVivo Ai meu bebe chorando üò≠üò≠üò≠üíö	negative
@user aqui em bel√©m o din din √© chope! #VideoShowAoVivo	neutral
Hey @user?! Gostei da blusa! Aonde posso comprar uma??? Hehehe... Abra√ßos!!! #VideoShowAoVivo	positive
#Encontro parem de ficar cortando falas. A pessoa n√£o consegue terminar uma frase. Toda hr algu√©m atravessa sem or	negative
Consolidados - GLOBO (18/05):  #JornalHoje II 9.1 #BemEstar (cont.) 8.8 #Encontro 9.8 #SP1 15.0 #GloboEsporte 13.3	neutral
Val√©ria morrendo de inveja do casamento da Janete com o gal√£ global √© hil√°rio! üòÇüòÇüòÇ #V√≠deoShowAoVivo	positive
N√£o entendo esses jurados do @user querem e cobram criatividade de TDS menos da Yoko #MasterChefBR #xenofobia	negative
Yuko voc√™ n√£o me tomba com essa hist√≥ria de odiar sardinha #MasterChefBR	neutral
Masterchef eu te venero #MasterChefBR	positive
Ai t√¥ nervosa #MasterChefBR	negative
Queria dormir cedo, mas tem #MasterChefBR	neutral
@user , al√©m de ser o que cozinha melhor, ainda √© o que tem os coment√°rios mais engra√ßados #MasterChefBR  #teamLeo	positive
Globo contrate a Cora üòò #Encontro	negative
#VideoShowAoVivo sonha comigo √© bem melhor na voz do Rafael Vitti	neutral
Assistindo #VideoShowAoVivo  @otacosta	positive
Otaviano sabe que √© p√©ssimo e sem carisma, √© por isso que interrompe todo mundo o tempo todo, at√© a F√°tima Bernardes. #VideoShowAoVivo	negative
#edecasa  aqui em casa ultilizou t√°bua de acr√≠lico tem algum plobema.	neutral
"#VideoShowAoVivo  moro em Jequi√©-Ba ""Dim-Dim"" aqui √© chamado de Apolo ou Geladinho"	positive
Yuko e Vitor B ah naoo, enqto isso Nayane, Leonardo e Miriam ainda na competi√ß√£o que merdaaaa #MasterChefBR	negative
Cristiane Torllona kkkkkkk #VideoShowAoVivo	neutral
Melhor epis√≥dio da Temporada!!! #MasterChefBR	positive
Pelo amor de deus, tira esse tradutor das entrevistas, coloca legenda @user #thenoite	negative
Como a Sheron vai fazer com a novela ? #Encontro	neutral
Outro coment√°rio avulso: mal posso esperar pela participa√ß√£o da Daniela Mercury no #MasterChefBR	positive
Pior que a fala desse rapaz do #Encontro √© a falar de muitos machistas. Isso AINDA √© real.	negative
üôÄ vivi pra ouvir #Slipknot no #MaisVoc√™	neutral
Que show de violino no #Encontro üëèüèªüëèüèªüëèüèªüëèüèªüëèüèªüëèüèª	positive
"""homem que √© homem n√£o tem que lavar lou√ßa"" NOS POUPE #Encontro"	negative
Que acho/'quero' vai embora Vitor B &gt;&gt; Nayane &gt;&gt; Fabrizio #MasterChefBR	neutral
tadinho do muso, por√©m corajoso #MasterChefBR	positive
Blogueira de moda a 10 anos. N√£o sei garimpar.... U√© tamb√©m ganham tudo, assim at√© eu seria p√©ssima meu amor #VideoShowAoVivo	negative
#Encontro o maluco do reagge ta brabo. Kkkkk F√°tima concordando pra ele finalizar o assunto... Vai at√© deixar o cara cantar	neutral
√â a Claudia Raia com certeza! #VideoShowAoVivo	positive
Miriam bem morph√©tica #MasterChefBR	negative
Gente. Que look √© esse da Ti√™??? #encontro	neutral
#MasterChefBR se m√≠dia desse mais aten√ß√£o para esse programa da @user seria um fen√¥meno em audi√™ncia!!	positive
N√£o consigo olhar para a Sandy @user e imaginar ela peidando!! #Encontro	negative
"""Eu gostaria"" #TheNoite"	neutral
#ConversaComBial com as lindas @user  altas risadas! ‚ù§ Parab√©ns,meninas!üòò	positive
Nada contra, mas fico me perguntando o que o #conversacomBial tem de novo. S√≥ reciclaram o que o J√¥ fazia.	negative
Mas o professor falou a real, nem tudo √© preconceito, porem ele existe! #Encontro	neutral
"""O ator √© um estudante do comportamento humano"" #ConversaComBial  psicologia e dramaturgia t√™m coisas em comum"	positive
#MasterChefBR hj tem q sair essa Miriam aff	negative
Assistindo #DomingoLegal	neutral
Vivi Pasmanter maravilhosa!! #VideoShowAoVivo	positive
E no #MaisVoce de hoje,tivermos torta de clim√£o,quer dizer nhoque de ab√≥bora!	negative
#MaisVoc√™ @nadiabochi  √â  o m√°ximo s√≥ f√£.üëèüëèüëè	neutral
Capricha na prova Vitor B. üòâ #MasterChefBR	positive
Bial malicioso pra CARALHO brinca que n√£o √©, mas √© em TODO programa #ConversaComBial	negative
Consolidados - GLOBO (09/05):  #JornalHoje 12.4 #V√≠deoShowAoVivo 10.0 #Sess√£oDaTarde 11.3 #SenhoraDoDestino 16.0	neutral
Sophia falando da Mel!!!üòçüòçüòç #melphia #videoshowaovivo	positive
L√©o Lins √© completamente treze üòÇüòÇ #TheNoite	negative
Q lindo q a @user  n√£o sabia o q vestir hj e pegou uma blusa do @user  #VideoShowAoVivo	neutral
Essa coisa fofa e muito linda √© o Nicolas prattes ,sofia e Otaviano amo vcs ,bjs  #VideoShowAoVivo	positive
#VideoShowAoVivo a Marcela foi no local errado. Essas express√µes s√£o do Par√°. Nada a ver essa reportagem. O povo nem sabia os significados.	negative
shippo Joaquim  e F√°tima rs #Videoshowaovivo	neutral
Porra com a Deborah colocando a Miriam pra liderar o time advers√°rio no pr√≥ximo ep kkkkkkkkkkkkkkkkkkkk Deborah icone #MasterchefBR	positive
Se Yuko sair eu desisto deste #MasterChefBR	negative
O desarmamento n√£o acaba com a viol√™ncia, assim como a proibi√ß√£o da maconha n√£o acaba com o tr√°fico. Me julguem  #TheNoite	neutral
#Encontro na vdd quando as pessoas se apaixonam e s√≥ vai ver a idade depois ai isso n√£o importa mais üòç	positive
N√£o entendo essa super prote√ß√£o com a Miriam. Desnecess√°rio isso. #MasterChefBR	negative
Eu gosto mais n√£o gosto da Yuko #MasterChefBR	neutral
Fiquei feliz pelo Fernando ‚ù§Ô∏è #MasterChefBR	positive
Mentira que o Vitor lambeu os dedos e pegou no frango dnv #MasterChefBR	negative
Enfia whey protein nesse povo, ja v√£o se dar por satisfeitos #MasterChefBR	neutral
Me inspirei no epis√≥dio do #MasterChefBR (sim, s√≥ vi hj!) e vou fazer um jantar super digno com sardinha em lata! üòã	positive
#VideoShowAoVivo  Pena que eu perdi!!!!	negative
Gente porque n√£o gostam da Miriam, me expliquem plissss . n√£o assisti outras edi√ß√µes. #MasterChefBR	neutral
Caiu uma l√°grima aqui nessa cena de A Favorita Nelson Xavier ficar√° pra sempre em nossa mem√≥ria #VideoShowAoVivo	positive
ai gnt ta dando afli√ß√£o esse povo batendo no azul!! A Miriam tem q sair hj galeraa  #MasterChefBR	negative
Hoje eu nem comentei sobre #MasterChefBR	neutral
Qdo o telefone do @user tocou, achei q era o meu. Fiquei ca√ßando o barulho. N√£o acreditei q era da televis√£o. üòÇüòÇüòÇ #ConversaComBial	positive
Que fome da porra! A√≠ eu invento de ir assistir #MasterChefBR	negative
D√° vontade de pegar o filho do Serginho, agarrar e n√£o largar mais!! üòçüòçüòç #AltasHoras	neutral
#MasterChefBR vem q vem	positive
#MaisVoce gosto muito da Ana Maria mas esse cabelo dela t√° muito feio!!! Muito amarelo!!! Desculpe mas √©  verdade! !!	negative
"""vou nem perguntar se gostam de alho"" kkkkkkkkk #MaisVoce"	neutral
Eu em uma prova de sardinha em lata: Misturo a sardinha em lata no miojo e PRONTO! Temos uma MACARRONADA SARDINHESA üçù üòÇüòÇüòÇüòÇ #MasterChefBR	positive
nunca passei tanto nervoso como hoje #MasterChefBR	negative
Os votos de hoje ser√£o contatos por socos na Miriam e no Leonardo. #MasterChefBR	neutral
Bom dia @user  @user @user @user adoro come√ßar o dia com o #MaisVoce	positive
Por favor, convide  #SamAlves no #AltasHoras de @user  @user. Agradeceria muito ver novamente meu √≠dolo nesse programa.	negative
Aprendi no #maisvoce que garfo √© um talher masculino e faca e colher s√£o talheres femininos. N√£o sabia que talher tinha sexo.	neutral
@user Vou pegar esse voo s√≥ pra comer a comida da @user @user e @user #masterchefbr	positive
O prato t√° feio pra ded√©u, V√≠tor. #MasterChefBR	negative
Aqui em casa compramos muita sardinha! N√£o sabia que era luxo! #MasterChefBR	neutral
Ela √© minha diva #VideoShowAoVivo	positive
Sonhando com uma m√°quina dessa de passar e dobrar a roupa aqui em casa. #Maisvoc√™ #OdeioPassarRoupa	negative
Nao gosto de #passarroupa hoje em dia, imagina antigamente com esse dinossauroüòæüòπüòπ #MaisVoce	neutral
Nossa mais o nariz do maluma √© quilom√©trico. Kkkk mas mesmo assim √© lindo. #thenoite	positive
Olha a cara dele olhando as palavras da mae adotiva. To chorosa. #encontro	negative
Olha a @user na Pra√ßa com a Velha Surda #TheNoite	neutral
#VideoShowAoVivo minha primeira vez no tweeter e meu coment√°rio j√° saiu! Amei/essa tv globo √© 10 v√≠deo show √© meu amor! Ota e Joca amo vcs	positive
a Mirian podia quebra a perna ne, so um pensamento, assim  #MasterChefBR	negative
S√£o Paulo 11h54 -  Globo #Encontro 9.8,  SBT #BomDiaECia 6.6,  Band #JogoAberto 3.3,  Record #HojeEmDia 3.0	neutral
#MaisVoce Meus olhos n√£o saem da blusa da Ana, linda demaaais üòçüòçüòç Nunca te pedi nada, manda essa blusa pra mim Ana. PLEASE!!! üòÇüòÇüòÇ‚ò∫‚ò∫‚ò∫	positive
Eu t√¥ com medo que o Douglas saia :( #MasterChefBR	negative
MUITO BOM o #TheNoite com o @user e a Tania! Ri demais! @user @user	neutral
#MasterChefBr @user t√° mais maravilhosa ainda hoje	positive
"A regra √© clara, ""ovelha negra"" n√£o tem nada a ver com racismo, tem a ver com l√£ mesmo... gente chata! #Encontro"	negative
#thenoite @user @user  L√©o Lins j√° √© um mito nas entrevistas das estrelas de Hollywood.	neutral
Prepara o cora√ß√£o. Agora que eu morro #MasterChefBR	positive
F√© no pai que a Miriam sai  #MasterChefBR	negative
Ota, Joca, vcs falando de sotaque, isso pq ainda n√£o me ouviram falar BERNARDES !! üò¨üôà  #VideoShowAoVivo	neutral
J√° entrando no clima pro #MasterChefBR ! Hoje tem!	positive
O mo√ßo querendo falar e a F√°tima doida pra cortar por causa do tempo #Encontro	negative
#MaisVoce FGTS n√£o √© descontado dos sal√°rios. Ele √© uma obriga√ß√£o da empresa.	neutral
Adorei essa senhora #Encontro	positive
O QUE QUE √â ISSO DESSA MIRIAN CONTESTANDO O FOGA√áA?!?!? WHAT THE FUCK #MasterChefBR	negative
Daqui a pouco MASTERCHEF No Ar !!! assistindo a pr√©via com @user e @user   #MasterChefBR	neutral
@user Fiquei emocionada de ver a dona Ana e o seu carinho com ela. #altashoras	positive
Mano olha esse @user sobre o jornalismo na... KKKKKKKKKKKKKKKKKKKKKKKK    #TheNoite	negative
Galera 129 anos da ABOLI√á√ÉO DA ESCRAVATURA #√âDeCasa	neutral
VIVER √â MELHOR QUE SONHAR üé∂ A RAINHA #ConversaComBial	positive
Um dos piores momentos do #MasterChefBR esse final, sim ou claro?	negative
Yuko gente como a gente, queria usar o p√™nis, ficou duro, decepcionou, pensou em fazer picadinho do p√™nis mas deixou pra l√° #MasterChefBR	neutral
O prato da @user ficou mais bonito que o da @user. Convenhamos. #MasterChefBR	positive
O #Encontro promovendo pseudoci√™ncia. LAMENTAVEL! #SandyNoEncontro #QuartaDetremuraSDV #QuartaComFenixSDV	negative
Yuko como sempre vai ficar por √∫ltimo #MasterChefBR	neutral
A VOZ DA LUCEROOOOOO √â A COISA MAIS LINDA QUE VOC√äS IR√ÉO OUVIR HOJE   #DomingoLegal	positive
Dormi antes do #masterchefbr acabar,  foi a vida falando pra eu n√£o assistir a decep√ß√£o dessa elimina√ß√£o üò¢üíî	negative
Bora azulllllll #MasterChefBR	neutral
To rindo demaaais hahaha #TheNoite	positive
"""Homem q √© homem n tem q lavar lou√ßa n""  MEU QUERIDO? EM QUE MUNDO VC VIVE??? #Encontro"	negative
23h45 - Globo 12.3, RecordTV 7.1, SBT 5.9, Band 5.8 #MasterChefBR	neutral
@user adorei saber mais sobre voc√™! N√£o sabia que comia carne, legal isso de n√£o ser radical #altashoras	positive
Gente do c√©u, nem assisto mais o #AltasHoras por causa desse insuport√°vel do Marco Luque, que cara bem sem gra√ßa. Tenho 100 tipos de nojo.	negative
#MasterChefBR Viiuuuuuu Surra de Sorvete de cacha√ßa de Jambu üòç Chama ele a√≠ pro #Allcolin√°ria @user	neutral
N√£o lembro da atriz Isabel Ribeiro, ta√≠ mais um bom motivo p/ prestigiar o #Mem√≥riaNacional, p/ conhecermos essas estrelas! #V√≠deoShowAoVivo	positive
Poxa, o @user saiu ontem do. #MasterChefBR. Eu gostava das performances dele. Kkkk	negative
Gente o treinador da @user hahahahah #MasterChefBR	neutral
Maiara e Maraisa cantando belchior ‚ù§Ô∏è‚ù§Ô∏è‚ù§Ô∏è   #ConversaComBial	positive
Eu amo a Sandy, mas ela se veste muito mal, sempre com roupas de velha, que n√£o valoriza ela.  #Encontro	negative
Consolidados - SBT (17/05):  #TheNoite 4.4 #SBTNot√≠cias I 3.2 #SBTNot√≠cias II 2.6	neutral
Hora de levantar, arrumar a casa e me preparar pro melhor evento da minha semana: #MasterChefBr POOOORRAAAA! üòÇ‚ù§üòç	positive
#MasterChefBR eu to bem triste üò≠üò¢	negative
O Brasil √© uma rapariga mesmo #TheNoite	neutral
Padre F√°bio est√° com a cadimia em dia #ConversaComBial	positive
Eu nunca vi em nenhum programa participante sair por q se acidentou! Houve um sensacionalismo ali na hora! #MasterChefBr	negative
t√¥ dormindo de uniforme pra ajudar @user #ConversaComBial #MaiaraeMaraisaNoBial	neutral
Minha rotina de toda quarta-feira nos √∫ltimos dias: acordar,assistir #MasterChefBR  no YouTube. AMO o estagi√°rio que acorda cedo pra postar.	positive
N√£o acredito que hoje n√£o sai nem Miriam e nem a Taize nem sei como escreve o nome da peste #MasterChefBR	negative
medo de baratas: eu tenho, vc tem, paolla oliveira tem, todo mundo tem #VideoShowAoVivo	neutral
#eDeCasa Falar Sobre Mae üíìüòç tema Bom Demais	positive
N√£o consigo mais ficar acordada pra ver #MasterChefBR	negative
fernando foi o √∫nico que tomou uma cacha√ßa de jambu e t√° ali de boas #MasterChefBR	neutral
Paolla Maravilhosa como sempre ‚ù§ #VideoShowAoVivo	positive
Ainda bem que n√£o assisti #MasterChefBR muito triste que o Vitor B saiu	negative
Mas eu me mordo de ciuuuuuuumeees #TheNoite	neutral
A√≠ que tuuuudo @user no #VideoShowAoVivo	positive
Acho q eh o fim da linha p o vigor b! #MasterChefBR	negative
#MasterChefBR Algu√©m gosta de basquete? SDV	neutral
Amo o Vitor B. #odeioamirian #MasterChefBR	positive
Uso da cor pra doutrina√ß√£o partid√°ria usando Bob Marley e maconha ?? #Encontro ou panfleto pol√≠tico partid√°rio ?	negative
Meu sonho √© comer uma barca de a√ßai ou de hamb√∫rguer, batata, sei l√° KKKKK üòç #MaisVoce	neutral
N√£o tenho frescura pra comer e se a comida for de gra√ßa muito menos #MasterChefBR	positive
Sai a Nayane e deixa o Vitor B  #MasterChefBR	negative
Preciso dessa receita... Na minha mesa agora #MaisVoce	neutral
P. F√°bio de Melo sempre impressionando !!  #conversacombial	positive
MEU DEUS ME AJUDEM #DomingoLegal	negative
"""For compra o presente da minha m√£e,e ningu√©m vai saber ""üòÇ pow crian√ßa √© muito ing√©nua   #Encontro  @BoraPraTag  @belardo_SO  @Eulay18"	neutral
O diretor do filme esteve ontem no #TheNoite com @user e fiquei com vontade de assistir. Parece ser muito bom #SigaORastro	positive
To chocada com a bomba que a S√¥nia Abr√£o mandou agora no #ATardeESua sobre o #MasterChefBR üò±üò±üò±	negative
Come√ßou a reprise do #MasterChefBR.  Preciso assistir pq s√≥ vi o finalzinho ter√ßa feira.	neutral
#VideoShowAoVivo F√°tima realmente √© um exemplo de pessoa/mulher a ser seguido.	positive
Que agoniiiiia #MasterChefBR	negative
@user quando vai ter o jogo de panelas de novo?!  #MaisVoc√™	neutral
Ant√¥nia de Morais √© das minhas! Salto alto, nunca mais!üòÅ#VideoShowAoVivo	positive
"HAHA @user sentiu a falta dos #twitters hoje! "" - Voc√™s devem estar bem ocupados!!"" üì∫üëÄüòÇ Eu tamb√©m t√¥ com voc√™s viu!!! #V√≠deoShowAoVivo"	negative
Quanta coisa da vida da F√°tima que eu n√£o  tinha visto #VideoShowAoVivo	neutral
Materia linda no #encontro ‚ù§Ô∏è	positive
Obrigada #masterchefbr por me transformar num zumbie hoje! üòÇüò¥	negative
Agora Partiu Ver @user na globo em #ConversaComBial #MaiaraeMaraisaNoBial....	neutral
#VideoShowAoVivo parabens a vcs do video show a cada dia que passa vcs arrazao	positive
mas que tema rid√≠culo ein Fatima #Encontro	negative
#V√≠deoShowAoVivo kkkk sei n√£o essa m√£e de leo e uma onda	neutral
A terceira m√∫sica nem acabou, e eu j√° t√¥ lembrando da gente fazendo amor... #MaiaraeMaraisaNoBial #ConversaComBial	positive
O humor do Porta dos Fundos √© de fund√£o mesmo. #TheNoite	negative
Interessante esse prato hein #MasterChefBR	neutral
#BoletimDeSegunda o @user mostrando o f√£ clube do Lula. Berrooooooooo! üòÇ #TheNoite @user @user.	positive
Namaria t√° de pijama?  #maisvoce	negative
Faz pat√™ de sardinha, galera üòÇ #MasterChefBR	neutral
Eu amo #MasterChefBR isso √© s√©rio	positive
#V√≠deoShowAoVivo ainda bem que avisaram, ananh√£ nem ligo na globo	negative
#VideoShowAoVivo √© a F√°tima Bernardes.	neutral
Jamais ia saber que era a Viviane Pasmanter,que fazia esse personagem na novela,incr√≠vel. #MaisVoce	positive
Por que a an√°lise do Foga√ßa √© quase sempre cortada? Fica a√≠ o questionamento. #MasterChefBR	negative
"A palavra que sempre falo nas tercas na hora do #MasterChefBR √© ""To Com Fome""‚úå"	neutral
Adorei essa vota√ß√£o, bem mais emocionante #MasterChefBR	positive
Como comemorar com uma elimina√ß√£o entre Vitor B x Yuko? N√£o d√°... QUE MERDAAAAAA #MasterChefBR	negative
O gigantossauro personal da Kefera no masterchef hahahha #MasterChefBR	neutral
#MasterChefBR masterChef profissionais, gosto pq tem v√°rias tretas	positive
Pula pra agosto üò≠üò≠üò≠  #DomingoLegal	negative
#EDeCasa nossa !!!!	neutral
N√£o sei se o Vitor vai ganhar o #MasterChefBR, mas essa edi√ß√£o √© todinha dele‚ù§	positive
Como essa mulher √© grossa! Aff... Estupida! #encontro #forafatima	negative
Vai ser o Melhor epis√≥dio do #MasterChefBR se a Mirian sair!	neutral
hj o #ConversaComBial √© pra mim	positive
Miss√£o do dia: evitar spoilers #MasterchefBR	negative
#SBTNot√≠cias com as principais not√≠cias do Brasil e do Mundo com @user! √â logo ap√≥s o #TheNoite! #N√£oPercam	neutral
O Bial atacando o Pd. Fabio e ele dando uma surra de boas respostas! #conversacombial	positive
Fiquei com pena do Victor B. #MasterChefBR	negative
O que √© o depoimento dessa mulher no #Encontro com #F√°timaBernardes? Parece que ela ta recitando a lista da feira! ü§î	neutral
#MaisVoc√™ mt engra√ßado @user dando bom dia pro louro	positive
O MEU FAV SAIU AFSSSS N√ÉO ACREDITO #MasterChefBR	negative
T√£o dizendo que √©  nina  #ConversaComBial	neutral
@user sempre linda!! ‚ù§ #VideoShowAoVivo	positive
#MasterChefBR vendo esses pratos da equipe azul eu ja estou ficando nervosaüòûüòû	negative
Lucero eu t√¥ tremendo Lucero #DomingoLegal	neutral
Rodrigo Santoro √© uma influ√™ncia de ator para mim. #ConversaComBial	positive
Perdi #MasterChefBR n√£o acreditooooo	negative
Calabokinha pq come√ßou o #MasterChefBR	neutral
Ana Lu√≠za &amp; D√©bora üíö #MasterChefBR	positive
as cobras est√£o juntas destilando o veneno j√° #MasterChefBR	negative
@user me surpreendendo em cada programa! #MasterChefBR	neutral
O filho do djavam,tem a mesma voz,linda voz!#encontro	positive
Esse #ConversaComBial √© quase a mesma coisa do programa do J√¥, esperava algo mais original.	negative
O quase filho ga Giuliana da #TerraNostra √© o Zac da #RockStory  Sorry, n√£o sei o nome do ator. =D #VideoShowAoVivo	neutral
#TheNoite  vai ser muito bom 30 anos da #pra√ßaenossa @user	positive
Nem acredito que vou ter que assistir o #MasterChefBr sem torcer por vc @user üò≠üò≠ Deveria ter repescagem üòÉüòòüòò	negative
Consolidados - SBT (11/05):  #TheNoite 5.8 #SBTNot√≠cias I 4.1 #SBTNoticias II 2.9	neutral
Exemplo de sobremesa: creme de cupua√ßu. Del√≠cia. #MasterChefBR	positive
Passei a aula de f√≠sica inteira cheirando meu casaco E ainda me julgam por causa disso #AltasHoras	negative
"#MasterChefBR ""um segundo pessoal, eu disse UM SEGUNDO, anda"" Quem concorda q a @user deveria tomar conta do rel√≥gio do ENEM? kkk"	neutral
"""Cada um que expulse o Diabo que criou."" Pde Fabio de Melo. Muito a refletir nessa frase #conversacombial"	positive
Hoje no #conversacombial vai estar o meu amado padre. S√≥ q gente,olha s√≥ a hora desse programa.	negative
Tem anos que n√£o uso ferro que n√£o passo roupa.  #MaisVoc√™	neutral
T√° f√°cil ficar lendo essas coisas no trabalho, sobre o #VideoShowAoVivo com a @user	positive
#MasterChefBR eu teria que me trancar a sete chaves	negative
#VideoShowAoVivo   Cl√°udia Raia	neutral
A YUKO √â MUITO FOFA CARALHO VAI TOMAR NO CU #MasterChefBR	positive
@user Quero meus lindos @user e @user de volta no #MasterChefBR  üò≠üò≠üò≠	negative
Depois de hoje, tava na cara que o Vitor ia sair! #MasterChefBR	neutral
#altashoras a Sophia Abrah√£o √© linda e a cara da Cl√°udia Raia	positive
Verdade, saudade de ir no banheiro sozinha üòë #altashoras #vidadeMae ‚ù§	negative
@user o que um unic√≥rnio  come? Nuvem!!! #MaisVoce	neutral
Gente, amo inhoque e a Tais Ara√∫jo dispensando? Manda pra mim #namaria ! üòÇüòÇüòÇüòÇ #maisvoce	positive
Douglas √© bem debochada, n√©? Pregui√ßa #masterchefbr	negative
Sempre q via a Maiara e Maraisa na propaganda do CD via uma mulher s√≥ e queria conhecer a outra. A√≠ descobri que s√£o g√™meas #ConversaComBial	neutral
"#altashoras @user Convide Eriberto Le√£o p/cantar""Hurricane-Furac√£o) p/que eu possa participar de convidado na plat√©ia que ser√° o melhor"	positive
Pega pega √© o nome da nova novela das 7? A criatividade manda lembran√ßas #MaisVoce	negative
@user √© um monstro neh ?üëèüëèüëè #ConversaComBial	neutral
@user sua linda te vi no @user com @user e amei sua hist√≥ria. #TheNoite	positive
E dale porrada no #MasterChefBR . N√£o fez prato bom, leva um direto!!	negative
Quem vai assistir #MasterchefBR agora tamb√©m?	neutral
#Encontro.  Homem que √© homem, n√£o s√≥ lava a lou√ßa como cozinha tamb√©m.  Companheirismo √© a palavra. A quest√£o n√£o √© ajudar.	positive
Entendi a inten√ß√£o dos 2 ringues mas achei meio brega e confuso #MasterChefBR	negative
#MaisVoc√™ pombo a passarinho üòÇüòÇüòÇüòÇ	neutral
√â o tchaaaaan. Eu te amooo!!! #AltasHoras	positive
MANO, VOU CHORAR #MasterChefBR	negative
Esse cara de preto perto do tchan me representa muitooooo #AltasHoras	neutral
Eu serei uma velha jovem tipo a Ana Maria Braga! #MaisVoce	positive
Triste em ver o V.B. saindo üò≠üò≠üò≠ #MasterChefBR	negative
Esse epis√≥dio foi foda,foi emocionante! #MasterChefBR	neutral
Paolla e o cachorro √© a coisa mais fofa e LINDA desse mundo ‚ù§ #VideoShowAoVivo	positive
#Encontro Fui abusada na inf√¢ncia e at√© hj n√£o consigo falar sobre o assunto. Muito menos perdoar os abusadores q j√° faleceram.	negative
23h00 - Globo 19.5, SBT 8.8, RecordTV 6.2, Band 5.0 #MasterChefBR	neutral
Ti√™ maravilhosaaaaaaa no #Encontro üíô	positive
E essa mulher fica mais 1 semana... #MasterChefBR	negative
o problema da galera √© q quando eles v√£o cozinhar algo pensando no norte, acho q eles tentam buscar o nordeste por ser proximo #MasterChefBR	neutral
De olho no....‚ô°üëÄ#VideoShowAoVivo	positive
Melhor dia vai ser ver Leo e Miriam saindo juntinhos do #masterchefbr	negative
#VideoShowAoVivo,melhor hor√°rio pra se almo√ßar √© assistindo voc√™s	neutral
@user fala t√£o lindo, tem uma calmaria na voz üíú #ConversaComBial	positive
#MasterChefBR quem s√£o os 20% q t√£o torcendo p time vermelho? Eu s√≥ t√¥ vendo azul rsrsrs	negative
Mano o povo est√° falando: Eu j√° falei vou repetir...  O que eu entendo :Eu j√° falei vou repetir √© a Lucero que manda aqui   #DomingoLegal	neutral
Muito lindo o filho dele socorro #AltasHoras	positive
Vou ficar tonta @user #conversacombial  #MasterChefBR	negative
Tem gente impressionada por a mulher ter 9 filhos.... Minha v√≥ teve 23 #Encontro	neutral
#Thenoite est√° maneiro hoje ü§ôüèΩ#Maluma #danilogentili	positive
@user Senti sua conversa c/Santoro sobre americanos em rela√ß√£o ao Trump foi mal informado e enviou a mensagem errada. #ConversaComBial 1/2	negative
Isso √© a F√°tima Bernardes @user #VideoShowAoVivo	neutral
Minha Diva!!!!!! #Sandy  #Encontro	positive
Porra que medo kkkkkkkkkkkkkk #TheNoite	negative
"Agora tem Carlos Alberto de N√≥brega comemorando os 30 Anos da ""#APra√ßa√âNossa"" üòÇüòÇüòò no #TheNoite do @user no @user."	neutral
J√°, j√° üì∫ #NasNovelasDaNoiteSBT #CarinhaDeAnjo122üòç #Chiquititas171üíô Logo mais: #ProgramaDoRatinho  #CineEspetacular #TheNoite  @SBTonline.	positive
#Encontro.  T√¥ tentando mas ainda n√£o sei quem √© Manoel. √â ator?	negative
Vai fala da Nina, aguenta cora√ß√£o #ConversaComBial	neutral
#VideoShowAoVivo  Progama mais do que show, amo esse progama, n√£o perco por nem um dia.... #amo	positive
O dia inteiro falando de NOVELAS, que bosta de  TV..............  #encontro	negative
Gente, quero esse mapa astral da Sandy! Comofaz? #Encontro	neutral
"N√£o estou sabendo lidar com o filho do Serginho puxando o ""vau vau"" pelo est√∫dio üòç #altashoras"	positive
Sardinha com queijo??????? #MasterChefBR	negative
#MasterChefBR vamos l√°	neutral
M√¥nica  üòçüòçüòç#VideoShowAoVivo	positive
Coitado do Vitor B #MasterChefBR	negative
"""Todo PM sai de casa querendo salvar uma vida [...] ajudar algu√©m"", mo√ßo, Cabo Theodoro, vc t√° numa utopia... #Encontro #EncontroComFatima"	neutral
pe F√°bio de Melo melhor pessoa  #ConversaComBial	positive
Vitor ralou a tampa do dedo. Aquele descascador √© potente, credo #MasterChefBR	negative
#MasterChefBR come√ßou! Hoje √© dia de frango com batata doce.	neutral
Assistindo #conversacombial com o #padrefabiodemelo. Excelente #talkshow. Entrevista intelig√™ncia e com humor na medida certa.	positive
leonardo cada dia mais invejoso  #MasterChefBR	negative
Thomas e Valval se divertindo no #AltasHoras Fernanda, como sempre, super discreta. E sdd da D. Ana	neutral
Ain, c√©us. Olha essa foto como Jax. Minha nossa...‚ù§#TheNoite	positive
Nicolas Prattes, o Zack de Rock Story. N√£o mudou nada o resto de Terra Nostra pra c√°. #VideoShowAoVivo	negative
Ricardo Tozzi um hom√£o desse #VideoShowAoVivo	neutral
Eu acho a coisa mais linda do mundo o Serginho falando e mostrando a fam√≠lia dele. Me emociona mesmo! #AltasHoras #AmorDeFam√≠lia	positive
embuste da miriam ficou üòí#MasterChefBR	negative
J√° quero #DiegoDarksonMc no #VideoShowAoVivo	neutral
Vanessa da mata no #AltasHoras üòç Amo muito ‚ù§	positive
Pena que recebo spoiler a cada tweet nessa timeline. #MasterChefBR	negative
Voc√™s t√£o me matando de fome #MaisVoce	neutral
#MasterChefBR Ainda bem que os lutadores est√£o descontando a comida que n√£o agradou nos bonecos viu!	positive
Todo mundo odeia a M√≠rian #MasterChefBR	negative
Que fome!! Quero!!! #maisvoce	neutral
AMO A YUKO E VOU DEFEND√ä-LA  #MasterChefBR	positive
#MaisVoc√™ Ana Maria nunca viu um ferro de passar...afff...	negative
Imagina se aproveitam os ringues e alguns se pegam por ali? ü§î #MasterChefBR	neutral
VEEEEM VERMELHOOOO #MasterChefBR	positive
MEU AZUL TEM Q GANHAR #MasterChefBR	negative
Impress√£o minha ou a Ana Maria falou dibrar ?? Kkkkkkk #MaisVoce	neutral
Essa hist√≥ria sobre ado√ß√£o no #Encontro fazendo n√≥s chorar litros.	positive
Deixou a mo√ßa no v√°cuo #MaisVoc√™	negative
A roteirista do #MaisVoce hoje √© a @user repassem	neutral
AMEI AAAA MEU CRUSH T√Å AINDA NA COMPETI√á√ÉO AAA #MasterChefBR	positive
Fui assistir #MasterChefBR ontem, dormi e agora descobri que meu Vitor saiu AAAAAAAAAAAAAAAAAAAAAA	negative
#VideoShowAoVivo eae, vamo falar da #DiretasJ√° ?!!!	neutral
Braulio Bessa, que homem!!! #Encontro #DiadasM√£es ‚ù§Ô∏è	positive
Aquarela bxjsjdjjwjs eu t√¥ tremendo  #DomingoLegal	negative
√â O Tchan No #AltasHoras	neutral
Admiro essas mulheres que fazem parto natural. #AltasHoras	positive
@user Nao faz assim, fica c n√≥s!!!!! #MasterChefBr	negative
NaMaria j√° mandou o recado: parem com o bullying com a Ta√≠s. #maisvoce	neutral
#TheNoite  o melhor quadro, Mestre mandou .	positive
Eu n√£o entendi uma coisa. No prato do Fabrizio s√≥ tinha o tomate de bom e no da Yuko tava tudo gostoso. Pq ele subiu?  #MasterChefBR	negative
Lua t√° parecendo filha da F√°tima #LuaBlancoNoEncontro #Encontro	neutral
Adorei Maiara e Maraisa no programa do Bial, maravilhosas! #ConversaComBial	positive
Coloca esse frango no forno logo, @user. #masterchefbr	negative
@user que horas vc chega em Bel√©m/Aeroporto? Quero ir l√° bater uma foto com vc. #VideoShowAoVivo	neutral
Amando cada pedacinho dessa entrevista com minha diva F√°tima #VideoShowAoVivo	positive
O prato de hoje √© esse vomito selado com esse gorfo verde etc #MasterChefBR	negative
Comida para passarinho #MasterChefBR	neutral
Mayara e Maraysa Cantando Elis Regina no #conversacomBial manoooo üòçüòçüòçüòçüòçüòçüòç‚ù§‚ù§‚ù§‚ù§‚ù§‚ù§‚ù§‚ù§‚ù§	positive
#ConversaComBial poderia interagir com o p√∫blico! #UmaIdeia #S√≥Acho	negative
Vamos tomar um caf√© com not√≠cia boa? √â no #MaisVoce	neutral
#MasterChefBR amo esse programa.! Ana Paula me manda um bjo, gosto muito de vc.	positive
A Ana Maria est√° apresentando o #MaisVoce ou o Note e Anote? Kkkkk	negative
Me avisem quando come√ßar A PR√âVIA? #MasterChefBR	neutral
Isso sim √© exclusivo, Carlos Alberto vai virar youtuber.. üôåüôå @user #TheNoite #APra√ßa√©Nossa	positive
#MasterChefBr vai Foga√ßa, vai caralho ~Carosella Voice	negative
Flora e Donatela depois de 40 anos cantando Beijinho Doce na Rede Globo #Encontro	neutral
O poeta tem um olhar sobre o mundo que √†s vezes muitas pessoas n√£o tem. O olhar cr√≠tico e filos√≥fico ao seu redor, sobre tudo... ‚ù§ #Encontro	positive
Fala s√©rio s√≥ t√° saindo o povo massa do #MasterChefBR üò≠	negative
@user   Sophia Abrah√£o  Como  foi a participa√ß√£o do S√©rgio malheiros   #altashoras	neutral
Emocionante a homenagem que a galera do #TheNoite com @user est√£o fazendo para o #CarlosAlbertoN√≥bregaNoTheNoite	positive
Acabou o jogo mudei pro #MasterChefBR e t√¥ tentando entender o programa mas tamo a√≠!	negative
‚Ä∂Dia de Gr√™mio‚Ä∂ ‚Ä∂FELIZ DIA DAS M√ÉES‚Ä∂ ‚Ä∂HOJE TEM PALMEIRAS‚Ä∂ #AltasHoras #EstamosJuntosVasco	neutral
Impressionante como #MasterChefBR s√≥ melhora a cada temporada.O epis√≥dio de ontem foi o melhor de todos!	positive
Minha opiniao sobre o #ConversaComBial de hoje: um festival de clich√™s, t√° muito chato. E a terceira vez que assisto, este √© o pior de todos	negative
S√≥ acho que a Sophia deveria desfilar hoje. #videoshowaovivo	neutral
"'N√£o importa se √© ateu ou cat√≥lico, se somos todos bem intencionados, tds queremos o bem da humanidade"" Essa padre üòç#ConversaComBial"	positive
ESSE SERTANEJO QUE T√Å NA F√ÅTIMA PARECE COM AQUELES DE CABELO ROSA DA DIVA DA DEPRESS√ÉO #ENCONTRO	negative
22h45 - Globo 21.5, SBT 8.8, RecordTV 7.6, Band 3.9 #MasterChefBR	neutral
a m√£e do Serginho era fofa e lgl ah gente #AltasHoras	positive
#Encontro rouba 3min, todo dia do jornal local. coloco na globo 10min depois da 12h pra n corre riscos. prefiro desencontrar #GloboGolpista	negative
Gente eu achei que acordei b√™bado ainda do role de ontem e a Nivea Stelman tinha engordado. Essa mulher Roberta √© a cara dela #EDeCasa	neutral
@user jogando torta no povo Socorro que maravilhoso kkkkkk #VideoShowAoVivo	positive
√â muito vergonhoso ver que os participantes n√£o conhecem quase nada da culin√°ria do Norte!  #MasterChefBR	negative
mano Maiara KKKKKKKKKKK #ConversaComBial	neutral
#MasterChefBR Hj √© dia de preparar algo  pra comer na hora do programa #FomeSempreüòãüíï	positive
"""Parem com essa tradi√ß√£o maldita de culpar a v√≠tima."" #Encontro"	negative
Meu pai t√° na TV #McCatra #TheNoite üòò	neutral
O Vitor n√£o vai sair por falta de torcida, isso √© certeza! #MasterChefBR	positive
O DANILO DO HIPERTENS√ÉO DE 2010 NO MASTERCHEFF AHHHHH #MasterChefBR	negative
Estrogonofe de sardinha √© uma iguaria mto apreciada no meio universit√°rio #MasterChefBR	neutral
Acabou, amei o programa mais uma vez voc√™ @user lacrou muito sucesso, continue assim te amo #VideoShowAoVivo	positive
fui tombada achei eles iriam cantar eu era #Encontro	negative
Hoje no #MasterChefBR os participantes ir√£o passar por uma prova de resist√™ncia onde v√£o experimentar o nhoque de ab√≥bora da Ana Maria Braga	neutral
Quero o Thomas no #AltasHoras toda semana! üòÑ Beb√™ mais lindo!!!! üòç	positive
Sem no√ß√£o Yuko colocar essa quantidade de tempero na alm√¥ndega, se eu fosse capit√£ ficaria put√≠ssima #MasterChefBR	negative
#videoshowaovivo pq o Ota fica olhando pro lado ?	neutral
Como √© bom ouvir o @user! Bom seria se todos os religiosos tivessem essa sabedoria e discernimento! #ConversaComBial	positive
"""homem que √© homem n√£o lava lou√ßa""  Se piroca lavasse lou√ßa toda mulher ia querer ter um macho bb #encontro"	negative
Foi s√≥ eu falar que o Valter foi destaque positivo #MasterChefBR	neutral
Respeita que o cara √© foda #TheNoite	positive
Acaraj√© de SUSHI! AH VAO DORMI PQP #MaisVoce	negative
@user Passar roupa √© facio #maisVoce	neutral
#Conversacombial o talkShow q vc respeita! #Bemassim	positive
Aff Ana Maria, foca mais na carreira da Vivianne Pasmanter, mal conversa com ela, que bosta.  #MaisVoce	negative
#encontro com F√°tima Bernardes	neutral
Se for comparar, a F√°tima quase sempre teve os cortes de cabelo parecidos com o da Celine Dion. Duas rainhas ‚ù§ #VideoShowAoVivo	positive
n era pro Vitor B ter sa√≠do, uns dos meus fav :( to triste #MasterchefBr	negative
#TheNoite @user t√¥ fazendo acumpuntura junto com a placa mio relaxante odontol√≥gicaAcumpuntura est√° associada √† v√°rias disciplinas	neutral
JAMAIS TIRE ESSE TRIO FOGA√áA JACQUIN CAROSELLA √â TUDO QUE PE√áO #MasterChefBR	positive
Rever cenas da Marieta Severo d√° uma saudade da dona Nen√™ de #AGrandeFam√≠lia! #V√≠deoShowAoVivo	negative
@user  hj vc n√£o sai #MasterChefBR	neutral
"eu gosto tanto do memoria nacional porque eu tenho a oportunidade de ""conhecer"" tanta gente #VideoShowAoVivo"	positive
Mta emo√ß√£o no #Encontro @user @user Como sempre o tema #ado√ß√£o nos transborda o cora√ß√£o! #amorPraSempre	negative
#MaisVoc√™ ajude uma pessoa friorenta ganhar o pijama da @user da RT p/ q meu tt chegue at√© ela	neutral
@user Mariana Xavier √© muito parecida com a m√£e Fabiana Carla. Incr√≠vel! #VideoShowAoVivo @user	positive
#MaisVoce NAO QUERO !	negative
√© a F√°tima Bernardes ela acabou de postar KKKKKKKKKKKKKK KKKKKKKKKKKKKK #VideoShowAoVivo	neutral
Augusto Cury MARAVILHOSOOOOOO!!!!   Melhor #ConversaComBial	positive
#AltasHoras quem √© esse de preto, achando que √© o jacar√©, dan√ßando na plat√©ia as m√∫sicas do tchan kkkkkkkkk	negative
AnaMaria de Unic√≥rnio no dia q Camila Cabello lan√ßa m√∫sica n pode ser coincid√™nciaüòÇ #ihavequestions #CryingInTheClubMusicVideo #MaisVoce	neutral
Entrevista foda!! Esclarece muita coisa. Sensacional!! @user #TheNoite	positive
Quase n√£o tem sal mas t√° bem temperado... ser√° ?#MasterChefBR	negative
#V√≠deoShowAoVivo Otaviano. Voce lembra de mim sou eu maria Cristina sou eu eu mesma  dei meu segundo livro para voc√™ e V√≠deo pera mim	neutral
Pelo menos  a @user chegou atrasada e linda, eu chego atrasada parecendo um zumbi #VideoShowAoVivo	positive
Se fosseu eu nesses 5 minutos √© que eu ia come√ßar a fazer e ainda conseguiria empratar #MasterChefBR	negative
#VideoShowAoVivo em vez de nub podia ser nudes!!!!	neutral
@user Maiara me emprega? hahah #ConversaComBial.	positive
Esse #MasterChefBR virou um programa para intrigas üôÑüôÑ	negative
@user ,vc j√° pode fazer maratona  Padre F√°bio de Melo no  #ConversaComBial,grata.	neutral
Agora tem ator lindo Charlie Hunnam üé¨üòò no #TheNoite com @user no @user. #CharlieHunnamNoTheNoite	positive
"Pior coisa √© voc√™ passar por isso com 12 anos e sua m√£e n acreditar em voc√™.. ""Castigo pra pedofilo tem que ser cadeia perp√©tua ""üò† #Encontro"	negative
"Vanessa da Mata n√£o tem s√≥ ""Ai ai ai"" de m√∫sica, mas √© inevit√°vel ela ir num programa e n√£o cantar. Um hino, n√©, mores? #AltasHoras"	neutral
Rodrigo Santoro pleno e maravilhoso. Um orgulho nacional ‚ù§ #conversacombial	positive
Ver o #Masterchefbr dessa semana me fez chorar muito üíî	negative
Aqui na regi√£o de Campinas fala-se juju para esse sacol√© #V√≠deoShowAoVivo	neutral
#Encontro.  D. Ivonete, m√£e  de Manoel, super m√£e!	positive
Esse gordinho √© a peste viu #MasterChefBR	negative
Minha m√£e sempre fazia Macarr√£o com sardinha #MasterChefBR	neutral
O filho do Serginho √© um encanto #Altashoras	positive
#VideoShowAoVivo povo idolatra uma exBBB que se √± fosse por eles ela nem existiria, confundem beleza de Sophia com talento de apresentar üò£üò£üò£	negative
Consolidados - SBT (09/05):  #TheNoite 3.3 #SBTNot√≠cias I 2.5 #SBTNot√≠cias II 1.9	neutral
Otaviano falando cuiabano üòÇüòÇüòÇüòÇüòÇ gente nos falamos assim meixmo, vot√™  #VideoShowAoVivo	positive
Coitado do @user  #TheNoite	negative
Tem um monte de menino que usa personagem feminina em jogos #Encontro	neutral
@user no #Encontro !! Agora acredito que v√° ao ConversaComBial @user @user	positive
COMO ASSIM O VITOR SAIU??????? NAOOOOOO #MasterchefBR	negative
Globo Recife (17/05) #VideoShowAoVivo 19.6 #NETV2 33.4 #JN 32.7 #Futebol 38.2 #JornalDaGlobo 22.3 #Profiss√£oReporter 15.4	neutral
O cabelo mais famoso do Brasil #VideoShowAoVivo	positive
Eita que hoje est√° pegando fogo! Literalmente! Kkkk #MasterChefBR	negative
nao sei pra quem torcer nao quero que o vitor saia mas tbm quero que a yuko fique aaaaaaaaaaaa #MasterChefBR	neutral
#MasterChefBR Estou apaixonado pela Paola SIM ‚ù§	positive
#masterchefbr ol√° M√≠rian, gostaria de dizer que ningu√©m gosta de voc√™	negative
Quem autorizou o mezanino participar da regressiva? #MasterChefBR	neutral
#VideoShowAoVivo A FOR√áA DO QUERER MELHOR NOVELA PARA QUEBRAR TABUS	positive
Percebo q est√° vis√£o √© bastante psiqui√°trica e pouco psicol√≥gica #ConversaComBial n√£o curti tantas sugest√µes, diagn√≥sticos e recomenda√ß√µes	negative
#MaisVoce certamente que tem coisas mais importante que o dinheiro	neutral
O melhor #ConversaComBial eveeerrr!!!	positive
Morrendo de medo do avental azul  #MasterChefBR	negative
Eai, Vamo se da uns obrigado por tudo   obrigado por tudo :bj #encontro #QuartaDetremurasdv	neutral
Adoooro '√â o tchan' #altashoras	positive
Ran√ßo  desses macho ran√ßo #Encontro	negative
#MasterChefBR vai come√ßar	neutral
QUE LINDOOOOOO O #DomingoLegal	positive
Um sal√°rio do Guerrero paga 3 shows da Maiara e Maraisa. Flamengo podia ver isso.  Haja sofrencia no sof√°.  @maioralvinegro #ConversaComBial	negative
F√°tima Bernardes foi picada pelo ryca v√≠rus #VideoShowAoVivo	neutral
Adoro a sinceridade da Maiara @user #ConversaComBial #MaiaraeMaraisaNoBial	positive
Nem adianta chorar pq n convence os jurados n√£o #MasterChefBR	negative
A filha de Carolina Kasting √© a cara da m√£eüò± #Encontro	neutral
"Eu sou ""meseira"" e nem sabia!!!! #meseira #MaisVoce"	positive
Nunca vamos merecer ver o filho da Sandy? #Encontro	negative
Bobby azul foi hospitalizado e n√£o passa bem, sua equipe tbm n√£o #MasterChefBR	neutral
Vou comentar sobre o #MasterChefBR no tt SIM e quem n gostou me processa	positive
Se eu fico tenso de fazer um ovo com minha m√£e me olhando, imagina cozinhar pra esse tanto de gente? Eu ia ter um treco #MasterChefBR	negative
A paolla de costas kkkk sou eu agora #MasterChefBR	neutral
#MasterChefBR muito emocionante hoje!!	positive
@user Larga esse merda do seu marido, ele √© verme, bandido ou vc vai compactuar com a criminalidade? #SextaDetremuraSDV #Encontro	negative
E o pr√≥ximo #MasterChefBR ser√° o Profissionais. Desistiram do Kids?	neutral
Meu prato hoje no #MasterChefBR seria fritar a sardinha e cortar um lim√£o p colocar ao lado do prato. S√≥ isso. Sardinha frita! Maravilha! rs	positive
Aaaaah n√£o kkkkkkkkkkk @user #ConversaComBial #MaiaraeMaraisaNoBial	negative
#VideoShowAoVivo Queria que M√¥nica irose voltase Por favor M√¥nica volta depois que terminar bater retro	neutral
Nham üòã qnt comida gostosa #MasterChefBR	positive
era s√≥ o que faltava n√©, que cara rid√≠culo #Encontro	negative
COMO ASSIM O CARLOS ALBERTO DE N√ìBREGA TEM 81 ANOS?! :OOO  #TheNoite	neutral
#AltasHoras Tom√°s √© muito bonitinho,to apaixonada‚ù§	positive
TEM QUE SAIR OS DOIS #MasterChefBR	negative
Parece meu pai me emprestando o carro üòÇüòÇüòÇüòÇ #MasterChefBR	neutral
meus favs na mesma equipe, am√©m #EquipeAzul #MasterChefBR	positive
@user n√£o passa nem ar #MasterChefBR	negative
sopa de piroca #MasterChefBR	neutral
Eu quero ser amigo dessa cara de preto na plat√©ia. Algu√©m me passa o whats dele #AltasHoras	positive
E, agora toca o telefone dele.  Ain.. Que indelicado! #Encontro	negative
#MasterChefBR equipe azul	neutral
Carlos Alberto de N√≥brega falando sobre os 30 anos dele na Pra√ßa √© nossa no #TheNoite t√° muito legal	positive
Tem r√£ viva hj no #MasterChefBR ? Me avisa p eu nem come√ßar a assistir.	negative
Aquele momento que √©  00:30 e voc√™ est√° com vontade de cozinhar sardinha por causa do @user pois √© üòÖüòÖ #MasterChefBR	neutral
PQP o Maluma √© muito lindo! üòÇüíúüíú #TheNoite	positive
ele j√° ta tenso e esse povo ainda fica gritando ah plmdds nem #MasterChefBR	negative
#VideoShowAoVivo a express√£o levar farelo significa levar a pior!	neutral
Agora √© a vez do meu anjo  #MasterChefBR	positive
Meu God, ainda est√£o falando do tal nhoque de ab√≥bora!!! Manda pra c√° que eu como tudo e acaba com isso logo. #MaisVoc√™	negative
O maluma n√£o gostou do abra√ßo da Juliana. Kkkkkkkkkkkkkkk #thenoite	neutral
Vitor B ficou que lindo‚ù§Ô∏è  #MasterChefBR	positive
mds t√° muito acirrado t√¥ nervougfj #MasterChefBR	negative
Um dente  #MasterChefBR	neutral
Tony Bellotto falando sobre o exerc√≠cio como forma terap√™utica de olharmos os nossos fantasmas #ConversaComBial FATO!	positive
PASSA NO SEU NAMARIA!  #MaisVoce	negative
#MaisVoc√™ Louro, ajuda a√≠, est√£o destruindo a pantufa da Ana Maria. Kkkkkk	neutral
@user aaaaah que saudade que eu tava de assistir video show e principalmente te ver nas telinhas #VideoShowAoVivo	positive
to esperando o clipe. nao tenho paci√™ncia nao. #DomingoLegal	negative
√â a Totia Meireles mesmo! Tenho certeza! #VideoShowAoVivo	neutral
MALUMA √â UM TUDINHO DE HOMEM QE PQP ‚ù§ #TheNoite	positive
Vergonha alheia desse gordo que t√° se achando o macho alfa! NOJO #Encontro	negative
Hoje a Miriam sai? Sim ou com certeza? #MasterChefBR	neutral
Guilherme Arantes √© o maior! #Encontro	positive
T√£o triste ter que assistir #masterchefbr s√≥ na quarta :(, n√£o da nem pra acompanha a #	negative
A convidada de hoje √© a F√°tima Bernardes (@user). Acertei? #VideoShowAoVivo	neutral
Sardinha em lata √© um ingrediente fant√°stico. Al√©m de saborosa, √© vers√°til. #MasterChefBR	positive
"""Um beb√™ de 14 anos"" HAHAHAHA #TheNoite"	negative
Ganhei a noite com vcs cantando Se Olha no Espelho. #ConversaComBial  #MaiaraeMaraisaNoBial @user	neutral
Se fosse eu com essas sardinhas, ia fritar elas, deixar bem sequinha colocar um lim√£o do lado, t√° pronto meu prato #MasterChefBR	positive
Que rid√≠culo #Encontro	negative
#VideoShowAoVivo fa√ßa um #MeuVideo√âUmShow parte II com a Claudia Raia pra vermos o restante da carreira que faltou.	neutral
#Bial para todos e #Pedro para os √≠ntimos!! Berrooooooo...... Morrroooooo... #Conversacombial	positive
Acho que o Vitor B que vai hj :/ #MasterChefBR	negative
Nossa v√©i!!  Olha a camisa e a gravata  do @user . #VideoShowAoVivo	neutral
@user se divertindo ao som do √â O Tchan, uma fofa!  #VanessaDaMata #CaixinhaDeM√∫sicaDVDVanessaDaMata #AltasHoras	positive
Bem triste que o @user saiu do #MasterChefBR :(	negative
#MaisVoce EU QUERO MEU CABELO ASSSIMMMMMMM	neutral
Ahhh como √© bom ouvir @user falar... sempre confortante #conversacombial	positive
#MasterChefBR to com medo pelo meu amorzinho @user fica amore Tinha que sair essa nojenta da Miriam	negative
#VideoShowAoVivo a convidada do meu v√≠deo √© um show √© o moz√£o do @user @user	neutral
Uma fam√≠lia que se chama AMOR! T√¥ aqui emocionada de ver, que delicia, que alegria, uma felicidade imensa ‚ù§Ô∏èüôèüèª‚ù§Ô∏è Deus aben√ßoe  #encontro	positive
Partiu assistir a reprise do #MasterChefBR e sofrer com a saida do @user de novo. Pq sou dessas! Rever a cena q estra√ßalhou meu ‚ù§ üò¢üíî	negative
J√° estou com meu avental de comentar #MasterChefBR	neutral
A @user √© a melhor pessoa, j√° era f√£ agora triplicou! #AltasHoras #NaturalOnde? #NuncaQuis #TbmN√£oQuero #Barrig√£oxBuraquinho hahaha	positive
Jacquin falou que Bel√©m √© limitada pra sobremesa? MANO, esse cara n√£o tem no√ß√£o nenhuma do que ele falou!!! #masterchefbr	negative
toda vez que assisto Masterchef d√° uma fome... #MasterChefBR	neutral
Perdi de ver o #MasterChefBR por motivos de me abafei nas cobertas e esqueci da vida	positive
#MasterChefBR quanta espinha.... deus me livre....	negative
O menino √© o Zaque do Love Store! #VideoShowAoVivo	neutral
Maiara e Mara√≠sa no #ConversaComBial vamos curtir um modao @user ?	positive
#MasterChefBR VAI VITOR B N√ÉO DECEPA PARTE DO DEDO HOJE!!!!	negative
@user Eu teria medo de vazar meus nudes, claro. #Encontro	neutral
O programa t√° demais hoje. #DomingoLegal	positive
Mem√≥rias da querida @user no #MaisVoce me fazendo sentir saudades e chorar! @user	negative
N√£o foi essa semana mas na pr√≥xima a Mirian sai #MasterChefBR	neutral
#MaisVoc√™ minha irm√£ cal√ßa 34 e compra sapato em qualquer loja,nunca teve dificuldade em encontrar essa numeracao	positive
#MasterChefBR essa Mirian s√≥ quer fazer o que d√° na telha, √¥ mlr chata	negative
Acho q o mr catra fumou alguma coisa antes de gravar a entrevista com o @user kkkkkkk #thenoite #danilogentili	neutral
#DuasCaras foi uma novela maravilhosa, merece reprise! Lembrando que neste ano a novela completa 10 anos. #v√≠deoshowaovivo	positive
Chegou visita: abre umas latas de ervilha!!! Meu Deus!! #MasterChefBR	negative
As pessoas confundem SOTAQUE com falar errado, falar g√≠ria etc... nada a ver... termos e express√µes regionais √© diferente! #VideoShowAoVivo	neutral
Quero abra√ßar o @user e colokr num potinhoüòç #MasterChefBR	positive
Miriam cai fora...fazer a coitadinha n√£o pega..  #MasterChefBR	negative
#V√≠deoShowAoVivo Otaviano. Otaviano. Voc√™ n√£o lembra de mlm voc√™ esqueceu de mim esqueceu sou eu maria Cristina	neutral
Olha essa mulher, tem 9 filhos (de 4 a 24 anos) super realizada. Seria meu sonho?! üòÅüíï #Encontro	positive
S√≥ de ver a sardinha em lata j√° t√° me dando alergia! #alergica #enlatados #masterchefbr	negative
#MasterChefBR s√≥ de ver sardinha eu j√° tava eliminada	neutral
#Encontro ACHO QUE EU AMEI MESMO DISTANTE! Que lindo Nando Reis...	positive
Hoje vou ver o #MasterChefBR pois ontem estava grudada no #powercoupleBrasil TRISTE pq j√° soube da elimina√ß√£o do @user	negative
Acho que quem vai sair √© Douglas no #MasterChefBR	neutral
Sandy mt maravilhosa socorro #Encontro	positive
O agri√£o t√° se sentindo sozinho nesse prato de moqueca #MasterChefBR	negative
"""Advogado de Lula"" ""Na Justi√ßa"" ""Nando Reis"" ""The National"" ""Two Ghosts"" #Encontro Kiwi Zimb√°bue"	neutral
se esse thiago castanho olha assim pra mim eu fico at√© nervoso #MasterChefBR	positive
O Vitor saiu eu n√£o t√¥ acreditando, eu t√¥ bem triste #MasterChefBR	negative
#MasterChefBR amanh√£ no YouTube vou dar mil replay no coment√°rio do Valter kkkk	neutral
Maravilhosas @user no #ConversaComBial	positive
Gosto do padre, mas cantar trem bala √© demais #ConversaComBial	negative
Eu faria tr√™s pratos. Porque um seria meu com toda certeza.  #MasterChefBR	neutral
E come√ßooooooouuuu @user  #ConversaComBial #MaiaraeMaraisaNoBial	positive
Fiz um brigadeiro para olhar #MasterChefBR mas n√£o deu certo, hj √© eu que saio	negative
Thais Ara√∫jo. N√£o gosta de ab√≥bora! üíî  #MaisVoce	neutral
FAM√çLIA BONITA A DO SERGINHO GROSNJNKDKJ #altashoras	positive
#VideoShowAoVivo no mem√≥ria foi dito que Carlos ficou casado 23 anos, com Eva, n√£o seria 53 anos?	negative
#Pablo diz em sua m√∫sica: PORQUE HOMEM N√ÉO CHORA... Mentira, Chorei Com @user no final do #ConversaComBial #MaiaraeMaraisaNoBial.	neutral
A Sophia √© muuuuito maravilhosa, acompanho desde RBR, amo muito #AltasHoras	positive
FILMES de baixa audi√™ncia ----&gt;&gt; ESCURID√ÉO TOTAL  #AltasHoras √â o Tchan Vanessa da Mata #ClaudiaLeitteNaSabrina #FabricaDeCasamentos Titanic	negative
Cad√™ @user ? Quando ela vai t√° no #AltasHoras	neutral
hoje #AltasHoras t√° muito bommm üòç	positive
Pqp hein #MasterChefBR	negative
Vim s√≥ falar de #MasterChefBR mesmo!	neutral
Nossaa Canta Mt üò±  #Domingolegal  #CDANoDomingoLegal	positive
Esse neg√≥cio de n√£o conseguir demonstrar sentimentos sou mt eu, n√£o consigo falar eu te amo pros meus pais e eu odeio isso. #Encontro	negative
#VideoShowAoVivo a vers√£o em portugu√™s √© cantada por Robson Anjo.	neutral
otimo #ConversacomBial hj, um dos melhores so far.	positive
Como assim o Vitor B saiu?! Ontem n√£o aguentei e dormi üò¢ #MasterChefBR	negative
#MaisVoc√™ algu√©m sabe se chef Erick tem tt?	neutral
Maluma de √≥culos estilo nerd consegue ficar mais gostoso #TheNoite	positive
Tudo embolorada as sardinha do Jacquin #MasterChefBR	negative
Pessoal falando q a Namaria foi corajosa...corajoso foi esse menino q fez manobras de bike com Namaria. Do jeito q ela √© zicada... #MaisVoce	neutral
Sigo e indico  #Encontro #SextaDetremuraSDV	positive
N√£o gosto da Douglas #MasterChefBR	negative
A Band est√° planejando para o pr√≥ximo ano uma vers√£o do #MasterChefBR com famosos	neutral
Essa entrevista com o Drauzio tem um teor de verdade t√£o grande que eu nem acredito que isso t√° passando na Tv aberta... #ConversaComBial	positive
Victor B foi eliminado meu Deus crush volta aqui por favor #MasterChefBR	negative
@user lindo demais #VideoShowAoVivo	neutral
#Encontro Demais esse liban√™s violinista!	positive
Quem mentiu pra esse Marco Luque que ele √© engra√ßado? S√≥ o Serginho ri. Mais sem gra√ßa que dan√ßar com irm√£o em festa. #AltasHoras	negative
Rolam boatos que Mara√≠sa √© do babado #ConversaComBial	neutral
Amando o assunto da conversa, Dr√°uzio divo #ConversaComBial	positive
Hoje √© dia de #MasterChefBR = ja ter jantando mas na hora do programa voc√™ comer at√© ficar triste	negative
#DomingoLegal ah, esqueci fora Themer. Como diz Carlinho Maia, ta na moda kkkkkk	neutral
vanessa da mata AMOOOOOOOOOOOOOOOO #altashoras	positive
REPETIDO CARAI #MasterChefBR	negative
#V√≠deoShowAoVivo A cena da Ivana ontem em A For√ßa do Querer foi bem forte, vcs podiam reprisar hj n√© pf	neutral
Obrigada por mostrar minha deusa Vivianne Pasmanter #VideoShowAoVivo	positive
N√£o creio que o Crush do #MasterChefBR saiu üò¢üò¢üò¢ @user vamos torcer por uma repescagem üôè	negative
#altashoras assistindo	neutral
ESSA MULHER √â GUERREIRA TEVE 9 FILHOS #ENCONTRO	positive
#MasterChefBR Essa broaca da Mirian vai ficar por causo do teatrinho clich√™ dela	negative
O homem participa com um espirro. @user sobre fecunda√ß√£o #AltasHoras	neutral
#MasterChefBR nem come√ßou e j√° vou torcer pra #EquipeAzul por motivos de Mirian que t√° na equipe vermelha!	positive
ESSA √â A PROVA QUE EU T√î MAIS NERVOUSA DA HIST√ìRIA DAS PROVAS NERVOSA #MasterChefBR	negative
#MasterChefBR se eu pudesse provar os pratos	neutral
Coisa mais linda essa edi√ß√£o com a m√£e do @user !!!!! üòçüòçüòçüòçüíóüíóüíóüíó#altashoras	positive
Ser√° que n√£o tem nenhuma assessoria pra ver quais s√£o nossas express√µes e como utilizamos de verdade?!!! E o sotaque!!! Pqp #VideoShowAoVivo	negative
Paola t√£o baixinha e ela tava descal√ßa #MasterChefBr	neutral
vendo #thenoite somente pelo malumaaa	positive
#Encontro Quem √© simone e simara perto das Irm√£s Galvao nos anoa 70 kkkkkk	negative
#thenoite @user cara s√≥ agora identifiquei o @user	neutral
H√° alguns meses tentei me inscrever numa capelania prisional. O #ConversaComBial de hoje com o @user s√≥ aumentou minha vontade.	positive
#MasterChefBR essa Mirian e esse leonardo tem que sair pra ontem j√°	negative
#MasterChefBR Fica #FicaYuko	neutral
Assistindo Masterchef s√≥ por causa da Ana Luiza, tem as melhores frases, al√©m de parecer a Cassie‚ù§.. #MasterChefBR	positive
Silvia ganhou! Cen√£o √©pico de Duas Caras! #videoshowaovivo	negative
Lembrando que o Mr¬∞ Catra √© judeu e Soci√≥logo!  #TheNoite	neutral
Quero ver voc√™ seu lindo aqui amanh√£ @user #videoshowaovivo	positive
ser√° que existe simpatia pra tirar nota boa na escola? se tiver me passa pq to precisando #VideoShowAoVivo	negative
Batuque na cozinha a sinh√° n√£o quer üé∂üé∂ #conversacombial	neutral
Celso na casinha de bonecas üòç #CarinhaDeAnjo #DomingoLegal #SBT	positive
Como que esse povo faz doce e √© magro! D√° pra entender???? ü§£ü§£ü§£#Encontro	negative
#MaisVoce n√£o se desconta FGTS s√≥ recolhe, o que desconta √© INSS!	neutral
Emocionad√≠ssima com a homenagem do @user  a Nelson Xavier. Que ator, gente! Que ator! #RIPNelsonXavier  #VideoShowAoVivo üò•üò•üò•	positive
Quando ia passar roupa branca era a pior parte,  a cinzas caia na roupa e ficava manchada #MaisVoce	negative
Beatriz parece com F√°tima o sorriso √© igual .Laura √© a cara do Bonner #Encontro	neutral
vitor foi bem agr pra ficar melhor s√≥ com a saida da mirian #masterchefbr	positive
O genocida Stalin disse uma vez que se n√£o deixavam os inimigos terem ideias, por que deixariam ter armas? Hitler desarmou tamb√©m #TheNoite	negative
Queria me comunicar com essa capit√£o Vitor rs  #MasterChefBR	neutral
Ai, Ana Luiza √© linda n√© gente? &lt;3 #MasterChefBR	positive
#conversacombial esse mo√ßo ta confundindo ansiedade pontual com a doen√ßa ansiedade. A doen√ßa ansiedade √© HORR√çVEL, mo√ßo. N √© pr√© show legal	negative
Come√ßou #MasterChefBR	neutral
"#MaisVoce sou muito f√£ do Dan, nossa que del√≠cia essa entrevista, adorei ele no filme ""tempos de paz"" @user √© um ser humano lindo!"	positive
PQP, n√£o pode ficar entre Vitor B e Yuko. TEM QUE SAIR OUTRA PESSOAAAA... qualquer um!!!! #MasterChefBR	negative
#Encontro tema √≥timo. J√°  vi apresentadora de TV  dizer q depois de certa idade n√£o se deve usar roupa de coc√≥tinha	neutral
Alguem sabe o #ig do #cozinheiro gato do #√âdeCasa????	positive
Seria @user o sans√£o do #MasterChefBR ? Cortou o cabelo e foi eliminado üòê	negative
Nem sei quem eu quero que saia pois a √∫nica pessoa que eu n√£o gosto √© o Leonardo e ele t√° no mezanino! #MasterChefBR	neutral
#VideoShowAoVivo melhor programa da tarde!!	positive
#masterchefbr mas s√©rio, o Fabrizio fez um prato muito bosta, talvez tenha ficado gostoso, mas passou uma impress√£o p√©ssima	negative
"Dan Stulbach no #MaisVoce: v√≠deos da √çsis Valverde dizendo que o admira, e do Fiuk ""agradecendo a admira√ß√£o""..."	neutral
Ana maria manda pra mim,ou me convida ora ir no Programa que eu como o nhoque de ab√≥bora #Maisvoc√™	positive
CALADOOOOOOOOOOOOO #Encontro	negative
maira √© a que mais fala e √© da bagaceira da dupla podemos ver claramente #ConversaComBial	neutral
#VideoShowAoVivo Que cor de batom perfeita √© essa?!  Amei!!!	positive
Disseram que todos deveriam ser ansiosos. Pelo amor de Deus, gente! Ansiedade n√£o √© brincadeira n√£o. #ConversaComBial	negative
#masterchefbr a pergunta √© : QUEM VAI FICAR COM A MIRIAM ???	neutral
Terminei de assistir o epis√≥dio agora e a produ√ß√£o do #MasterChefBR t√° √≥h: de parab√©ns! üôåüèª	positive
A mulher faz um monte de filhos e pr√≥prios que cuidam um dos outros. A√≠ √© mole, n√© miga? #Encontro	negative
como seria uma galinhada desconstru√≠da?? #MasterChefBR	neutral
Aline Moraes mais linda ainda #AltasHoras	positive
#VideoShowAoVivo Parece que n√£o vai come√ßar hoje porque temer t√°  bombando , Jesus nos acuda .	negative
Hoje, no #Encontro eu percebi que n√£o sou o √∫nico que curte uns @user ! (e que o elenco da @user n√£o sabe dan√ßar...)	neutral
Ta come√ßandooooooooo #MasterChefBR	positive
√â dif√≠cil acreditar que em pleno s√©culo XIX ainda existem pessoas que acreditam que homem de vdd n√£o ajudam em casa #Encontro	negative
Vou assistir #TheNoite e dormir, fui üíú	neutral
Mas, a gente lida com isso todos dias, cada pequena vit√≥ria √© uma celebra√ß√£o #ConversaComBial	positive
"todo programa a Ana Paula fala ""hoje mais do que nunca"" #MasterChefBR"	negative
E ae Victor B, vamo fechar? #MasterChefBR	neutral
o Vitor B. √© o unico crush que eu tenho que n√£o √© asi√°tico #MASTERCHEFBR vote @user for the #BTSBBMAs top social artist award	positive
Puta que pariu eu vou infartar #MasterChefBR	negative
Hoje vou me sentir um lutador no #MasterChefBR ...S√≥ me sentir por que o porte f√≠sico mesmo...	neutral
Por√©m, meu crush segue sendo o Fabrizio. Hom√£o da porra!!! #MasterChefBR	positive
O #VideoShowAoVivo depois da @user , est√° precisando se reinventar viu? T√° chato demais!	negative
@user , s√≥ pode ser o Nicolas Prattes.   #VideoShowAoVivo	neutral
Sou apaixonado pela @user mulher de postura, e um sorriso encantador #MasterChefBR Um dia ainda vou ao #Arturito	positive
Pelo amor de Deus gente #MasterChefBR	negative
"Acho que ficar falando ""eu te amo"" a qualquer momento √© como usar uma roupa de gala para coisas triviais. Tira o significado. #Encontro"	neutral
Rita Lee maravilhosa sempre!! üíñ #VideoShowAoVivo	positive
Eu como apresentadora de TV procuraria saber se o convidado tem alguma restri√ß√£o alimentar antes d escolher a receita n√©, Namaria. #maisvoce	negative
Bora povo de casa todo mundo na #Quemsai pq a tia Ana Paula pediu üòÇ #MasterChefBR	neutral
#QuartaDetremuraSDV #MasterChefBR  O melhor progama culin√°rio do Brasil e do mundo üíñüíñüíñ	positive
Uma saudade chamada: Danilo de camisa cor de vinho/rosa, mangas dobradas e colete preto #TheNoite	negative
O crime organizado: Nada funciona sem ordem, sem disciplina, sem autoriza√ß√£o. Funciona, n√©? #ConversaComBial	neutral
@user J√° estou aqui te vendo no #ConversacomBial e adorando mas a minha sonol√™ncia amanh√£ √© certa!! üòÇüòÇüòÇ	positive
Grande perda para as artes brasileiras, Nelson Xavier! Descanse em paz! #VideoShowAoVivo	negative
Como que os figurantes da pra√ßa conseguem ficar tanto tempo fingindo que est√£o conversando?! ü§îüòÇüòÇüòÇüòÇ #TheNoite	neutral
Melhor come√ßo de programa disparado Hahahahaha üòÇüòÇüòÇüòÇ #ConversaComBial	positive
#VideoShowAoVivo prefiro Julia no vetido de noiva vermelho	negative
c√¢mbio negro  #Encontro	neutral
#VideoShowAoVivo que saudade eterna do vando arrepia ate a alma	positive
17 filhos. Socorro! #AltasHoras	negative
#VideoShowAoVivo √© o @user , tenho certeza!!!	neutral
Vai Vitor fidapest #masterchefbr	positive
Elas t√£o beeem perdidas nos g√™neros musicais heim #ConversaComBial	negative
Gosto mais do #timeazul, por√©m o menu do #timevermelho foi mais atrativo pra mim #MasterChefBR	neutral
#ConversaComBial hoje est√° bem interessante üëåüèªüëåüèªüëåüèª	positive
#MasterChefBR espero que o programa n√£o se perca... N√£o pode excluir o menino por causa de acidente de trabalho...Ele tem que continuar	negative
hoje √© dia de mta emocao... #TheNoite  @user @user	neutral
A sabedoria do Padre F√°bio √© anormal. Todo mundo deveria ter a honra de ouvi-lo ou l√™-lo pelo menos uma vez na vida üôèüòç #ConversaComBial	positive
CAD√ä AQUARELAAAAAA #DomingoLegal	negative
QUERO VER O JIN NA PROXIMA TEMPORADA DE #MasterChefBR BULTAOREUNE #BTSBBMAS	neutral
Ai que m√∫sica linda‚ù§ #Encontro	positive
Muita injusti√ßa isso com o Vitor #masterchefbr	negative
Sexta (12), os infantis e Talk Show do SBT marcaram:  #MundoDisney 3.6 #BomDiaECia 6.4 #ClubeDoChaves 6.9 #TheNoite @user 3.3	neutral
Ai que lindas @user #ConversaComBial üíï	positive
t√¥ precisando de um banho desses pra ver se eu paro de ser trouxa pelo crush #VideoShowAoVivo	negative
Douglas saiu, falta a Mirian agora #MasterChefBR	neutral
Oooh Maiara e Maraisa, sabe o que voc√™s t√™m? C√™s tem sorte que eu amo o c√™s! @user no #ConversaComBial ‚ù§Ô∏è	positive
No programa #encontro desta quinta, falaremos sobre preconceito e racismo e convidamos uma atriz branca. Representatividade, N√ÉO.	negative
E a maioria dos cen√°rios de talk shows tem foto de cidade no fundo üåÉ üåÉ #ConversaComBial	neutral
"#videoshowaovivo p√¥ t√¥ muito feliz hoje, v√≠deo show passando ao vivo aqui em Rio Branco ""Acre "" e podendo interagir com vcs Joca e  Ota, amo"	positive
Douglas melhor pessoa dps da yuko,n√£o podia ter sa√≠do #MasterchefBR üò≠üò™üòì	negative
#FicaVictorB tu n√£o v√° estragar essas sardinhas geniais #MasterChefBR	neutral
Vanessa Da Mata que √≠cone!!!! Rainha! #AltasHoras Ai, Ai, Ai	positive
meu deus a maiara n√£o deixa a maraisa falar #ConversaComBial	negative
Consolidados - GLOBO (16/05):  #BDSP 11.0 #BomDiaBrasil 11.4 #MaisVoc√™ 8.3 #BemEstar 7.2 #Encontro 8.3 #SP1 12.8 #GloboEsporte 11.7	neutral
Vendo a @user no #EDeCasa orgulho da Bianca	positive
"""precisamos de uma musica que homens n√£o tenham vergonha de ouvir"" PRECISAMOS √â DE HOMENS MELHOR! #ConversaComBial"	negative
Sexo, sangue, viol√™ncia. N√£o √© Game of Thrones, √©  #MasterChefBR	neutral
#VideoShowAoVivo  Parab√©ns Otaviano... Deus te aben√ßoe grandemente... tudo de bom...üòòüòò	positive
O cara se enrolou n√£o sei quanto tempo numa sardinha #MasterChefBR	negative
#Encontro.  Eu, h√° muito fa√ßo permanente nos meus cabelos para que eles fiquem pixaim. S√≥ h√° 6 anos n√£o fa√ßo, depois do AVC.	neutral
#MaisVoc√™.  Que mulher linda! @user  √© um encanto! T√£o bom v√™-la ! Bom diaa!!!	positive
@user √© um canastr√£o  #VideoShowAoVivo	negative
"A menina √© f√£ do Justin Bieber, assistiu o filme dele e ""se inspirou""...eu sou f√£ do @user ... #TheNoite"	neutral
#VideoShowAoVivo @user  Diva, Linda ... Que mulher completa üòç‚ù§  Tomou de conta da novela	positive
EU ACREDITO N√ÉO GENTE PFVR √â ZICADO ISSO #MasterChefBR	negative
vai l√°, foga√ßa #APr√©via #MasterChefBR	neutral
Deu vontade de comer esse macarr√£o feito com abobrinha üòéüëè #MaisVoc√™	positive
toda a ter√ßa eu perco a prova do #MasterChefBR por causa do ingl√™s s√≥ pego a de elimina√ß√£o affff	negative
Daqui a pouco no #TheNoite com @user tem #APra√ßa√©Nossa30anos	neutral
Hoje tem Bene Barbosa do MVB no #TheNoite !!!! Imperd√≠vel!!!	positive
Que batata verde √© essa??? #MasterChefBR	negative
t√¥ s√≥ pelo #MasterChefBR hoje üåöüë©üèª‚Äçüç≥	neutral
O Padre Fabio de Melo me passa uma paz, deve ser a voz dele. Bial acertou em cheio no convidado de hoje! #ConversaComBial	positive
O Padre Fabio de Melo desperta a luxuria nas mulheres e nas gays,, e Luxuria √© pecado #ConversaComBial	negative
Na cama em TAQUARITINGA-SP #altashoras	neutral
Ja era apaixonadinha no maluma na epoca  do dvd do Lucas #TheNoite	positive
S√≥ mesmo os maquiadores da globo pra fazer a gatissima da Vivian√© Pasmanter ficar feia. Parab√©ns  #VideoShowAoVivo	negative
FGTS √© obriga√ß√£o que a empresa recolhe. O que se desconta √© o INSS. #MaisVoce	neutral
 ∫NADESSA AT√â O FIM ∫  ∫Rodrigo Caio ∫  ∫Zeca Pagodinho ∫ #KissingStrangersVIDEO #TBTNoEIGames #TheNoite Edmundo Tandara Volero	positive
"Que diabos √© ""prote√≠na de alto valor biol√≥gico""? Tucanaram a carne de primeira? #MasterChefBR"	negative
Ai meu Cora√ß√£o!!!!  #MasterChefBR	neutral
Emocionado com a hist√≥ria do Willian @user #Encontro	positive
MIRIAN E LEONARDO: DESPREZ√çVEIS. FIM #MasterChefBR	negative
#MaisVoc√™ Ana Maria o FGTS n√£o √© Descontado do sal√°rio.  S√≥ √© informado.  Descontado e repassado √© o valor do INSS.	neutral
Bial √© maravilhoso, n√£o adianta...  #ConversaComBial	positive
Fico vendo essas pessoas que viajaram por v√°rios pa√≠ses enquanto eu quero viajar mas n√£o tenho nem 1 real #Encontro	negative
Se tem medo de vazar seus nudes, n√£o fa√ßam nudes. Simples assim. #Encontro	neutral
"@user N√£o vejo #MasterChefBR por motivos de sono, mas ver seus coment√°rios no Twitter √© genial. ""Gordinho barbudo no mezanino"""	positive
N√£o acredito q a equipe vermelha ganhou #MasterChefBR	negative
Ana Maria ser√° um obst√°culo. Ser√° que vem mais um meme a√≠? #MaisVoce	neutral
Acertei!! Amei #VideoShowAoVivo	positive
ai caralho!!! que nervoso !!! ja entrou pra hist√≥ria do #masterchefbr	negative
@user @user Deu pra perceber pelo teu pesco√ßo! Mas s√≥ vc emagreceu n√© kkkkkkk... o resto, üê≥ #MasterChefBR	neutral
Looks maravilhosos no #VideoShowAoVivo	positive
#thenoite A familia do Jair Rodrigues n√£o aparece muito na TV. O 'Jairzinho' ent√£o sumiu a tempos	negative
Galinhada desconstru√≠da = frango desfiado com arroz #MasterChefBR	neutral
Quero encontrar a La√≠s Souza. Tenho uma admira√ß√£o toda especial por ela. #AltasHoras	positive
Douglas n√£o pode sair hoje üôè #MasterChefBR	negative
Vitor B. estragou a sardinha plano A dele na hora de montar. #MasterChefBR	neutral
finalmente uma receita diferente de sardinha pq aqui s√≥ da sardinha tipo 2/3 do ano num aguento muito #MasterChefBR	positive
Perdi #MasterChefBR ontem :'c	negative
#Encontro  Claudia gimenes est√° a cara da.Dilma	neutral
Crl o mestre mandou e o melhor , #TheNoite	positive
Cada porrada no Bob azul eu passo mal  #MasterChefBR	negative
Mas s√≥ a @user pra completar os desafios do Mestre Mandou!! #TheNoite	neutral
Ansiosa daqui a pouco @user  no #VideoShowAoVivo vamos l√° ver nossa princess brilhar @user	positive
Ta√≠s Ara√∫jo n√£o comeu ab√≥bora mas escutou muita abobrinha no #MaisVoc√™	negative
Vamos ver se hoje repete a regra: TODA sertaneja que vai no #TheNoite quer dar pro Danilo	neutral
Eu amo a Yuko!!!!!!!!  #MasterChefBR	positive
MIIIRIAN FAL√áAAAAAA #MASTERCHEFBR	negative
Audi√™ncia de 16 de Maio - SP  Mister Brau 20.7 #PowerCoupleBrasil 7.6 Totalmente Sem Rumo 2: Defensores da Natureza 6.8 #MasterChefBr 6.3	neutral
se n√£o for pra casar duas vezes que nem o Nando Reis eu nem quero #Encontro	positive
#AltasHoras em casa em pleno s√°bado	negative
Tomara que n√£o estraguem os baby beef #MasterChefBR	neutral
Eu acho que a Sophia devia ficar pra sempre no #VideoShowAoVivo	positive
Nao creio que o Vitor B. Saiu #MasterChefBR	negative
Se puder vou fazer meu pr√≥ximo n√≠ver, s√≥ sobre unic√≥rnio kkkkk üòÇ ü¶Ñ #MaisVoce	neutral
"Amoooo ""Adultos com voz de crian√ßa"" deveria passar todos os dias @user @user @user @user ‚ù§  #TheNoite"	positive
#masterchefbr ai que nervosuuu	negative
Brasil tem potencial pra tudo porque tem uma grande variadade de produtos exoticos e unicos #MasterChefBR	neutral
Daqui a pouco tem Marcos &amp; Belutti no #encontro ü§óüòç	positive
vitor b. cagou no pau ne #MasterChefBR	negative
Ser√° que o L√©o ganha sua primeira prova em grupo? #MasterChefBR	neutral
Assuntos do Momento #LulaEuConfio Lula dep√µe hoje ao juiz S√©rgio Moro #MasterChefBR Epis√≥dio teve muitas reviravoltas e discurso emocionante	positive
J√° com fome pra assistir o #MasterChefBR	negative
Vaidoso e muito  rs #ConversaComBial	neutral
Tudo de Unic√≥rnio, que lindoooo üåàüåà #MaisVoc√™	positive
A Vanessa da Mata est√° estranhamente envelhecida, e n√£o falo do seu rosto, mas do seu gestual, postura. Parece uma senhora de 60 #altashoras	negative
Aqui em Bel√©m falamos chopp.  #VideoShowAoVivo	neutral
#VideoShowAoVivo como sempre muito bom	positive
@user eu amo voc√™ como apresentadora mas n√£o consigo achar interessante o @user #Encontro Sucesso pra voc√™!	negative
O cara √© MUITO picaaaaaa, deixa ele falar!!!! #Encontro	neutral
#MasterChefBR o bom disso √© que cada nego vira chefe	positive
#EDeCasa minha esposa est√° de jejum no consult√≥rio e est√° enlouquecendo vendo essa receita...	negative
Que que se fez? Sardinha ue #MasterChefBR	neutral
@user Voc√™ √© DEZ!!  #VideoShowAoVivo üì∫	positive
Qnd dividem os times no pgm fico aflita, com d√≥ dos √∫ltimos. Parece eu na turma qnd tem trabalho em grupo e ningu√©m escolhe! #MasterChefBR	negative
AAAAAAAAA VOZ O ROSTINHO   #DomingoLegal	neutral
meu vitor b ficou entre os melhores, to bem feliz sim #MasterChefBR	positive
Gente to solu√ßando de chorar vendo #Encontro	negative
"Mais importante √© assistir o v√≠deo ""Chamaram-me Negra""!  #Encontro"	neutral
Owwww homem lindo, iluminado e  inteligente esse Padre F√°bio de Melo.  #ConversacomBial	positive
"Muito estranho esse #Encontro O tema de hoje √© ""pessoas que n√£o demonstram o que sentem""  Mas gente, devia se chamar Div√£..."	negative
Kkkkkkkkkkkkkkk que m√∫sica √© essa #TheNoite	neutral
Assistindo #MasterChefBR &lt;3 amo demais	positive
Eu n√£o aguento hist√≥rias de ado√ß√£o üò≠ #encontro	negative
Eu quero os coment√°rios do @user sobre a elimina√ß√£o do #MasterChefBR de hoje na minha mesa at√© as 3h	neutral
Gente a F√°tima √© t√£o maravilhosa que eu tenho vontade de Guardar num potinho s√≥ pra mim. #VideoShowAoVivo	positive
Lembro que fiquei chocado qndo a Hebe morreu #MaisVoce	negative
@user metade do Senado deveria ruir pra podermos pensar em boas op√ß√µes para novas elei√ß√µes! Que a justi√ßa seja feita #encontro	neutral
Que fofura √© o Thomas üíô #AltasHoras	positive
#VideoShowAoVivo t√° parado por aqui ein!? Kk	negative
No tempo desse ferro as roupas eram de algod√£o @user #MaisVoce	neutral
aAaAAaAAAAaaa ESSE MOMENTO √â  MEU #ConversaComBial	positive
SOS Eles s√£o MUITO ruins #altashoras	negative
Chorando at√© amanh√£ com: Quem sabe dan√ßa  Quem n√£o sabe ... üòÇüòÇüòÇ#TheNoite	neutral
Babo demais nos vestidos da Cissa Guimar√£es, usaria todos  #EDeCasa	positive
17 filhos. Trepadeira. #altashoras	negative
At√© o Joca esta falando do vestido da Sophia #VideoShowAoVivo	neutral
ow o Padre F√°bio de Melo fala bem demais n√©? to curtindo a entrevista #ConversaComBial	positive
#VideoShowAoVivo, to tao emocionado que n√£o paro de chorar kkkkkkkkkkkkk	negative
Cara ri muito da cara da Aderlize  #MasterChefBR	neutral
Um exemplo para todos n√≥s! #Encontro	positive
N√£o faz intervalooooooo PasmanterEPivaNoMaisVoce #MaisVoce	negative
#VivianePasmanter √© #Germana em #MundoNovo!? üò± Impressionante a caracteriza√ß√£o! Chocado!!! #VideoShowAoVivo	neutral
#MasterChefBR Douglas saiu tombando msm. O rei desse programa sem mais	positive
2 da manh√£ com essas hist√≥rias de terror t√° dif√≠cil üò¨üò¨ #TheNoite	negative
Ana Paula padr√£o vai pedir desligamento da Band depois de tanto recolocar o len√ßo nos bonecos #MasterChefBR	neutral
Que del√≠cia minha Fatinha no  #VideoShowAoVivo	positive
Se eles falarem de SOA eu vo morre #TheNoite	negative
@user de salsicha CUT no castigo do mestre mandou no @user  k k k #TheNoite #MestreMandou	neutral
O  padre F√°bio de Melo √© cantor, padre e bonito pra caramba. Que hom√£o da porra.   #Conversacombial	positive
Chefes, vcs me assustaram  #MasterChefBR	negative
escutando Raridade e impossivel √± lembrar da filha do @user  #MasterChefBR #QuintaDetremuraSDV #PorIstoUmaFor√ßaMeLevaaCozinhar	neutral
Mariah sempre linda tamb√©m.  Era um dos meus blogs preferidos!#VideoShowAoVivo	positive
Quem nunca comeu farofa de mi√∫dos n√£o sabe o que √© bom na vida! Esses participantes do #MasterChefBR s√≥ devem comer magret de pato msm!	negative
Olha estamos aqui so pra saber se Vitor B continua #MasterChefBR	neutral
#TheNoite com @user est√° sensacional.	positive
#VideoShowAoVivo Cissa narrando kkk igual nota de falecimento nos carros funer√°rios kkkkkkkkk	negative
que pacto √© esse que #MasterChefBR fez pra ta nos trends at√© agora? O pacto foi maior que o do temer	neutral
#encontro 70 anos s√≥ de carreira. √â muito talento. √â muita hist√≥ria üòçüòçüòçüòçüòçüòçüòçüòçüòçüòçüòçüòç	positive
Cantores, pf n√£o mudem o ritmo das m√∫sicas...üé§üé∂ #altashoras	negative
Aquele momento que toca Slipknot no Mais Voc√™ #MaisVoce.	neutral
O que salvou esse pgm agora foi essa poesia do Braulio ‚ù§Ô∏è  #Encontro estou grata por essa homenagem linda! Por mais pessoas assim!	positive
Olha esses pratos do #masterchefbr. √â pouca comida at√© pra quem est√° sem fome üòí. Imagina pra quem acabou de treinar?	negative
oi, queria saber por que existe tanta manifesta√ß√£o contraria a criminaliza√ß√£o da homofobia e quem s√£o os principais opositores? #encontro	neutral
#MasterChefBR #Equipeazul Gosto muito da Ana, ela vai indo, neutra, at√© a final.	positive
#VideoShowAoVivo Desculpa, mas aqui no Par√° nem o mais interiorano dos interioranos fala como essas pessoas de #AForcadoQuerer #Vergonha	negative
@user @user #MaisVoc√™ volta logo pra Espn, contigo era muito bacana	neutral
#TheNoite Adorei o tchau do Ultraje a Rigor no final do programa. Muito inteligente, vai virar tend√™ncia, repitam mais vezes. Kkkkk	positive
Acabar logo com o glamour #ConversaComBial	negative
@user @user @user @user. Fique de olho, numa possivel repescagem, ou estude mais pro #MasterChefBR 2018.	neutral
morei na carmo neto que tbm tem muita historia #conversacombial	positive
S√≥ rindo desse programa #TheNoite üòÇüòÇüòÇüòÇüòÇüòÇüòÇüòÇüòÇüòÇüòÇ	negative
Aqui em PE o nosso sacol√© se chama Dudu üòÇ #VideoShowAoVivo	neutral
essa Ti√™ √© maravilhosa üíúüíúüíú  #Encontro #F√°timaBernardes!	positive
#MasterChefBR √© uma falta de absurdo essa Miriam ter ficado... Sem t√©cnica, sem criatividade e comida feia	negative
Ih vai ter uma entrevista com os atores de ALIEN COVENANT no @user #TheNoite !!!	neutral
#MasterChefBR adoro a Yuko mas se ela orecisar sair ora @user  ficar QUE SAIA	positive
"""A sociedade est√° doente."" #Encontro"	negative
#VideoShowAoVivo o Ant√¥nio Fagundes tinha a cara de Pablo Escobar kkkkkkkkk	neutral
@user t√° t√£o bonita com esse azul√£o üíô #MaisVoce	positive
Que d√≥ do Victor gente üíî gosto do bixinho.. #MasterchefBR	negative
#TheNoite t√° no ar	neutral
Bene  Barbosa  dando uma aula sobre o desarmamento! #TheNoite	positive
Estava assistindo #MasterChefBR agr no yt e gente..a da Mirian tava ridicula parecia comida dos meus priminhos td misturado devia ter saido	negative
Hoje tem TRETA, mores. #MasterChefBR	neutral
Esse √© o melhor quadro do #TheNoite	positive
O japon√™s n√£o vai gostar disso, Guilherme Arantes üòÄ #Encontro	negative
#VideoShowAoVivo  s√≥ acho q a @user √© dan√ßarina de funk profissional √© fica enganando n√≥s	neutral
Skank no #VideoShowAoVivo melhor banda do mundo! E o melhor, na ativa ainda üòç	positive
Engra√ßado ne mirian voc√™ ai quase saindo e o fabrizio la em cima no mezanino kjjjjjj #MasterChefBR	negative
#VideoShowAoVivo Fiquei na d√∫vida se √© vestido ou camisa do joca?	neutral
Irm√£s Galv√£o s√£o maaaaraaaaaa üòçüòç #encontro	positive
#thenoite tem q ser mto idiota pra achar que um pais igual o brasil ta preparado pra ter arma liberada	negative
eu acho yuko muito ousada pq olha.. ela mete tempero sem d√≥ #MasterChefBR	neutral
#VideoShowAoVivo Cibele arrasar lindona,v√≠deo show o melhor	positive
Vou fazer greve geral se eliminarem o @user  e n√£o a Miriam #MasterChefBr	negative
Uns 3 meses atr√°s comecei chorar na rua por ver uma mo√ßa gritando desesperadamente. Seria eu #hipersensivel ??? #ConversaComBial	neutral
A Sofia √© linda DMS! #Thenoite	positive
To muito triste com a sa√≠da do @user do #MasterChefBR :(	negative
Vemos que semana que vem al√©m de saber culin√°ria tamb√©m v√£o ter que saber qu√≠mica e f√≠sica. #MasterChefBR	neutral
crtz que a D√©bora nem sabe oq t√° fazendo mas crtz que vai sair mo bom #MasterChefBR	positive
ainda t√¥ bem triste com aqueles cachorros que tem mais utilidades que eu #VideoShowAoVivo	negative
o √≥culos que ela chegou pra gravar era o que passou com a Lili BERREI #VideoShowAoVivo	neutral
Nossa rainha  no #Encontro  t√£o plena Tao linda luinha arrasa	positive
Ci√∫me #MisterCatra e #OTrajeARigor.... #RockNaVeia embrazandoooooooo #TheNoite @user	negative
Eu com uma lata de sardinha s√≥ sei fazer macarr√£o mesmo. Me julguem. #MasterChefBR	neutral
#MaisVoce EITA MUITO BOM DIA	positive
Leonardo sendo prepotente e arrogante #MasterChefBR	negative
#TheNoite #TheNoite  a popula√ß√£o com arma na m√£o, inibirar o ladr√£o.	neutral
TI√ä T√Å LINDA  #encontro	positive
M√≠rian seu maior erro ... Soberba... #MasterChef #MasterChefBR	negative
a Pol√≠cia Militar do Brasil inteiro estava acabando com o programa #encontro h√° alguns dias atr√°s agr t√° l√° dando depoimento kkkkkkkj	neutral
Que rep√≥rter √© esse do programa da F√°tima? Crush certo #Encontro	positive
N√£o quero que Victor e Fabrizio saiam #MasterchefBr	negative
a equipe azul t√° perdida ,por favor gente n√£o me decepcionem ,ganhem do vermelho  #MasterChefBR	neutral
#MasterChefBR esse trio que sempre tem minha torcida ‚ù§‚ù§‚ù§ @user @user @user	positive
N√£o sei nas grava√ß√µes falaram mas eles poderiam ter acalmado os participantes na hora do acidente #MasterChefBr	negative
Esse Victor hoje cozinhou em homenagem ao Lula ( s√≥ com 9 dedos) #MasterChefBR	neutral
#conversacombial,muito bom!!	positive
Gostei mais do look da Mariah, mas acho q ficaria melhor sem o casaco  #VideoShowAoVivo	negative
O Rodrigo Santoro deixou o Brasil mas o Brasil √ë deixa ele,, #ConversacomBial	neutral
@user t√° dando show de cristianismo! #ConversaComBial	positive
#MasterChefBR parei, n√£o assisto mais	negative
@user  e @user   J√° foram eliminadas √© isso mesmo produ√ß√£o?! @user  via @user  #MasterChefBR	neutral
Essa plateia √© das minhas üòÇüòÇüòÇüòÇ #DomingoLegal	positive
N√£o importa o tema,  voc√™ n√£o tem jeito pra esse programa F√°tima Bernardes!  #Encontro	negative
Carlos Zara era meu conterr√¢neo e vizinho do meu av√¥. #V√≠deoShowAoVivo	neutral
√â o @user com sua risada no #TheNoite e o @user com sua risada no #ProgramaDoPorchat	positive
Que prato q ficou com apresenta√ß√£o feia esse do Vitor B üò≤ #MasterChefBR	negative
Zeca Pagodinho, agora no #ConversacomBial	neutral
#VideoShowAoVivo F√°tima lindaaa manda um oi pra mimüòç	positive
sap√£o do masterchef vai rodar hoje #MasterChefBR	negative
Esse #MasterChefBR T√° cotado aaaaaaaaa	neutral
S√©rio, eu quero ser amiga do @user. Por favorzinho, vai?! #MasterChefBR	positive
Gostaram do epis√≥dio de ontem? Achei a Paola muito fraca! #MasterChefBR	negative
TAVA TOCANDO SLIPKNOT NO #MaisVoce GENTE DO CEU	neutral
#VideoShowAoVivo   Melhor programa	positive
O Vitor B vai sair hj, certeza #MasterChefBR	negative
S√≥ torcendo pra azul pq qyer ver a Miriam na elimina√ß√£o!!! Hahahha #MasterChefBR	neutral
Gata @user: O @user  e  @user s√£o os melhores comediantes. Me fazem morrer de rir. #altashoras	positive
#MaisVoce esse spray n√£o fica no cabelo, eu j√° comprei, sai muito r√°pido...ü¶Ñ	negative
sim amigos PEDRO BIAL conhece as escritas da nossa @user üíôüíôüíôüíôüíô #ConversaComBial	neutral
Dr.Rey o Dr.estranho esse Leo Lins e d+ kkkkkkkkkkkkkkk #thenoite	positive
Eu nem to acompanhando o programa e chorei aqui com o Vitor #MasterChefBR	negative
Bial ta tentando fazer o padre confessar que gosta da vida pregressa hahaha #ConversaComBial	neutral
Esse Charlie Hunnam √© Muito Lindooo, MDS #TheNoite	positive
douglas, o t√≠pico jovem leite com pera #masterchefbr	negative
O Z√© Modesto no #TheNoite	neutral
Gente esse menino lindo com certeza √© o @user lindo desde de crian√ßa #VideoShowAoVivo	positive
Filme br de terror?? #TheNoite	negative
N√£o vai rolar assistir #MasterChefBR hoje... por motivos de estarei dormindo se deus quiser	neutral
EU T√î MORTA COM ESSE CARA #ENCONTRO	positive
SAI MIRIAN VOLTA VITOR  #MasterChefBR	negative
@user se dando bem na sexta feira!! #selinho @user #encontro	neutral
Yuko √© t√£o fofa que fico toda bad quando vejo ela tomando comida de rabo #MasterChefBR	positive
Explica essa parada de colocar pedra na ra√ß√£o pro cachorro comer mais devagar #EDeCasa	negative
semana passada a Yuko tava no p√™nis do boi, hoje ela t√° nas bolas de carne. #MasterChefBR	neutral
Assisti esse epis√≥dio de #AsBrasileiras com Gl√≥ria Pires sendo m√£e de Ana e Antonia, muito legal! #V√≠deoShowAoVivo	positive
@user para de colocar outra pessoa nas entrevistas! O Augusto Cury tinha mt coisa p falar sozinho. Foi mt interrompido #ConversaComBial	negative
Pasmanter!!! Pra mim, √© o papel da vida dela. Maravilhosa!! #MaisVoc√™ @user	neutral
Ana Maria Braga √© uma figura !!! Vestida de Unic√≥rnio hahahaha #MaisVoce	positive
Vitor B saiu do #MasterChefBR , mas permanece no meu cora√ß√£o Sai mirim, volta Vitor b	negative
√â s√≥ no Brasil que tem essa misturan√ßa nas comidas?  #MaisVoc√™	neutral
üòª Hoje @user no #ConversaComBial üíú	positive
chorei real com essa prova do Vitor sozinho #MasterChefBR	negative
√â o Tchan (@user) #AltasHoras	neutral
Gente o @user t√° muito gato na verdade sempre foi mas hoje ele est√° de parab√©ns  #DomingoLegal	positive
Crian√ßa adulta s√£o mto chatas.. Aff #encontro	negative
Um olho na Sardinha e outro na caixa da Perp√©tua #MasterChefBR #TietaNoVIVA	neutral
@user √© Maravilhosa!  Parab√©ns pela coragem!  #Maisvoc√™	positive
Kkkkkkkkkkkkkkkkkkkk mano a vergonha alheia desse quadro, nunca faria. Puta merda #TheNoite	negative
Vitor recebendo s√≥ elogio pelo seu prato!!! Tchau Miriam! #MasterChefBR	neutral
#VideoShowAoVivo Enlouqueci com essa nata do rock nacional!Quero mais!!!	positive
N√£o acredito que o azul vai se lascar #MasterChefBR	negative
Boa noite!! #AltasHoras üì∫	neutral
Sust√£o da porra hein, @user  #TheNoite	positive
Pq carioca pronuncia 'naisci'? que erro horroroso! morei no Rj e nunca entendi isso #ConversaComBial	negative
A igreja precisa de mais pensadores com espiritualidade do que sarcedotes hip√≥critas, alienados a realidade humana e crist√£.#ConversaComBial	neutral
Medo Bobo um hino atemporal #ConversaComBial	positive
Ela n√£o superou o n√£o da Ta√≠s Ara√∫jo kkk #MaisVoce	negative
iPhone do Zeca Pagodinho tocou e eu pensei que fosse o meu. Fui trollado pelo Zeca! HAHAHA  #ConversaComBial	neutral
Raul e Foga√ßa, os maiores hidratad√µes que voc√™ respeita #MasterChefBR	positive
Chorei real oficial #AltasHoras	negative
Quero ver a F√°tima dan√ßando com a Anitta no meu v√≠deo e um show ahhh #VideoShowAoVivo	neutral
@user adoreeeei essa blusa üòÇüòç #VideoShowAoVivo	positive
O prato do dia √© com ab√≥bora. A convidada √© a Thais Araujo e ela n√£o come ab√≥bora... Que isso Ana? #MaisVoce	negative
#VideoShowAoVivo com a aguada da Sophia ninguem implica.üò£üò£	neutral
@user Por isso que eu queria a @user no #EDeCasa. Ela √© super natural e engra√ßada.	positive
n√£o sei como esse fernando ainda t√° a√≠ #MasterChefBR	negative
minha semana sem ir pra escola se resumiu em assistir #encontro t√¥ me sentindo muito dona de casa	neutral
Victor V e Ana Luiza s√£o os destaques positivos. #MasterChefBR	positive
#V√≠deoShowAoVivo achei  que hoje o v√≠deo show estaria como sempre bom MAS TA CHATO mesmo	negative
Hoje √© dia de ver o #masterchefbr de ontem	neutral
Promo das reportagens do jornal da globo no #AltasHoras	positive
O Vitor B saiu, to triste, n√£o to feliz #MasterChefBR	negative
T√¥ aqui vendo o #masterchefbr por√©m ligadinho no hor√°rio pro pronunciamento hist√≥rico	neutral
T√¥ amando te assistir no #altashoras @user üòçüòçüòç	positive
#altashoras  Dif√≠cil se conter ap√≥s a linda homenagem a m√£e dele üò¢ Chateado com vc por ter me feito desmoronar üò≠üò≠	negative
#ConversaComBial com um assunto muito interessante e importante: ansiedade.	neutral
Medo bobo ‚ù§ #ConversaComBial	positive
gente quem passa calcinha? pfvr n√© n√£o passo nem camisa  #MaisVoce	negative
N√£o quero saber de prova, quero saber do Vitor!!! #MasterChefBR	neutral
#EDECASA Cissa tremendo at√© 2030 segurando a cena no car√£o kkkk	positive
Eu fico s√≥ a Ta√≠s Ara√∫jo quando pedem pizza de br√≥colis #maisvoce	negative
Fabrizzio est√° mal humorado nesta prova de elimina√ß√£o ou √© impress√£o minha?! #MasterChefBR	neutral
Que lindo esse poema para as mam√£e. Chorei... #Encontro	positive
At√© que o #EDeCasa de hj t√° dando pra engolir, n√©?	negative
Ai caralho #MasterChefBR	neutral
#VideoShowAoVivo melhor programa da globo amo voc√™s	positive
Colocam um cara branco pra falar o que √© ou n√£o racismo na frente de 4 negros kkkkkkkkkkk pqp em globo #Encontro	negative
#Encontro -TT Pago Reforma da Prev @PMDB_Nacional Contra 96%, 5.017 Votos) A favor 2%, 96 Votos) N√£otenhoconhecimento 1%,) Prefiron√£oopinar	neutral
T√¥ apaixonada por essas orqu√≠deas!!! #Encontro	positive
#MasterChefBR me fode, 1 da manh√£ e eu ainda acordado assistindo hhhahhhaha	negative
""" Bem vindos a competi√ß√£o culin√°ria mais importante do mundo, bem vindos ao #MasterChefBR "" üíô"	neutral
Leonardo nao disse que a miriam iria lacrar ? #MasterChefBR	positive
A pessoa tem 13 anos e j√° conhece 25 pa√≠ses, eu o mais longe que fui Buenos Aires üòîüòí mundo injusto esse #Encontro	negative
√â nicolas prattes . CERTEZA #VideoShowAoVivo	neutral
""" Os Dias Eram Assim "" √â Um Maior FLOP Da @user #VideoShowAoVivo"	positive
esse pessoal metendo a m√£o na boca e mexendo de volta na comida AHAHAHHAHAHAHAHHA rindo de nervousor #MasterChefBr	negative
Consolidados - GLOBO (08/05):  #JornalHoje 11.2 #V√≠deoShowAoVivo 9.8 #Sess√£oDaTarde 12.7 #SenhoraDoDestino 16.7 #Malha√ß√£o (estreia) 20.5	neutral
Depois do intervalo: Sandy vai cantar com Chit√£ozinho e Xoror√≥ no Karaok√™ Virtual ü§ó‚ô•Ô∏è #encontro #SandyNoEncontro	positive
Agora lascou #MasterChefBR	negative
Voc√™s tem cara de quem j√° dan√ßaram muito √â o Tchan na adolesc√™ncia #AltasHoras	neutral
T√¥ aqui assistindo #MasterChefBR e sofrendo de tanta fome	positive
Eu aqui esperando #ConversaComBial e o programa ja acabou faz tempo üòÇüòÇüòÇüòÇüòÇüòÇ foi triste. Aff at√© pra assistir programa chego atrasado üòÇüòÇ	negative
Gente coloca no #TheNoite kkkkkkjjjjjjjkkkkkkkkk	neutral
to sem palavras pro vitor de vdd chorei assistindo #MasterChefBR	positive
estou com uma peninha do fabrizio üò©  #MasterChefBR	negative
#MasterChefBr tem √°gua na sua cozinha?	neutral
Esse epis√≥dio foi sensacional , Ana Luisa mandando ver *_* #MasterChefBR	positive
#MasterChefBR A MIRIAM √â UM FDP.	negative
@user Falando com a mona do #masterchefbr	neutral
Gui √© um guerreiro, j√° enfrentou tantas nessa novela, e agora mais essa, sua ex que reaparece querendo causar! #RockStory #V√≠deoShowAoVivo	positive
Toda ter√ßa-feira √© isso de eu ir assistir #MasterChefBR e ficar vendo Igreja da gra√ßa (nem sei se esse √© o nome).	negative
Come√ßou! #oRastro no #TheNoite com @user !!!!! #cinemanacional #terror #leandraleal #rafaelcardoso #alicewegmann	neutral
@user Melhor pessoa km #MasterChefBR	positive
#MasterChefBR eu aqui com febre e sem vontade de comer e essa comida boa pra degustar	negative
#videoshowaovivo Queremos ver a rotina(bastidores) acompanhando a @user ! @user @user @user N√£o √© gente?	neutral
Vamos assistir #MasterChefBR	positive
@user AVENTAL AZUL EU TE ABOMINO AAAAA #MasterChefBR	negative
Sobre o tema do #MasterChefBR: Comida tem que ser boa, mesmo que n√£o fa√ßa bem. A vida √© curta demais para dieta.	neutral
Que linda essa homenagem do Serginho para o #DiaDasM√£es #AltasHoras	positive
LUTADORES NAO ME TOMBEM NAO VOTEM NO AZUL  #MasterChefBR	negative
Olha o @user desfilando no #√âdeCasa #HACKATHONglobo	neutral
Melhor momento da tarde ‚ù§‚ù§ #VideoShowAoVivo	positive
#V√≠deoShowAoVivo Otaviano. Voc√™ esqueceu de minha mesagens.	negative
TEM QUE PROVAR QUE MERECE...üéµ #Encontro	neutral
Um ignorante me sustentou,educou sem estudo e nenhum conhecimento, n√£o me deixou sem um teto, foi o sr. Ailton Soares MEU HER√ìI #encontro	positive
#MasterChefBR perdi hoje, como vou ser bom na cozinha assim vei , n√£o quero deixar tudo nas m√£os da muie	negative
Bela Gil :Se eu pudesse teria mais uns dez! Vanessa da Mata: Nunca quis!!Imagina saindo aquilo tudo naquele buraquinho.KKKKK #AltasHoras	neutral
Rodrigo Santoro fala Espanhol! Lindo! #conversacomBial	positive
primeiro prato que a menina n faz merda e vcs ai enaltecendo  #MasterChefBR	negative
UM MEME NOVINHO EM FOLHA SAINDO AGR DO FORNO DIRETO DO #ENCONTRO COM F√ÅTIMA BERNARDES	neutral
"Ahhh que saudades do momento..""piadoca do jocaa""üéµ rsrs lindoos beijos ‚ù§‚ù§ #VideoShowAoVivo"	positive
Devolvam Vitor B e Abel, eu imploro @user #MasterChefBR	negative
eu n√£o conseguiria fazer cenas assim #ConversaComBial	neutral
J√° j√° √†s 22h30 tem #MMACorinthians no #MasterChefBR  N√ÉO PERCAM!	positive
a equipe do Victor V sempre √© a mais desorganizada e no final √© a que sempre ganha #MasterChefBR	negative
Se vc quiser eu vou ter dar um amor desses de cinemaa üòçüé∂üé∂üéµ #altashoras #VanessadaMata	neutral
Gente, como algu√©m consegue n√£o amar Vanessa Da Mata? #AltasHoras	positive
Tirem esse homem do programa pelo amor de Deus #Encontro	negative
Que mais voc√™s dividiam ?! Essa Sophia kkkkkkk Joaquim nem respondeu üôÑüôÑüôÑ #VideoShowAoVivo LINDA BRUNA MARQUEZINE	neutral
Meu Deus to morrendo com o  #thenoite	positive
#Encontro todo mundo ta vendo que esse cara foi pago pra falar merda... S√≥ pra alimentar as feministas que precisar se empoderar	negative
bem q podia ter repescagem no #MasterChefBR, volta vitorb, tem tanta gente q merecia volta...	neutral
Ala a Namaria de pijama e pantufas de unic√≥rnio üòπüòπüòπ #MaisVoc√™	positive
T√¥ chorando  #DomingoLegal	negative
√â Kik√£o, migos #VideoShowAoVivo	neutral
Todo mundo conseguiu entregar üíÜ #MasterChefBR	positive
Como assim n√£o √© Nina ? ! KKKKKKKKKK eu jurava que era rapaz #ConversaComBial	negative
o povo ta meio louco hoje, ta todo mundo perdido hahah #MasterChefBR	neutral
#Encontro.  Lindo, como Fabr√≠cio pegou o doce. Ambas as m√£os embaixo do mesmo. Um gesto de respeito, com certeza.	positive
Miseric√≥rdia os pratos est√£o com uma cara horr√≠vel.  #MasterChefBR	negative
Ana Maria Braga de roupa de unic√≥rnio... socorro! hahaha  #MaisVoce	neutral
Ja come√ßou o #TheNoite e hoje t√° sensacional	positive
Hj a Ana Maria enterrou minha inf√¢ncia de vez. #MaisVoce	negative
O melhor foi o Tiago meio q colocando pilha. Perguntando a rede social do cara AAAAAAAAA QUERO SABER QUAL √â #Encontro	neutral
Drauzio Varella √© t√£o inteligente, imaginem se todos tivessem uma mente igual a dele, o mundo seria melhor! #ConversaComBial	positive
@user Poderiam repetir aquela c√©lebre entrevista do Bial com o professor @user realizada nos anos 90 #ConversaComBial	negative
@user na hora que a #EquipeVermelha estava amassando batata estava verde sim #MasterChefBR	neutral
N superei o susto q o @user me deu ontem  no #MasterchefBR e quando voltou a cara dele tava tipo I'M BACK BITCHESüòÇ	positive
O pagodeiro se cortou? Eu achava que era s√≥ emo que fazia isso... #MasterChefBR	negative
Leo verdadeiro  #MasterChefBR	neutral
@user √© a melhor pessoa!!! üòÇüòÇüòÇüòÇüòÇüòÇüòÇüòÇüòÇüòÇüòÇüòÇüòÇüòÇüòÇüòÇüòÇüòÇüòÇüòÇüòÇüòÇüòÇüòÇüòÇüòÇüòÇüòÇüòÇüòÇüòÇüòÇüòÇüòÇüòÇüòÇüòÇüòÇüòÇüòÇüòÇüòÇüòÇüòÇüòÇüòÇüòÇüòÇ #MaisVoce	positive
o leonardo √© muito naja  #MasterChefBR	negative
Vitor V j√° est√° fora da elimina√ß√£o. Quem ser√° o pr√≥ximo? #MasterChefBR	neutral
Acho que mamai se sairia bem nessa prova de v√≠sceras #MasterChefBR	positive
#encontro negro e branco no BR t√° ferrado com a pol√≠tica do mesmo jeito.	negative
@user te vi em BH eu acho.. ou algu√©m muito parecido... Engra√ßado neh.. e ele nem tava com um saco de tomates. #MasterChefBR	neutral
Irm√£es Galv√£o me fizeram gargalhar.... #berrooooo Kkkkƒ∑kkkkkk #encontro	positive
Caceeetaaaa #EquipeAzul t√£o muito perdidos... aiii carambaaa... vou ser tombada to vendoo #MasterChefBR	negative
Pr√©via - Rio de Janeiro - #TheNoite com @user - SBT 7.8, Globo 7.6 e Record 2.2. Picos de 9.	neutral
#MaisVoce Esse cara √© muito top....s√≥ n√£o esque√ßo o cara da raquete kkkkk	positive
Saudades da @user no Brasil.üò≠üòç #DomingoLegal	negative
MEU AMORRRR #DomingoLegal	neutral
celular carregando pra poder assistir com voc√™s #MasterChefBR e torcer pro Leo sair e eu ganhar a camisa do @user	positive
Eu s√≥ espero que o Celso n√£o iluda as lucerinas  #DomingoLegal	negative
QUEM √â SEU PAI KKKKKKKKKKKKKKKKKKKKK  #Encontro	neutral
@user #TheNoite na #PracaeNossa show de bola üòò	positive
Se a Mirian sair, quem n√≥s vamos odiar??? #MasterChefBR	negative
Fazer n√∫mero 3 na velocidade que eu quiser... foi √≥timo üòÇüòÇüòÇüòÇüòÇüòÇüòÇ #altashoras #vidadeMae ‚ù§	neutral
Coisa linda o @user no #ConversacomBial! Arrasando! üíú	positive
Toda ter√ßa come√ßo a forrar o est√¥mago por volta de 8pm pra n√£o ter fome na hora do #MasterChefBR. Sempre em v√£o. Mas sigo tentando	negative
O crime organizado, o PCC √© consequ√™ncia do massacre do Carandiru #ConversaComBial	neutral
Mds eu adoro #MaisVoc√™ e nunca mais tinha visto	positive
o programa hoje n√£o favoreceu a minha tpm eu chorei umas dez vezes j√° #MasterChefBR	negative
Esse vestido de @user √© estilo anos 60. #VideoShowAoVivo	neutral
Chega ter√ßa-feira‚Äã ! Ansiosa para assistir #MasterChefBR	positive
J√° fui v√≠tima de roubo no Internet Bank, bloqueei tudo √© j√° n√£o uso mais, n√£o confio! #Encontro @user	negative
Qual o nome desse especialista? #√âDeCasa	neutral
#AltasHoras Vc √© uma menina muito doce. E com as novas tecnologias vc vai com certeza fazer muitos progressos..Ah se eu fosse mais jovem. Bj	positive
Ol√° @user eu preciso dormir, vamo agilizar com o comercial #MasterChefBR	negative
"#videoshowaovivo Aqui em Ji-Paran√°/Rond√¥nia tbm falamos ""dim-dim"". Em Minas Gerais fala-se ""chup-chup"". Bjus."	neutral
to felizona que o Vitor t√° cozinhando #MasterChefBR	positive
#VideoShowAoVivo  luto grande ator	negative
Hoje √© dia de #masterchefbr	neutral
"""Se a @user √© o date, ela fica para o caf√© da manh√£"" - eu te amo, @user! #MasterChefBR"	positive
Sabe de quem deu saudade? Do @user #MasterChefBr	negative
O creme de leite que tem em casa est√° vencido faz uma semana. Posso fazer a receita mesmo assim? #MaisVoce	neutral
#MaisVoce Thais Araujo e Fernanda Freitas...show...	positive
VITOR PISA MENOS EU TE IMPLORO #MasterChefBR	negative
QUE PROGRAMA VEI #MasterChefBr	neutral
Debate sobre os hackers malditos muito bom no #Encontro ! N√£o existe mais PRIVACIDADE nesse mundo!! @user @user	positive
Quero ouvir mais √â o Tchan viu Serginho, t√° muito micro essa participa√ß√£o #AltasHoras	negative
Bacuri   com tucupi kkkkkk mano    #MasterChefBR	neutral
Amo @user  no #VideoShowAoVivo  amanh√£	positive
Vamos recome√ßar o episodio de #MasterChefBR porque esse deu muito errado? Agradecida	negative
Programa de entrevista deveria sempre ter a lembran√ßa que o Bial tem: temos duas orelhas e uma boca #ConversaComBial	neutral
#VideoShowAoVivo do cora√ß√£o, amo este programa desde crian√ßa	positive
#MaisVoce o senso de rid√≠culo manda lembran√ßas l√° da Isl√¢ndia. Ele est√° bem longe pelo visto	negative
#MasterChefBR taca tucupi no frango ou no pato, que √© do PAR√Å hahah	neutral
#ConversaComBial  com o @user  ‚ù§ Amo forte @user	positive
J√° perdemos o #BBB17 esse ano perder o #MasterChefBR tbm no mesmo ano seria crueldade.... ser√° 2017 o ano do fim dos realitys?	negative
#VideoShowAoVivo tchau del√≠cias, üòç	neutral
.@user ,a melhor rep√≥rter da TV Sorocaba que vc respeita,üòúüòúüòú#DomingoLegal	positive
O AZUL N PODE DEIXAR FALTAR COMIDA  #masterchefbr	negative
Amigos, peguem esse frango e arrocha dentro do forno!!!!!! #MasterChefBR	neutral
#TheNoite como sempre √≥timo mas hoje ta muito mara. Altos risos üòÇ	positive
Reapresenta√ß√£o do #MasterChefBR termina aqui, pra mim! N√£o tenho psicol√≥gico pra passar por essa tens√£o daqui em diante novamente! üíîüò¢üíîüò¢üíîüò¢üíîüò¢üíî	negative
@user Pra quem acha que sardinha √© coisa de pobre quero s√≥ ver os pratos que ser√£o elaborados. #MasterChefBR	neutral
Sophia Abrah√£o linda #AltasHoras	positive
Eu estou com vontade de tomar o sorvete com a cacha√ßa, como faz? #MasterChefBR	negative
Oi chef de cozinha  #Edecasa	neutral
#MaisVoce falando de Nossa Senhora de F√°tima üòçüòçüíí	positive
#VideoShowAoVivo ta ai... Tata √© a cara desse programa. Sophia q va fazer novela,	negative
Ana L√≠dia no #√âdeCasa üíõüíõüíõ	neutral
Acompanhamos juntos com a Eva Wilma essa bela homenagem ao ator Carlos Zara no #VideoShowAoVivo	positive
Pra aumentar peso, pra diminuir peso, n√£o sei quantos mil pratos. T√¥ perdida. #MasterChefBR	negative
Gente, vou fazer uma Live hj no #Instagram e quero perguntas bem legais! Me enviem inbox! #MasterChefBR	neutral
O @user muito maravilhoso. J√° vou atr√°s do livro novo! #ConversaComBial	positive
eu ja to aqui pronto pro #MasterChefBR mas ainda falta 1h10 =(	negative
#VideoShowAoVivo e o @user  na novela Terra Nostra.	neutral
Morrendo de amor pelo filho do Serginho. Coisa mais fofa! #AltasHoras	positive
Esse #Encontro t√° ruim demais. N√£o tem nada atrativo, n√£o fazem mat√©rias interessantes, os convidados quase n√£o falam de si... P√©ssimo!	negative
"Aqui no MS falamos ""eita pega"" para demonstrar surpresa,susto,admira√ß√£o... #VideoShowAoVivo"	neutral
Carlos Alberto no #thenoite vai ser bacana	positive
Nunca mais vai acabar essa mat√©ria chata desse menino n√£o?  #VideoShowAoVivo	negative
T√¥ assistindo #maisvoce e n√£o tem √°udio,5- acontecendo isso com voc√™s ? Socorro ~	neutral
Ana Maria assando espetinho no ferro de passar roupa #MaisVoce	positive
Leonardo querendo que Ana Luiza fosse eliminada e o prato dela foi o melhor üëäüèº#MasterChefBR	negative
@user √© aquela pessoa que voc√™ tem vontade de dar um abra√ßo e ser amigo. #altashoras	neutral
COMO EU AMO O #Encontro üòÇüòÇüòÇ	positive
Eu tamb√©m t√¥ me hidratando hein kkkkk #MasterChefBR	negative
S√≥ quero ouvir VAI COME√áAR A PUTARIAAA HAHAHAüé∂ #TheNoite	neutral
Muito bom o @user de hoje üëèüëèüëèüëè #DomingoLegal.	positive
#MasterChefBR Meu deus Jacquin t√° chorando... vms cancelar essa elimina√ß√£o	negative
Samurai quer sushi pra comer. #AltasHoras	neutral
@user esse sabor novo √© uma homenagem ao espinho do come√ßo da temporada do #MasterChefBR? üòÅ finalmente taioba tbm no La Guapa! ‚ù§Ô∏è	positive
#MasterChefBr Vcs j√° t√™m um v√≠deo com a parte em q aparece o Thiago Castanho? Perdi : (	negative
#videoshowaovivo o menino de terra nostra e o Zac de rock story	neutral
Valter nunca critiquei #MasterChefBR	positive
Namaria colaborando mais uma vez com a f√°brica de memes üòÇüòÇüòÇüòÇ#maisvoc√™	negative
@user d√° 30 minutos para o @user e 15 minutos para #osdiasnaoeramassim e fica tudo numa boa e cheio de audi√™ncia #encontro	neutral
@user Seeeerio? Mdssssss agora tenho mais motivo pra torcer por ele e ele ser meh crush.. #MasterChefBR	positive
serasse hj a Mirian sai???? #MasterChefBR	negative
Beckham n√£o mudou nada kkkk üòÇüòÇüòÇ !! #TheNoite	neutral
que linda a Paola cozinhando üòç #MasterchefBR	positive
E agora com a entrada do programa vi que escrevi o nome de todo mundo errado üòÇüòÇüòÇüòÇ #MasterChefBR	negative
#MasterChefBR meu prato principal seria ovo mexido com copo d'√°gua.	neutral
@user O m√°ximo #MasterChefBR	positive
N√£o to aguentando os coment√°rios desse tim maia #MasterChefBR	negative
Cada pe√ßa aqui em Alagoas...kkkkkkkk #VideoShowAoVivo	neutral
O Leo: - Eu n√£o acredito que t√¥ aqui encima!  A @user: - Desce!    Kkkkkkkkkkkkkkkkkkk  #MasterChefBR	positive
A plateia do Caras e Bocas pisaria muito nessa plateia do #altashoras	negative
"S√≥ faltou o Nabby Clifford dizer: "" fora temer "". #encontro"	neutral
@user Pelo que eu saiba o Danilo Gentili n√£o tem acessoria. üòäüëç #TheNoite	positive
O #ConversaComBial de hoje come√ßou 35 minutos depois do hor√°rio divulgado no site da programa√ß√£o da Globo.	negative
Algu√©m nesse universo N√ÉO gosta do Zeca Pagodinho? Acho que n√£o √© poss√≠vel! E s√≥ um detalhe, √© BOTAFOGUENSE! #conversacombial	neutral
Ao mesmo tempo que eu amo a @user eu tenho medo dela n√£o da pra imaginar o que passa naquela cabecinha!!! #MasterChefBR	positive
Miriam aparece e eu blehhhh üò¨#MasterChefBR	negative
Consolidados - SBT (12/05):  #TheNoite @user 3.3 #SBTNot√≠cias - Madrugada I 2.0 #SBTNot√≠cias - Madrugada II 2.1	neutral
√ìtimo in√≠cio do #TheNoite heheheh	positive
#MaisVoce , eu j√° tomei esse milkshake da Kombosa e n√£o gostei. Principalmente do atendimento deles, muito ruim.	negative
Hoje tem #MasterChefBR  üò±üò±üò±üò±	neutral
Olha a Ninaa! #TheNoite	positive
Putz, tomei spoiler do #MasterchefBR	negative
Oi fatima manda a @user cantar #Encontro	neutral
Falar de comida rende, pq o Serginho est√° a 30 min falando sobre o assunto. Papo mais longo da hist√≥ria do #AltasHoras	positive
Essa depila√ß√£o na sardinha √© sem fim #MasterChefBr	negative
Drauzio Varella: n√£o adianta s√≥ construir pres√≠dio. Precisa um novo por m√™s. (Acho eu ent√£o pena de morte p/crime hediondo) #ConversaComBial	neutral
"""vc ta passando bem?"" BERRO kkkkkkkkk #MasterChefBR"	positive
Muito f√°cil se dedicar a esportes radicais com estrutura familiar e apoio financeiro, n√©? #MaisVoce	negative
Quase chorei quando Vitor B teve que sair para o ambulat√≥rio... Meu crush ‚ô•  #MasterChefBR	neutral
Confesso que sou f√£zinha da Bela Gil. #Altashoras	positive
Posso falar q eu quase MORRI por causa do @user hj no #MasterChefBR ??? Me matou de afli√ß√£o, cara!!!! üò± Ainda bem q deu certo depois.	negative
Consolidados - SBT (18/05):  #TheNoite 4.3 #SBTNot√≠cias I 3.2 #SBTNot√≠cias II 2.4	neutral
O #JN t√° competindo com o #MasterChefBR pra ver quem dura mais?	positive
@user @user @user Isso a√≠, vai pra cima dessas cobras! #MasterChefBR	negative
A alian√ßa ter√° que ser trocada rs #Encontro	neutral
Comida paraense √© mt boa #MasterChefBR	positive
A Mirian acha que com esse choro dela vai garantir ela ficar #MasterChefBR	negative
A @user de vestido de po√° no #VideoShowAoVivo. Plmdds! üòç	neutral
Gui santiago cantando  sonha comigo  foi lindo  paralisei na frente da tv , terminem o programa com ele . #VideoShowAoVivo	positive
Triste com a sa√≠da do Vitor B #MasterChefBR	negative
@user por favor queria muito ver os bastidores da cena do parto de Anna #VideoShowAoVivo	neutral
S√≥ eu sonho em tenho uma mise en place sempre prontinha toda a vez q vou cozinhar??? Quero uma igual do Raul toda a vida #MasterChefBR	positive
Quero @user no #Encontro √© pedir demais produ√ß√£o? ! N√£o, obg de nada. üòåüëëüíïüëèüëè @user	negative
#AltasHoras Voto no Marco Luque pra sair da casa.	neutral
DAQUI A POUCO VAI COME√áAR #MasterchefBR	positive
Esses modos de vota√ß√£o s√£o os mais torturantes  #MasterChefBR	negative
esse vitor b √© muito a cara do leandro do klb come√ßo de carreira, s√≥ faltava ser vesguinho #masterchefbr	neutral
Hebe cantando, que voz linda ela tinha #MaisVoce	positive
#VideoShowAoVivo mostrando o resumo de #OsDiasEramAssim so comprova que a coisa ta ruim pro lado da novela	negative
Low carb s√≥ ia dar o escondidinho de frango com creme de couve-flor #MasterChefBR #MasterChef	neutral
#VideoShowAoVivo Sophia Voc√™ t√° Maravilhosa!	positive
Eduardo, se voc√™ quis ser um grande babaca em rede nacional vc conseguiu. #encontro #saimachista	negative
Bial abre o programa com LAURO JARDIM. Entrevista gravada hoje #ConversaComBial	neutral
O v√≠deo show fica muito melhor quando  vcs 2 apresentam @user @user #VideoShowAoVivo	positive
Frango a passarinha @user #MaisVoce NaMaria	negative
Psicando a Mirian pq sim. #masterchefbr	neutral
Ela sorrindo, a√≠ Deus ksjsgsv üòçüòçüòç #DomingoLegal	positive
@user est√° na equipe errada #MasterChefBR	negative
A Lua jamais se enquadraria como capr√≠corniana. Eu sou um exemplo de pessimismo e realismo. #Encontro	neutral
O que foi a vov√≥ Galv√£o pedindo um selinho pro @user ????  kkkkkkkkk amei  #encontro	positive
Agora recebam ele que tem paladar infantil @user #TheNoite	negative
Foi nessa grava√ß√£o que o #VideoShowAoVivo ta mostrando que os moradores acharam a Paolla um docinho	neutral
Padre Fabio de Mello vai cantar Trem Bala no #ConversaComBial, j√° sei que vou chorar!	positive
#Encontro Fatima eu fico triste quando o #Fantastico come√ßa no Domingo a noite...kkkk sinal que o Fds acabou!!!!	negative
#somostodosherois #encontro vamos mudar o mundo!	neutral
#VideoShowAoVivo  Kk n√£o tenho TV, t√¥ assistindo na casa de um amigo. AMANDOOOO... Al√¥ de Panambi - RS	positive
Essa carne ta parecendo um peda√ßo de c√¥co no prato kkkkkkkkk #MasterChefBR	negative
Eu e a J√∫lia chorando assistindo #MasterChefBR	neutral
"""Cada um que expulse o diabo que criou."" -de Melo, F√°bio HAHAHAHAHAHAHAHAAHA #conversacombial"	positive
F√â NO PAI QUE A MIRIAN SAI #MasterChefBR	negative
O Choque de L√≠li  de TD+ para Germana de Novo Mundo, aconteceu o mesmo com Beth de Andando Nas Nuvens para Maria Jo√£o de UGA UGA   #MaisVoce	neutral
#thenoite @user @user Diguinho sensualizando sem ser vulgar	positive
Quando eu digo q tem muita m√£e  machista e por isso o machismo ainda persiste, alguns me xingam t√° a√≠ a prova hj no #Encontro	negative
To aqui bem linda, esperando o meu #MasterChefBR	neutral
O Padre fabio de melo lacrando no Snap Chat,,, #ConversaComBial	positive
Gente desfia o frango direto na panela de press√£o, nunca viram aquelas dicas no Face?  #MasterChefBR	negative
Porque Laura M√ºller n√£o est√° participando do #AltasHoras?	neutral
F√°tima e minha diva #VideoShowAoVivo	positive
#masterchefbr Falo nada dessa propaganda mentirosa do @user . Chega la √© um sanduiche com gosto de isopor temperado com agua.	negative
S√≥ VR√Å hj no #Encontro	neutral
#MaisVoce Viviane Pasmanter, melhor atriz. D√° logo um Oscar pra essa mulher	positive
Cada pergunta idiotaq esse povo da plateia faz #altashoras	negative
Ol√°, @user! Gostar√≠amos de ver a cantora e youtuber @user no #MaisVoc√™. Obrigada! @user @user	neutral
EU TO AMANDO #masterchefBr üòçüòçüòçüòç	positive
#maisvoce @user Nesse caso √© que essa Garota √© HiperMojentinha mesmo..acredito que antes da fama comia p√£o com ovo kkk	negative
Revoltado que ningu√©m usou bacuri. #MasterChefBR	neutral
#VideoShowAoVivo mostrou @user pequenininho numa participa√ß√£o na novela terra nostra e 1999 que fofoooo...lindo desde sempre :)	positive
Rico manda suas roupas  na lavanderia e j√° vem passada.....Eles n√£o sabem nem o que √© ferro de passar!!! #MaisVoce	negative
#MaisVoc√™ o que t√° acontecendo com NaMaria?	neutral
A Regra do Jogo era legal #VideoShowAoVivo	positive
CANCELA O EPIS√ìDIO DE HOJE  #MasterChefBR	negative
otaviano n√£o percebe nem quando o joca nao ta bancada quero ver reparar no cabelo kkkj #VideoShowAoVivo	neutral
@user est√° linda! Super b√°sica e gata. S√≥ pergunta pro @user onde comprou a blusa pq tb t√¥ querendo #VideoShowAoVivo	positive
O Bial n√£o para de interromper o entrevistado üôÑüôÑ #ConversaComBial	negative
"Ana Maria, agora, fazendo frango a passarinho: ""vai que algu√©m n√£o come alho, t√¥ traumatizada"" #MaisVoc√™"	neutral
A @user  ta me representando hj  @MChefVitorB t√° me amando do cora√ß√£o #MasterChefBR	positive
Eu fico vendo esse povo achando que vai dar certo , chega na hora ... tudo Errado  #MasterChefBR	negative
Achei q o @user so ficava acuado assim qnd via aranhas kkkkkkkkkkkkkk #TheNoite	neutral
Poesia com rapadura logo no in√≠cio do #encontro. üòçüòçüòç Que lindo! @user arrasa sempre!	positive
Eles perdem tempo fazendo coisas que n√£o acrescentam nada no prato. S√£o desorganizados e √© isso que faz a comida sair ruim #MasterChefBR	negative
#TheNoite com @user foi 10/10	neutral
#VideoShowAoVivo  Aqui em Pernambuco se chama dudu!!! Zeca e Otaviano‚ù§‚ù§‚ù§‚ù§	positive
Assistindo o epis√≥dio 7 do #MasterChefBR e a Mirian como sempre me irritando... acha que porque tem idade s√≥ ela sabe tudo.	negative
#MasterChefBR Acho justo o V√≠tor ter um tempo pra fazer o prato depois do atendimento m√©dico!	neutral
S√≥ assistindo #√©DeCasa pra ver se vai aparecer o #chef gato de novo!!!	positive
Porra acabei de ver quem saiu do #MasterChefBR e eu ainda n√£o assisti o ep de ontem.... VSF üò°	negative
J√°, j√° logo ap√≥s o #JornalRational do #ProgramaDoRatinho üòÇüòÇüëç tem participa√ß√£o especial na #APra√ßa√âNossa, em seguida #TheNoite no @user.	neutral
Maluma tudo de bom ... üòçüòç #TheNoite	positive
Se o Vitor sair eu choro/se o Vitor sair eu choro/se o Vitor sair eu choro /se o Vitor sair eu choro/ #MasterChefBR	negative
Quendaaaaaa Xuxa na Globo.... Mega destaques Poder da Hebe #MaisVoce	neutral
Esse quadro adultos com voz de crian√ßa √© sensacional üòÇüòÇüòÇ #TheNoite	positive
#MaisVoc√™ essa cena √© t√£o üò¢üò¢üò¢üò¢	negative
De fato. Quando a mulher √© mais velha que o homem o preconceito √© muito maior que um homem mais velho que uma mulher #Encontro	neutral
#VideoShowAoVivo  imposs√≠vel n√£o chorar com essa menininha , parab√©ns F√°tima e v√≠deoshow! A vida √© risos, mas √© bom perceber a realidade. Bj	positive
olha a hora que a pessoa vai dormir por causa de #MasterChefBR	negative
#MaisVoc√™ namaria,o q fizeram com vc mulher?	neutral
Sou super f√£  dessa mulher incr√≠vel,  inteligente e excelente apresentadora.  #VideoShowAoVivo	positive
"#encontro que rid√≠culo esta atitude machista deste cara ai , e a ""namorada"" dele ser√° que √© assim que ela quer ser tratada?"	negative
Travou ali no 27 x 24 #MasterChefBR	neutral
Esse mezanino vai cair...pke t√° O PESO! #MasterchefBR	positive
Aff, mais uma semana aturando o Leonardo! #SaiLeonardo semana q vem ent√£o! Otimismo neh @user @user #MasterChefBR	negative
"#conversacomBial  ""O machismo se estende at√© dentro das pris√µes"" ."	neutral
Gente a Namaria t√° com a pantufa do unic√≥rnio que eu t√¥ desejando h√° meses! Manda ela tirar minha pantufa do p√©! Obrigada,de nada #MaisVoce	positive
Como esse L√©o √© insuport√°vel, rid√≠culo #MasterChefBR	negative
Direito do Cidad√£o ter armas. #TheNoite	neutral
Sei l√° mas o #MaisVoc√™ ta a sua cara hoje @user  Feliz Anivers√°rio!!!	positive
A mulher quer um bando de filho pra v√≥, a creche e os outros filhos cuidarem! Falta de responsabilidade a gente v√™ no #encontro	negative
Al√¥ lorinha √¥ lorinha voc√™ sabe mexer #altashoras #eotchannoaltashoras	neutral
Ontem o #MasterChefBR  foi muito dahora com os lutadores.	positive
"""N√£o t√° morto quem paleia"" Tha√≠se n√£o me faz lembrar de BBB agora! #MasterChefBR"	negative
O neg√≥cio √© torcer para os chatos, pois sempre os que n√≥s torcemos acabam saindo... #MasterChefBR	neutral
Fiuk lindo maravilhoso! #Maisvoce #Viva no viva !	positive
Eu to desesperada #MasterChefBR	negative
preciso aguentar firme pra ficar acordada at√© o final do epis√≥dio aaaaa #MasterChefBR	neutral
#Encontro mostrando a hist√≥ria do cabo da pol√≠cia militar q salvou 20 pessoas de um inc√™ndio üëèüëè Por mais policiais como este cabo p/ o mundo	positive
Chorando estou!!! #AltasHoras	negative
Uma fam√≠lia toda cacheado no #Encontro com F√°tima Bernardes @user	neutral
#AltasHoras mesmo deitada estou me acabando com √â o Tchan! AdoroooooüíÉüíÉüíÉüòç	positive
Alian√ßa ta pequena pra esse dedo ai n√© #Encontro	negative
TCHAU PESSOAL!!! AT√â DOMINGO QUE VEM!!! #DomingoLegal	neutral
amei a roupa da Ana hoje, quero uma assim pra ir trabalhar #MaisVoce	positive
#MasterChefBR VITOR V PASSANDO O DEDO NA BOCA E NO FRANGO SOCORRO	negative
@user o pai de todos no #TheNoite üòÇüëèüëè	neutral
Eu vivi pra ver a Ana Maria de unic√≥rnio kkjj #MaisVoce	positive
acho estas flores  altas d+ para essa mesa de jantar da Ana, a conversa vai ser dif√≠cil #MaisVoce	negative
Vai caralhooo!!! #MasterChefBR	neutral
@user Imperd√≠vel assistir essa linda no #Encontro	positive
"""Ana Luiza deu uma despirocada"" #MasterChefBR KKKKKKKKKKKKKK"	negative
Vanessa sincera #AltasHoras	neutral
o dia que eu cantar na f√°tima vai ser muito top porque eu sou muito fanzoca #Encontro	positive
"Ana Paula falando ""N√£o √© algo q vc coma todo dia"". Como assim? F√≠gado de boi e moela √© o que mais vende em a√ßougue de bairro! #MasterChefBR"	negative
Chorando muito com esse #encontro de hj	neutral
Que homem lindo! Minha amiga disse que ele √© gay, s√≥ porque ele √© bonito üòÇ #DomingoLegal	positive
Bem que poderia ter repescagem no #MasterChefBR pro @user  voltar e mostrar do que ele √© capaz.‚ù§ homem Guerreiro e batalhador.	negative
#TheNoite n√£o vai ter mas Osasco com a in√™s Brasil?	neutral
Orgulho ‚ù§Ô∏è #MaiaraeMaraisaNoBial #ConversaComBial	positive
Al√¥ #JPmorningshow, chamem a @user p comentar sobre o #MasterChefBR urgente!!! A maior f√£ da Mirian üôä	negative
Al√¥ Serginho, eu t√¥ aqui na minha casa mesmo #ALTASHORAS	neutral
#VideoShowAoVivo  Aaaaaa Sophia falou da Mel aaaaa	positive
s√≥ hoje assistindo o #MasterChefBR e muito triste que meu queridinho @user saiu :((( &lt;\3	negative
Socorro, a Michelle! A professora que me deu aula de Teoria da Comunica√ß√£o acabou de aparecer no #MaisVoce	neutral
Yuko sempre acha que vai se d√° mal mas como toda oriental se vira nos 30 e acaba indo muito bem nas provas #MasterChefBR	positive
"#MasterchefBR nao dou conta desse povo colocando coisas no prato apenas "" para dar cor""."	negative
O que foi isso HAHAHAHA   #Encontro	neutral
#altashoras  a m√£e do serginho linda üíï	positive
Por favor galera denunciem o perfil da @user ela √© racista e homof√≥bica! #VideoShowAoVivo #desafiodepoisdas11 #ReliquiaDoisConeCrew	negative
"""Africano virou negro quando foi acorrentado..."" #encontro"	neutral
#AltasHoras SUCESSO com atra√ß√µes da Bahia e homenageando o dia das m√£es	positive
Prato do Vitor t√£o feio quanto meu cabelo de manh√£ #MasterChefBR	negative
#VideoShowAoVivo  Vem ai DVD Sonho Banda conde do forr√≥  @maltrataconde @user @user	neutral
So pela espera do filma√ßo,que elenco heim,que filme,vem que vem o raztro ,danilo sempre foda hudy #TheNoite	positive
J√°..üò±. acabouuu... N√£oooooo #ConversaComBial	negative
O que √© o @user dan√ßando no #TheNoite	neutral
Eu quero nos dois bem juntinhos At√© ficar bem velhinhos Bengala e Croch√™‚ô• #MaiaraeMaraisaNoBial #ConversaComBial @user	positive
Merda!!! Perdi Maiara e Mara√≠sa no #ConversaComBial üòí	negative
S√≥ eu que n√£o assisto #MasterChefBR? üëÄ	neutral
que fam√≠lia linda essa no #Encontro	positive
Caraca, o √∫ltimo #MasterChefBR foi traum√°tico	negative
Consolidados - GLOBO (08/05):  #BDSP 10.5 #BomDiaBrasil 10.3 #MaisVoc√™ 8.0 #BemEstar 7.5 #Encontro 6.9 #SP1 12.2 #GloboEsporte 12.0	neutral
A F√°tima fica mais bonita com cabelo curto üíá üòä #videoshowaovivo	positive
#Encontro pais relatam que filhos sofrem bullying por passar nudes pr√≥prios e o culpado √© quem compartilha? √â s√©rio? #Invers√£oDeValores	negative
Celular de @user tocando no meio da entrevista üòÇ queria que ele atendesse, queria sim rs. #ConversaComBial	neutral
Meu Deus a Sandy no #encontro üòçüòçüòçüòçüòçüòçüòç	positive
Vitor B √© meu amor, n√£o aceito perder ele nunca #MasterChefBR	negative
Essa juventude nunca saber√° o que √© dan√ßar os cds inteiros do @user nas festas escolares #altashoras #eotchannoaltashoras	neutral
Rafa Brites linda no #V√≠deoShowAoVivo !!!	positive
Gosto tanto a Michele,  mas ultimamente ela s√≥ tem ficado com os marromeno #MasterChefBR	negative
A sardinha que ganhar, vai ser meu prato p√≥s festa de amanh√£ #MasterChefBR	neutral
Queria ir dormir cedo mas lembrei que hoje tem #masterchefbr	positive
O Brasil pede o impeachment da Miriam!!! #MasterChefBR	negative
Come√ßooou o #TheNoite	neutral
T√¥ assistindo o ep de ontem do #MasterChefBR e ver a Michele e Aderlize fora da prova de elimina√ß√£o: n√£o tem pre√ßo! ‚ù§	positive
Cora√ß√£o partido com a sa√≠da do @user #MasterChefBR	negative
L√°aa vou eu assistir #MasterChefBR  üòå	neutral
Legal que os caras ficam l√° lutando rsrs #MasterChefBR #EquipeAzul	positive
S√≥ embuste nesse mezanino, podiam eliminar todos #MasterChefBR	negative
#MasterChefBR aiii meu Deus a Yoku e tao fofinha	neutral
nossa, quanto avi√∫! hahaha #MasterChefBR	positive
Hamb√∫rguer doce?! Gente para! #MaisVoce	negative
Lazaro falou Bale fitness e Ana Maria Braga escutou palafitas #MaisVoce	neutral
Mano √© daqui a pouco, √© daqui a pouco que eu morro. üòÇüò≠‚ù§Ô∏è #DomingoLegal	positive
Ai vc t√° dormindo e acorda passando Anjo - Saulo na Tv da Sala, pqp! √â pra acabar comigo n√© produ√ß√£o?  #√âdeCasa	negative
E a√≠, @user. O Vitor B volta ou n√£o volta? #MasterChefBR	neutral
L√©o Lins de VERA VER√ÉO mano Ri Demais kkkkkkkkƒ∑kk EEEEEEEEEEEEEEP√Å kkkkkkkk @LeoLins @user #THENOITE	positive
abdiquei do #MasterChefBR √†s ter√ßas por causa do kickboxing quarta de manh√£. s√≥ vou acompanhar o programa no youtube agora :(	negative
toda a certeza do mundo de que serei a pr√≥xima velhinha de 100 anos e que n√£o casou #Encontro	neutral
Eu n√£o seu por que voc√™s n√£o gostam do Leonardo, acho ele sensacional. Humor √°cido üòÇ #MasterChefBR	positive
Esse Mirian ja deu #MasterChefBR	negative
S√≥ vou assistir esse #ConversaComBial de lei e ir dormir porque t√¥ precisando	neutral
#VideoShowAoVivo ele foi um grande ator. Uma pessoa que sabia agradar seu p√∫blico, desde os mais velhos aos adolescentes.‚ù§ #NelsonXavier .	positive
Um machista na plateia socorro #encontro	negative
Depois desse #MaisVoce de hoje, se nadar der certo, eu viro #meseira	neutral
#MasterChefBR Foga√ßa sou sua f√£...	positive
AI CARALHO TO MTO NERVOSA #MasterChefBR	negative
J√° que ngm fala comigo, depois do #VideoShowAoVivo vou visitar Ilana.	neutral
Mal come√ßou a pr√©via do MasterChef e eu j√° t√¥ catando coisa pra comer #MasterChefBR	positive
