text	label
Normal bin ich ja ned der mensch dwer sich beschwert wegen dem essen aber diese Pizza von Joeys...boah wie ekelhaft	negative
VfB Stuttgart gegen SV Hamburg: Das Warten auf den n√§chsten Schritt - Stuttgarter Zeitung: DIE WELTVfB Stuttga... http	neutral
@user @user @user @user @user @user @user @user f√ºhlt sich schon so sp√§t an üòöüòöüòö	positive
@user glaub ich! XD 30‚Ç¨ sind echt not bad T___T *gr√ºbel*	negative
@user. Diviertete	neutral
@user @user plopp plopp plopp: frisches Popcorn r√ºber reich. Coke? klar, kein Thema!	positive
Ach Scheiss drauf, dann eben nich	negative
RT @user: Was ist das f√ºr eine Glaubw√ºrdigkeit, wenn wir sagen wir sind keine Verbotspartei und gleichzeitig Verbote fordern @user‚Ä¶	neutral
He's so charming. Man muss ihn einfach lieben #samuhaber #tvog	positive
Dieses Gef√ºhl, wenn man von Personen entt√§uscht wird...	negative
Sieben k√ºnstlerische Projektr√§ume ausgezeichnet http #Berlin	neutral
@user Cool! Keine weiteren Fragen. ;-)	positive
@user kamu syahrenong:-(	negative
Wer muss bis 8 in Krefeld arbeiten, geht dann direkt ins Fitnessstudio und muss dann nachts zu Hause die Sp√ºlmaschine ausr√§umen?	neutral
@user hab keine, bin lieb zu dir. ^_^	positive
NDR. Seniorenchor. Absolute Fassungslosigkeit meinerseits.	negative
Der #Klassiker ! #Knirps #T2 zum #Sonderpreis ! Der Name spricht f√ºr sich - der #Schirm schlechthin ! http	neutral
When we were younger (8)	positive
@user Hi, k√∂nnt Ihr bitte Oceans Twelve pr√ºfen? Nach einer halben Std. fehlerhaft :( Andere Serien u. Filme laufen problemlos. Gru√ü	negative
RT @user: 1/2 Hammerstory v @user: EU-Kommisar Oettinger streicht unliebsame Zahlen zur Subvention von Fossil u AKW. ht‚Ä¶	neutral
@user guten abend. bitte folge mir mal. dann kann ich dir das erkl√§ren. danke ^l	positive
@user Nicht gut. =(	negative
@user Breizh sur seine.	neutral
@user Schlaf gut und tr√§ume was sch√∂nes. &lt;3	positive
@user BUT NOT REALLY GUYS	negative
Berlin, Schadenregulierer (m/w) Sach Schaden f√ºr das Regulierungsgebiet Ostsachsen http Jobs Versicherung	neutral
RT @user: BISON #Multichannel-Studie: Wut- und Frust-K√§ufe zu 76% weiterhin via Offline-Handel ;) Danke @user, heute Aben‚Ä¶	positive
@user Nee, klappt nicht:/	negative
Extrem flacher, ber√ºhrungsloser Winkelsensor http	neutral
Voll sch√∂ner Vintage-Spiegel. Oder Retro. Wei√ü nicht genau. Eher vintage! #latergram #shabby #vintage http	positive
@user die deutsche regierung ist nicht unfaehig ...sie hat nur nix zuppa melden . Ich lach michele tot wie die sich aufblasen	negative
"""Niemand wei√ü, wie weit seine Kr√§fte gehen, bis er sie versucht hat."" Johann Wolfgang von Goethe"	neutral
@user Gourmet sozusagen...sehr sch√∂n! ... Oh...ganz sch√∂n tief...na macht nix, muss ich halt bisschen √ºben... hmm...^ . ^	positive
@user Ey! Nichts gegen den Ruhrpott. &gt;:( (Aber ja, teilweise kommen die echt hier wech.)	negative
Gratis Beauty-Box ab 15‚Ç¨ Einkauf http	neutral
#Museum, #Planes, #Red_Bull, #Friedrichshafen, #Nice, #Cool, #Good, #Fast, #Speed. @ Dornier Museum‚Ä¶ http	positive
H√§tte vielleicht doch was langes anziehen sollen..	negative
@user nichts.	neutral
@user geil, abends √Ñpfel essen, morgens besoffen \o/	positive
RT @user: T√§glich flie√üen 300 Tonnen verseuchtes Wasser vor #Fukushima ins Meer und die Regioerung pocht auf die Sicherheit von Atomkr‚Ä¶	negative
Nicht vergessen: Das bissige #Musical Vergn√ºgen heute im K√∂nig Albert Theater! http	neutral
Huzur kumsalda :) (@ Beach Bar) http	positive
Routentracing zu dem Server zeigt jedenfalls nichts gutes an. Habe nirgendwo sonst Probleme. Spiele aber auch kaum was anderes online.	negative
RT @user: #Atmosph√§re #Meer #Kalk #Kiel #Miesmuscheln Miesmuscheln wachsen auch im sauren Meer http	neutral
Gott sei Dank. Das 1:1. #Eintracht #SGE	positive
@user light mann light Nahrung #Opfer	negative
kein wunder (@user http	neutral
@user nope stimmt nicht (/.\) *wegschmelz*	positive
Unsicher? Ich? Da Lache ich doch. HA!	negative
Grunderwerbsteuer wird erh√∂ht: Der Immobilienkauf wird teurer http	neutral
Im Allgemeinwissen bin ich am 'besten' #omg	positive
@user ein grauenhaftes erlebnis. war auch dort. unglaublich. einfach unglaublich.	negative
TV Beitrag: Reinsdorf Classic Cup 2013 - Zweiter Durchgang Lauf 01 http	neutral
@user nachtiii&lt;3	positive
&lt;- m√∂chte milde kotzen	negative
@user Mit Blindheit geschlagen sein,ist hoffentlich nicht ansteckend #BTW13 http Zwangsbehandlungsgesetz 26.02.13	neutral
Neue Kollektion kommt! - Wir freuen uns demn√§chst die streng limitierte Seldom Nasty Kollektion... http	positive
RT @user: @user ihr macht euch √∂ffentlich und wollt diskurs, also klag nicht, dass er √∂ffentlich stattfindet @user‚Ä¶	negative
RT @user: F√ºhrungsstreit beendet: BER-Technikchef Amann abgesetzt http	neutral
...an mit rein durfte ;D bzw.... eigentlich pennte er ja im Sessel als ich ins Bad schlich ;D ;D na ja.. nun bin ich wieder wach :))	positive
endlich Bus erreicht ihr mongos #Matze_der_babo #ha_gayy	negative
Neue Autos stossen weniger Abgase aus: http #News #Liechtenstein	neutral
@user K√∂nnt ihr bitte f√ºr gute Laune sorgen, die ich eigentlich schon habe, und Best Song Ever von One Direction spielen ? #Wunschhits :)	positive
Das interessiert mich gerade echt nicht. #Domian	negative
Langsam wird's hell drau√üen.	neutral
S√º√üer kleiner Elefant: Bad W√ºnnenberg | Kann zur Blumenablage genutzt werden!Bitte Abholung! http	positive
Halloween III spar ich mir. Aus Gr√ºnden. #Halloween http	negative
05:00 Die Bew√∂lkung nimmt zu, es wird w√§rmer. In den n√§chsten 12 bis 24 Stunden sind Niederschl√§ge m√∂glich. Windig.	neutral
@user klare Linie bei dt. Au√üenpolitik wird jetzt schon gebraucht und von Schwarz-Gelb kommt nichts! #r2g w√§re also klarer Fortschritt	positive
YOU CAN'T TWERK WITH US! *Gretchen Weiner voice.	negative
Wo? ortseingang Lichtenau! Genauer? B68! Richtung? aus Richtung Paderborn kommend! Wann? 30.08.2013 17:14 Uhr!	neutral
@user @user jetzt erst recht geteerten und auf Seltsames aufmerksam machen ;)	positive
sorry meine Internetverbindung ist schlecht der Live Stream wurde abgebrochen n√§chstes Mal am zehnten elften kommt ein neuer live stream	negative
Preisabschlag 50% Preis: 18,40 ‚Ç¨. Textilien: Noppies Damen Umstandsmode Shirt/ Top, All over Druck 30311, Gr... http	neutral
Photo: Seebr√ºcke um 02:02 Uhr. War sch√∂n :) (hier: Seebr√ºcke) http	positive
RT @user: Obama trifft sich wegen #Schnowden Asyl nicht mit Putin. Menschenrechtsverletzungen der Russen waren bislang keine Absage ‚Ä¶	negative
Hazard/Gefahr: AKW Fukushima: Radioaktiv belastetes Wasser flie√üt tonnenweise ins Meer http via @user	neutral
Lebe frei! http http #Freiheit	positive
Das Wetter?! RT @user: Macht kaputt, was euch nachts wach liegen l√§sst!	negative
Transfer angeblich perfekt - Real zahlt 99 Millionen Euro f√ºr Gareth Bale http	neutral
@user @user @user GL√úCKWUNSCH! Echt heftig platz3 0.0 !! Aber echt verdient &lt;3!!!! Besten:) #stricksockenswagger #3	positive
@user unachtsam *seufz*	negative
Vodafone definiert nach $130 Mrd. schweren Verkauf der Verizon Wireless Beteiligung das Gewinnziel neu. http #LGTNavigator	neutral
@user Kein Problem S√º√üe! :)&lt;33	positive
"""Ich bin mehr so 'ne sch√∂ne, gelbe Banane."" #was o_O"	negative
@user Das w√§re der erste Schritt, bevor man von den Piraten allgemein spricht. @user	neutral
TVG verliert nach guter Leistung 0:1 gegen Satrup (Pokal). Weiter k√§mpfen M√§nner!	positive
Ich werde gerade dezent nicht wach...	negative
Retweet if you want new followers? Schreibt halt was nettes, dann folgen euch die Leute von ganz allein. Ohne solche Drecksretweets #issso	neutral
@user: Ashley darf dann gerne auf eine aussichtslose Mission gehen... ^^	positive
@user seit monaten geht der mist hier wieder los.....warum blos?	negative
@user #Mainz vs. #Eintracht ...w√§r' doch was!? #dfbpokal	neutral
Als alter Boston Legal &amp; James Spader/Alan Shore Fan, freue ich mich auf den Serien Neustart in den USA #TheBlacklist http	positive
XBOCT √§u√üerst sich negativ √ºber Mitspieler http #esports	negative
"Gladbach:""Ter Stegen fehlt, Younes bricht ab, Arango individuell http #Gladbach"	neutral
@user und? Hast dus fertig? :P	positive
Nicht gut. #LT	negative
"""Die NSA-Spionage macht uns weniger sicher"" - http #NSA #PRISM"	neutral
Alkohol! Jetzt! Mehr Alkohol! Sofort!	positive
Achtung, politisch unkorrekter Witz!! http	negative
Er kann es nicht lassen ‚Äì Xavier Naidoo doch wieder mit Musik-Show im TV!: Xavier Naidoo kann einfach nicht au... http	neutral
@user 2-0 Toko :) war eine ganz starke Vorstellung!!! #Danke #GCZ	positive
34 km, 615 hm. #Duscht mich! Knie schmerzt. #Aua! #Fertig! #Wasser! #Willinsbett #mimimimi	negative
Fremdartiges Gef√ºhl ‚Äì Kirsten Dunst: Noch nicht bereit f√ºr Kinder: 31 Jahre alt, eine langj√§hrige Karriere als... http	neutral
@user schlafet Wohl, wehrte Dame!	positive
Als was geht Merkel in die Geschichte ein? 1. Streuselkuchenkanzlerin 2. #merkelphone 3. Wendek√∂nigin 4. erfolgr.WahlkampfSchlaftablette 5.?	negative
[EDOEB] Aktualisierte technische Dokumente InTV: Die technischen Dokumente wurden aktualisiert. Freundliche... http	neutral
....auf meinen Schatz warten‚ô° (@ apt Hiller GmbH w/ @user) http	positive
Weltbild zerst√∂rt: Tageziel erreicht! RT @user: Mein ganzes Weltbild ist jetzt im Arsch.	negative
#telmi #dewa Sport: Fu√üball/1. Bundesliga: Eintracht Braunschweig geht in Hamburg unter	neutral
@user Kein Problem dass du erst jetzt antwortest! Lieber sp√§ter als nie. :)	positive
"RT @user: Fiedler (CDU) bezeichnet Snowden als Verr√§ter. ""Ich mag solche Leute nicht, der will nur Geld machen"". Unglaublich. #plen‚Ä¶"	negative
Znojmo holt alten Bekannten http #Sport #Eishockey	neutral
"""Stell dir vor, √ñsterreich m√ºsste bei der WM gegen Brasilien spielen!"" Wir lachen uns tot."	positive
@user @user @user :-/	negative
Software gegen √úberwachung: Verschl√ºsseln soll einfacher werden http via @user	neutral
16 Auszubildende beenden erfolgreich ihre Ausbildung - http	positive
"""...gr√∂√üer als bisher angenommen."" Wat'n Quatsch! Wer soll da wieviel angenommen haben? Wir denken das Schlimmste and then some! #GCHQ"	negative
RT @user: 'Bundesregierung verhindert strengere Abgasnormen'. BMW spendet fast 700 Millionen an #cdu. Lobbyisten im Kanzleramt! http	neutral
Hab voll bock nachher Pokemon Puzzle League spielen. lass euch dann davon teil haben =3	positive
F√ºr'n Arsch. Echt.	negative
Medien ohne Moral ‚Äì 25 Jahre nach dem Gladbecker Geiseldrama #srf http	neutral
@user daf√ºr KICK ASS	positive
RT @user: *stirbt gelassen aus*	negative
@user kurzprosa	neutral
@user your welcome	positive
Miley Cyrus √ºbertreibts langsam leicht.	negative
@user:#Hypo #Real #Estate Ex Chef klagt seit Jahren sein Gehalt ein.Nun fordert HRE Schadenersatz v Ex-Managern http	neutral
RT @user: Ich muss wieder mehr Beats machen. NEVER SLEEP CAUSE SLEEP IS THE CAUSE OF DEATH #nasvoice #music‚Ä¶ http	positive
"dasErste Mediathek http text/css Unglaublich! ""Miete rauf, Mieter raus!"""	negative
Weisheit des Tages: Wer gut schminkt, brauch weniger Schlaf	neutral
@user mach das, @user wird dir unheimlich dankbar daf√ºr sein	positive
same shit again :/ #ak #abschlussklasse #10 #rsbonlanden #realschule #scheiss #schule http	negative
RT @user: Alles wird gut! Pofalla erkl√§rt Probleme dieser Welt f√ºr beendet - http #pofalla	neutral
@user jaaaaa, h√§tteste halt ma Entw√ºrfe mit Sinn gemacht, wa!? :-P	positive
Ausgeglichenes Spiel,Hummels mal wieder ne Katastrope. Ein UE w√§re wohl verdient gewesen aber so ists auch Ok. http	negative
#wahlschau Kriminelle S√ºdl√§nder √ºberfallen brutal Rentner http	neutral
@user umm, shoot, ummm #DugMyOwnGrave. Lol.	positive
Die erste gro√üe liebe vergisst man nie ;(	negative
Fiat Panda Neuwagen g√ºnstig kaufen mit Rabatt - Premiumcars24 Neuwagen kaufen mit Rabatt http	neutral
Gut 21 Lauf-km im Sack &amp; p√ºnktlich zur√ºck, um den FRANKFURT MARATHON zu verfolgen.	positive
@user Damit machst du dir den Rhythmus dann komplett kaputt.. Versuch mal komplett wach zu (cont) http	negative
06.08.13 16:00 Bludenz: heiter, dunstig 31¬∞C. Wind:N/4 km/h. Regen:0,0mm http	neutral
@user nice. verdammt nice. danke. ich h√§tte mich echt ge√§rgert, w√§re mir das entgangen.	positive
@user Ich glaube nicht, dass ich da schlafen k√∂nnte.	negative
RT @user: Sony Smartwatch 2: Intelligente Uhr im Hands-On: Sony zeigt auf der IFA seine bald in Deutschland erscheinende... http	neutral
@user Ne ne, eindeutig !!! SP-lastig;-)))@user @user @user	positive
mir geht heute sowieso alles auf die nerven	negative
#Deload phase 1 Day 7! #SHFAthlete #HTH (@ Grand Platinum Fitness) http	neutral
@user Ach schatz. :'D wir waren uns doch einig, dass ich H√∂rn habe.	positive
Wieso nennt ihr euch @user wenn man keine infos bekommt? Einfach stillschweigen und 20min weniger Versp√§tung anzeigen?	negative
@user Programm neben Ai?	neutral
Peach vodka flush kar di meine :)	positive
Robbens Bewegungen beim feiern sehen nicht gut aus‚Ä¶. WTF	negative
Schon gewusst: 4010 hat das Comfort Complete Friends L Paket, bei dem Ihr 24x 10,- ‚Ç¨ sparen k√∂nnt....und wir... http	neutral
RT @user: @user YO SWAQGGY!	positive
Saftig geschriebener Taschentrafo	negative
@user Keine Ahnung.	neutral
@user Jep! F√ºr mich auch bitte! Guten Morgen! :-)	positive
@user Oh ja... und wenn man dann auch noch unterm Bett s√§ubern muss ._.	negative
Wo Unrecht zu Recht wird,wird Widerstand zur Pflicht!!!	neutral
Wow, das war echt witzig, Max. Applaus.	positive
Montag soll einfach sterben gehen. PUNKT.	negative
@user Zuerst der XBox Controller, und danach die Bonbons um den Schmerz zu tr√∂sten.	neutral
man muss drittkl√§ssler lieben. vorpubert√§t for the win. :D	positive
Manche Menschen sehen ohne Schminke echt komisch aus o_o'	negative
#GEWINNSPIELTEILNAHME #gratis! Mit Gl√ºck eine #Playstation 4‚úî GEWINNEN? ‚ûΩhttp ‚úî #gewinnspiel	neutral
@user Altmaier war schon hier. Aber auch schnell wieder weg... #Termine ;-)	positive
Innerseelischer Konflikt :-[	negative
Merkw√ºrdiger Traum!	neutral
@user deal! Helles? Augustiner? Was m√∂chtest du?	positive
@user leider kaufen genau bei Sparkassen viele Leute sowas :(	negative
@user meine Erfahrungen: Cardio (&gt;30 min) &amp; low Carb.	neutral
@user Dieser Blick 'ne? Ich liebe den. xD http	positive
@user soll tun,was er f√ºr richtig h√§lt Dennoch sei mir erlaubt nicht gl√ºcklich zu sein,wenn 2 WM-Spieler verkauft werden #Gomez #Gustavo	negative
Clogs: Birki SUPER BIRKI AS #68621, Unisex-Erwachsene... http #birki #blau #blue #sandalen #super #unisexerwachsene	neutral
So unfassbar m√ºde - gute Nacht, ihr H√ºbschen &lt;3	positive
Was f√ºr ein j√§mmerlicher Haufen. RT @user: Oracle: Open Source nicht f√ºr das US-Milit√§r geeignet http #linux	negative
Clogs: Ganter Sonnica, Weite E... http #520280570000 #clogs #damen #ganter #grau #pantoletten #sonnica #weite	neutral
RT @user: @user @user seine tweets haben zu 99% einfach keinen sinn üòÇ http	positive
@user Das macht mir Angst.	negative
Gefragte Produkte: K&amp;N Luftfilterreinigungsset: ReinigungssatzDer Reinigungssatz besteht aus‚Ä¶ http	neutral
@user *schaut ihn nach dem Kuss an und muss anfangen zu lachen* ha ha du schaust so doof aus ,, schau mal in den spiegel :P	positive
zur√ºck zum sushi house? RT @user: Geht gar nicht...hab schon wieder Hunger..	negative
Raus aus den Schulden: Peter Zwegat rettet Familienplanung eines Paares: Diesmal steht Peter Zwegat in seiner ... http	neutral
"""Ich hab das internet gel√∂scht"" Na dann herzlichen Gl√ºckwunsch!"	positive
"Aogo? Wof√ºr? Sinnlose ""Verst√§rkung"" #s04"	negative
Bundesliga Wrap: Eintracht Frankfurt bounce back, Stuttgart lose again http - #1 Fan @user	neutral
@user Nat√ºrlich :D was denkst du denn?	positive
Fressen Lieben Kotzen #veranstaltung http	negative
Also meinen namen eher nicht. Aber wir k√∂nnen nat√ºrlich auch mal aufnehmen. LG Schmiddy_LP (@user http	neutral
@user Die Liebe unter Verwandten. :'3	positive
@user ich werde halt trotzdem noch viel zu schnell mad	negative
Arbeitgeber: Studenten halten nicht mehr viel von Banken http	neutral
@user Gute Nacht Angelika, schlaf gut und tr√§ume was Sch√∂nes! ‚ô°	positive
@user Wehe, ihr schaltet @user nicht p√ºnktlich auf!	negative
@user was macht Obama wenn in Syrien innerhalb der n√§chsten 9 Tage wieder Giftgas von den Rebellen eingesetzt wird?	neutral
Endlich! Uli Hoeness schl√§gt zur√ºck. #steueraff√§re #stern #vorverurteilung #informant http	positive
Ok ich komm so nicht klar, hab grade meinen gastvater aus England getroffen.	negative
#TVDuell Frage an die beiden : Ich muss mit weniger als 400‚Ç¨ im monat klar kommen warum wird die jugend die... http	neutral
"RT @user: ""Guten Tag, verehrte Fahrscheine... √§h... Fahrg√§ste."" (Piotr Schuff)"	positive
Oder vielleicht liegt's auch einfach an mir. Vielleicht bin ich einfach so abgrundtief schei√üe.	negative
RT @user: RT @user: iPhone Gold. Das Ed Hardy unter den Mobiltelefonen.	neutral
RT @user: Welch geiler Slogan!! Besser geht's nicht !!!!!!!!! ‚Äú@bvb_blog_berlin: EVONIK!!! TOP SPONSOR!!! http	positive
@user kent ten ns3eb kein chiwahed fdari :(	negative
"RT @user: @user : ""und sie sind also der Sohn von Frau blaskow?"" - nachtw√§chter des Hotels: ""und das m√ºsst ihr jetzt auf‚Ä¶"	neutral
Mukke machen war wieder mega gut! Jetzt wird erstmal sch√∂n geschlafen! #gutenacht #welt http	positive
zu gro√üe tunnel sehen so h√§sslich aus im going to vomit	negative
.. allein open source eine chance hat, k√§ufer und besitzer von software zu sch√ºtzen, daher wird es weitere angriffe gegen open source geben	neutral
#awww #Hasen #Kaninchen #rabbit #Babys #looove #bei #uns #an #der #schule! #so #flauschig #und #klein!‚Ä¶ http	positive
@user in Deinem Zeitfenster sicher nicht. Aber ab KM 30 werde ich gerne nass ;-) @user @user	negative
Studie: √ñkolabel f√ºr Autos bei Verbrauchern kaum bekannt http #Riester	neutral
@user @user gratuliere!	positive
Die Websites der NPD sind bei mir grade down. Dabei suche ich Argumente aus der rechten Ecke ... Unauffindbar. :/	negative
Versp√§tete Zahlung: Nach 17 Jahren erh√§lt Mann sein Preisgeld http	neutral
Too much dessert! hehe http	positive
leider wurde um 17:06 aus versehen meine SIM gesperrt (GK) und nun kann ich weder telefonieren noch simsen // what to do? @user	negative
Der Herbst bringt gro√üe Raubfische http #angeln #herbst	neutral
@user Ooook....entt√§uschen nicht, sieht aber aus wie mehr als 20cm Unterschied, deswegen :) have fun	positive
Brauche mehr Hoodies... habe kein Geld.. fuk yu moni	negative
@user @user Keine Pumpen im Tiefbhf? Liegt bei Hochwasser Tiefbhf unter Neckarpegel, so da√ü Abflu√ürohre nix bringen w√ºrden? #S21	neutral
@user lief risch gut;)	positive
RT @user: Schule :( Nach diesem Wochenende einfach keine Lust....	negative
Alasan Kempf Tolak Gabung Juventus: Wonderkid Eintracht Frankfurt; Marc Oliver Kempf menolak untuk pindah ke J... http	neutral
@user woahaaa geil lea :) das muss echt ein geiles Gef√ºhl sein. Krass. Gl√ºckwunsch :')	positive
Will einen neuen Header aber ich bring es nicht √ºbers Herz mein jetzigen tollen Header zu entfernen ;-;	negative
RT @user: Herr, breite Deine Arme aus und spende mir Schatten. Amen #jesus #christ #sonnenstich http	neutral
@user Ich mag ihn auch echt gerne, haste fein gemacht!	positive
@user dortmund nicht sch√∂n	negative
RT @user: Kurz√ºbersicht was wir #piraten im Bundestag erreichen wollen (1/2) #btw13 /bo http	neutral
@user Guten Morgen. W√ºnsch' ich Dir auch! Muss heute aufs Zollamt fahren meine Quilts abholen - yay, endlich! Was liegt bei Dir an?	positive
"RT @user: ""Ich hab meinen D√∂ner verloren. ICH SOLLTE NIE EIGENE KINDER HABEN. ICH KANN NICHT MAL AUF MEINEN D√ñNER AUFPASSEN!"""	negative
#opblitzkrieg Innenminister Pistorius t√§uscht Interesse an Datensicherheit vor! http #GAGA	neutral
Drau√üen grau &amp; regnerisch. Perfekt f√ºr 5 Folgen Shopping Queen. üëç	positive
@user's account is temporarily unavailable because it violates the Twitter Media Policy. Learn more.	negative
A13 Zwischen AS Kayl und AS Schifflange Bauarbeiten, Fahrstreifen gesperrt, Dauer: 22.08.2013 08:30 Uhr bis 16:00 Uhr #ACL_A13	neutral
‚ô´ Lerelei Lerelei ohhhhhhhhh Lerelei ‚ô´ Maite #EventoDigital	positive
Gl√ºckliche P√§rchen. Ih. Pfui. B√§h. Aus!	negative
Sch√§uble: Neues Paket f√ºr Griechenland w√ºrde kleiner ausfallen ‚Äì Presse http #dowjones	neutral
@user um chicken duh ily	positive
"RT @user: NSA-Kritiker¬†Ilija Trojanow: ""Die Regierung verteidigt unsere Rechte nicht"" http"	negative
RT @user: Onliekommunikation erzeugt soziale K√§lte. #Symbolbild @user @user http	neutral
@user Hat bei meinen Facebook Freunden noch keiner gemacht xD	positive
RT @user: CDU/ CSU = Stillstand CDU/CSU + AFD = R√ºckschritt nahe zu ins Mittelalter	negative
#bz: Kein Geldbeutel: Karl Lagerfeld bezahlt niemals selbst http #berlin	neutral
@user lmao ich lach mich schlapp	positive
@user oküòî	negative
HR:  +++ Flum freut sich √ºber Konkurrenz +++ Eintracht Frankfurts Johannes Flum hadert nach der knappen... http	neutral
Ohne dich, bin ich wie ein Stern ohne Licht... ‚ô°	positive
Josephine Angelini: G√∂ttlich verloren http	negative
Offene Kamine Design: Tipps f√ºr ein gutes Gesch√§ft Herd mit Hilfe von Auction Web-Sites bekommen http	neutral
Bitte, bitte - haut voll rein. Lasst die BL nicht zu langweilig werden. Forever HSV @user: Countdown zum BL-Start....! Come On #BvB !!!	positive
@user ---- uuffffff	negative
Grand Theft Auto 5 - Erster DLC hei√üt angeblich ¬ªNorth Yankton¬´	neutral
@user H√ºbsch!	positive
"@user ""viel viel Koffein, wenig wenig Feingef√ºhl"""	negative
1. Gleichbehandlungsausschuss: 1. ordentliche Sitzung bereits passiert #uvsitzung13	neutral
@user sieht sicher cool aus zB mit Schwarzer Strumpfhose u Stiefeln!	positive
Einmal Weltuntergang zum Mitnehmen bitten. Danke.	negative
RT @user: PS4 / Xbox One: Ed Fries sieht gro√üe Publisher verschwinden http via @user #xboxone #playstation4 #konsolen	neutral
Amazon Smartphones, Handys, Telefone, Zubeh√∂r &amp; mehr - immer g√ºnstig! http	positive
@user Keine gute Nachricht.	negative
#2: Gangster Squad (Steelbook, exklusiv bei Amazon.de) [Blu-ray]: Gangster Squad (Steelbook, exklu... http #actionfilm	neutral
Wtf Genzlinger (Paul) aus New Girl spielt bei Being Human mit O.O WTF O.O	positive
Selten sinnloser Beitrag @user: Ahnungslosigkeit durch Digitalisierung http #realit√§tsferne #nichtsverstanden	negative
Ins Blog stellen oder nicht ‚Ä¶	neutral
K√∂ln Nachrichten: Gamescom 2013: Besucherzahlen explodieren http	positive
Ich w√ºrds mir am liebsten meine Beine abhacken, so weh tut das. Offene Blasen, juhu ...	negative
"RT @user: Stiftung Warentest: ""Keiner schneidet gut ab"" 13 Onlinespeicher http ""Manko: Daten¬≠sicherheit ..."" (German ‚Ä¶"	neutral
Ihre Augen entkleideten ihn geradezu - langsam aber sicher - St√ºck f√ºr St√ºck http @user #erotik #humor #liebe	positive
@user Und mein Fisch dauert noch 20 Minuten :(	negative
Kind sagt, ihr macht immer nur Quatsch!	neutral
@user hahaha tragisches Ende einer wundervollen Beziehung	positive
@user So soll's sein, hoffentlich √ºberwiegt aber nicht das Leiden dararn oder darunter, aber Liebe ganz ohne leiden ist nicht zu haben!	negative
@user Hilft Zeit, Arbeit und Geld sicher weiter, wenn man dann auf Twitter gegen Leute rantet. I see the point.	neutral
Aber wie cool war bitte der Kristen Stewart Tweet?	positive
@user Ka..ich tr√§um immer unlogisch :'((	negative
@user jag va hungrig, ok?	neutral
#psalm #23 #ich #will #bei #dir #bleiben #mein #leben #lang #gott #ist #immer #da #seine #arme #sind‚Ä¶ http	positive
@user biological parents cause depression	negative
RT @user: fr√ºher war mehr 20:15 uhr.	neutral
RT @user: Super: #Gysi klarer Gewinner bei ARD #ueberzeugtuns zur #btw13 mit 45,3 %! http	positive
@user Fr√ºhdienst und leider nicht am WE frei. Schlaf gut	negative
Hola @user	neutral
Qualit√§t Alter Klassikgitarre Sehr Gute Klang und Gut Erhalten: Hamburg | Qualit√§t Alter Klassikgitarre Sehr G... http	positive
@user @user ich erwarte gar nix mehr vom @user	negative
Robert Hartmann leitet Spiel gegen St. Pauli http	neutral
@user da bin ich in letzter zeit auch √∂fter und heute war es da richtig sch√∂n :3	positive
@user wieso sollten man Leute f√ºr Dummheit belohnen?	negative
Preisabschlag 50% Preis: 15,00 ‚Ç¨. Textilien: s.Oliver SELECTION Damen Bolero 3/4 Arm 11.307.39.1820, Gr. 34,... http	neutral
‚Äûverfluchte schei√üe geil‚Äú	positive
Irunge metu getehe-_-	negative
Die besten Schweizer Kredite des Monats Juli 2013! http	neutral
"Speechless~""@user: Kangen @user :')"	positive
Oh oh Die Batterien sind leer....das wird meinem Schatz nicht gefallen....	negative
"pv magazine Deutschland: ""Suntech fehlt klarer Businessplan"" http"	neutral
Heute 7h 1min und 54s Videoday geschaut war voll toll Y-Titty beste Leben. #ytitty #haltdeinmaul #videoday #videoday2013	positive
@user besseres kompetenteres Personal einstellen?	negative
RT @user: Darf euch meine Br√ºste nicht zeigen. Findet der Mann nicht toll. M√ºsst Ihr halt Eure zeigen!	neutral
@user *gaaaaaaaanz fest dr√ºck* was los?	positive
@user meiner nicht.. -.- Warte noch darauf, dass meine Tutorien ausgelost werden und die Chancen werden immer schlechter.. -.-	negative
Gefragte Produkte: Schild Durchgang verboten: Kunststoffschild;Farbe: gelb;schwarze Schrift; http	neutral
SGE ;-) Eintracht Frankfurt siegt auch gegen Maccabi Tel Aviv http	positive
Versto√üen...	negative
Mit dem Texte schreiben Geld verdienen| Geld verdienen mit Blogs und der Webseite http | #geld #verdienen #backlinks	neutral
Ach und: Gratulation nach M√ºnster. Have Fun in der n√§chsten Runde.	positive
Manche Leute k√∂nnen echt nicht buchstabieren. Da denken einige nach Android 4.4 KitKat kommt direkt Oreo oder Twix. Dafuq?	negative
Geldsorgen Fehlanzeige: Williams zuversichtlich #F1 http	neutral
Per 'Pelle' Nilssons Einsatz gegen den FC Augsburg fraglich - erneuter m√∂glicher Startelfeinsatz f√ºr Berkay... http	positive
@user Einfach kein Deo nehmen?! #nutzlosevorschlaege	negative
√ºbrigens sind das im neuen nintendo 2ds keine zwei separaten bildschirme, sondern nur ein(!) gro√üer... http	neutral
@user Just be grateful you're not Miley Cyrus	positive
Soo. Die #22UhrNonMention 's d√ºrfen nun beginnen...meins war schon. Zu fr√ºh. Besser als gar nich.	negative
‚ÄûActa Materialia Student Award 2013‚Äú f√ºr Dr. Melanie Timpel, #HZB. Preis√ºbergabe 28. Oktober, MS&amp;T, Montreal. (ar√∂) http	neutral
@user sch√∂n, nicht?	positive
@user weh...	negative
@user Gute Nacht! K√∂nnen Sie erkl√§ren, was passiert mit der Unterzeichnung des zaqueiro Vilson SEPalmeiras?	neutral
@user solche Worte passen nicht zu einer so h√ºbschen Frau. :-)	positive
@user @user Waaassssss???? Wer sagt sowas denn? Alter Schwede üò≥!Hoffe nicht die Jungs selber!	negative
@user dagegen spricht nat√ºrlich, dass jede Serie irgendwann endet... // @user	neutral
@user Falls Karyu dann Angelo verlassen w√ºrde. ^^	positive
B√∂rse Frankfurt: US-Geldpolitik macht dem Dax zu schaffen http #Geld #Finanzen	negative
Venedig: Gro√üer Preis der Jury f√ºr Film aus Taiwan! http http	neutral
@user aynen √∂yle schaweater :) @user	positive
@user l√§uft und hat so gut wie keine √§nderung mitsich gebracht. optisch zumindestl.	negative
K+S: Erwartet schwach http	neutral
@user ja. *-* wundersch√∂n vorallem diese insel war der Traum *o*	positive
Nervt mich voll, dass ich Samstag nicht da hin kann.	negative
RT @user: Urteil: Katholische Schule darf muslimischen Jungen ablehnen... http	neutral
Komme dank meines Feuerwehrausweises gratis aufs Frequency.	positive
(reagiert nicht)	negative
Muss bald mal bei H&amp;M bestellen. 	neutral
@user Aber die Seite schaut echt toll aus :3 Und da steckt sau viel Liebe drin :3	positive
@user Schmeckt bestimmt nicht sehr gut.	negative
Beim Abendbrot ne, da sa√ü meine Schwester neben Luka.	neutral
Oooooaaaa Robert Pattinson sieht in der #DiorRob Werbung megahei√ü aus. Respekt Robert :o	positive
". o O ( warum ist Hitler √úBERHAUPT noch irgendwo ""Ehrenb√ºrger""? ) Ich deute das Wort ""Ehre"" wohl falsch. W√ºrde vieles erkl√§ren."	negative
@user War eine eigene Buchungszeile. Kann's leider nicht mehr im Online-Banking einsehen aber in meinem eigenen XLS @user	neutral
Dat was echt zn sarcastische lach weetjewel.	positive
#Ich #raff #nicht #wie #sehr #sich #Leute #√§ndern #k√∂nnen #i #need #a #girl #in #my #life #forever‚Ä¶ http	negative
"Heiko berichtet √ºber ""Die Terror-Kr√∂te vom Oggenrieder Weiher"": http"	neutral
Wir w√ºnschen unserem FC Carl Zeiss viel Erfolg beim Heimspielauftakt 2013! ‚Äî at Ernst Abbe Sportfeld http	positive
@user Sch√ºtzengrabensimulator 1916 w√§re auch nicht sonderlich spektakul√§r. Ginge vermutlich Richtung Papers, please	negative
@user @user @user @user So f√ºllen, wie es hilft seiner Furcht oder Neugier zu z√ºgeln. Nur eben keine Religion daraus machen	neutral
Sorry, dass dieses WE kein Video kam, daf√ºr bekommt ihr jetz in 2-3 tagen schon wieder eins ;)	positive
So. Letzte Zigarette f√ºr heute. Morgen wieder 10 Stunden arbeiten *seufz	negative
Suppe schl√ºrfen	neutral
@user Guten Morgen liebe Kerstin w√ºnsch ich Dir auch :-)	positive
"RT @user: @user im not mad ""/ im sorry"	negative
Wann kommt n√§chstes Video?? (@user http	neutral
#Taunus -Gourmet: Die selbstgesammelten Kastanien frisch auf dem Grill r√∂sten...! So kann #Herbst Spa√ü machen.	positive
@user wahrscheinlich besser so. mein bl√∂der hang zu gossip ...	negative
Bei uns auf Arbeit gibts noch viel Spa√ü f√ºr wenig Geld.	neutral
RT @user: Das Paradies verdient, wer seine Freunde zum Lachen bringt. Aus dem Koran	positive
Uh, @user holt sich Smail Morabit, ex @user. Schwieriger Charakter. K√∂nnte schief gehen. Gewaltig sogar	negative
"RT @user: BVB-Boss Watzke: ""W√ºrde niemals J√ºrgen Klopp entlassen. Niemals. Nie""... http"	neutral
"@user nat√ºrlich ,, auf Heute Abend"""	positive
@user ahhhhh gezellig haha eindelihk iemand die ik ken !!!	negative
Einige SPD-Netzpolitiker erteilen Gro√üer Koalition deutliche Absage: http	neutral
@user Wenn der Fernseher wei√ü bleibt, k√∂nnte aber auch ne wei√üe Dingens ... lach, kreisch, gacker #tvwerbungaushauseblocki	positive
Selbst Peter und Olli f√§llt nicht viel zu dem Film ein. #schlefaz	negative
RT @user: Ich brauch neue Gedanken. Meine sind schmutzig.	neutral
RT @user: Hiiii @user k√∂nntest du das bitte machen ? W√§re total lieb von dir :) &lt;3 #HeidiKlumbittegr√º√üeOneDirectionvondeutschen‚Ä¶	positive
@user Arschl√∂chern in eine Schublade stecken sollen. Ich bin komplett anders, als meine Geschlechtsgenossen.	negative
¬ªiPhone-Schlaf√ºberwachung mit kostenloser Brandwunde¬´, via @user ‚Äî http	neutral
RT @user: Ein 1:1 gegen Freiburg. Au√üer unserer Super-Pfeife Pep h√§tte das sonst nur noch van Gaal geschafft.	positive
Ich muss mir morgen erstmal einen haufen schminke ins Gesicht klatschen, damit ich ausnahmsweise mal gut ausseh. #lt	negative
Schlicht und einfach Spaghetti mit Ketchup. No more no less. Just simple.	neutral
RT @user: Jetzt geht's los :) Unser CEO im @user Livestream mit @user http #Bloggerhuette #livestream	positive
@user nigga!!!	negative
Soziale Empfehlungen bald auch in #Google+ m√∂glich. #Update http	neutral
Drinking a Warsteiner Premium Dunkel by Warsteiner Brauerei ‚Äî http	positive
Toll, alle krank in meinem Umfeld. Ich wars net.	negative
RT @user: Klaus Eck: Erfolgreiches Online Reputation Management: http via @user	neutral
Wow! Sieht echt klasse aus! http	positive
@user Axt. Verdammte!	negative
@user iste ideal m√ºslim	neutral
Geiler Arsch http	positive
Wat ne Kacke. Wenn man zum Termin l√§dt, muss man ja auch wat erz√§hlen... :D	negative
6. Luxtra Spezialit√§t: Angriff Attacken: Eisenschweif, Biss, Donnerzahn, Funkensprung	neutral
@user gut Nacht Tr√§um s√º√ü	positive
Meine G√ºte, so allein sind sonst nur Singlem√§nner Samstagabends 2:3 #gerpar	negative
Sofortkauf: 5 Mark Silber, Hessen, Ludwig III, fast sehr sch√∂n gebraucht kaufen bei Hood.de http	neutral
"""With or without you"" und Mann zerrt mich auf seine B√ºhne. Liegen nebeneinander, sp√ºren unseren Herzschlag, lieben uns."	positive
‚Äû‚ÄöFisch nach Bauernart, sehr scharf‚Äò ‚Äì bist du sicher? Du wei√üt doch, was beim letzt‚Ä¶‚Äú ‚Äì ‚ÄûIch brauche meinen Schmerz, Spock!‚Äú ‚Äì *Seufz.*	negative
"Niederbayern: ""Blow up"" Gefahr gebannt http"	neutral
@user Man soll den Tag nicht vor dem Abend loben, aber man soll auch niemals die Hoffnung aufgeben ;-) :-D	positive
schei√üe :&lt; http	negative
Flotter Testkick in #Graz: @user nach 66 Minuten 0:1 gegen NK #Domzale aus Slowenien #SkyBuliAT #SSNHD http	neutral
Vin Diesel: Durch Arbeitslosigkeit zum Muskelprotz: Actionheld Vin Diesel hat seine imposanten Muskeln fehlend... http	positive
@user das klingt gar nicht gut :-(	negative
Die Bomben meiner Stadt machen BOOM, BOOM, BOOM!	neutral
@user Jau-das mache ich auch-meistens. Wenn ich nicht gerade einkaufen muss oder √§hnliches ;) @user	positive
@user ehrlich gesagt find ich sehen die headset tr√§ger noch alberner aus *g*	negative
Was macht denn so @user heute Abend?	neutral
http #viagra sehr billig kaufen	positive
@user Die gegenw√§rtig herrschende Gewalt ist m. E. sehr wohl ein Problem. Und vor allem wenig konstruktiv in der Sache. #lampedusahh	negative
Syrien: Ban fordert Zugang f√ºr Giftgas-Inspektoren: UN-Generalsekret√§r Ban Ki-moon hat die syrische F√ºhrung au... http	neutral
@user @user ich glaube, dass er eigentlich keinen blassen Schimmer hat, was er eigentlich will ;-)	positive
RT @user: @user #Totalschaden Einfach, leider.	negative
21.08.2013: Kampf gegen Fracking erreicht England (neues-deutschland.de) http	neutral
"""Willkommen, bienvenue, welcome! Fremde, etranger, stranger. Gluklich zu sehen, je suis enchante, Happy to see you, bleibe, reste, stay."""	positive
Cros Kindermusik braucht keiner.	negative
RT @user: #Black_Cat: Hey Du, was machst du so? komm in den kostenlosen Sex Chat http @user	neutral
Klasse √úbung http	positive
Boah ey.... Hoffentlich spielt der beim Derby auch so Schei√üe.	negative
Neuer Teilnehmerrekord beim Dresdner Elbeschwimmen ‚Äì √§ltester Schwimmer war 86. Zur Seite: http	neutral
@user @user compliment. Not criticism.	positive
Autsch autsch autsch! Sag doch einfach, dass du homophob bist, weil du denkst, dass Homosexuelle keine guten Eltern sein k√∂nnen! #wahlarena	negative
fraMediale-Preis 2014 ¬¥Digitales Lernen: Reality, Science &amp; Fiction¬¥: Zum einen richtet sich dieser Wettbewerb... http	neutral
#ff @user #ff @user #ff @user #ff @user #ff @user #ff @user Ich verbeuge mich vor dem gro√üen Autor, Chapeaux!	positive
Ultimative Langeweile..... Ich sterbe mooooooah D:	negative
... #Politik ... Herzspende, amtl. beurkundet, zu Gunsten der Partei. Damit nicht Wort, aber Takt in anderer H√ºlle weitersCHl√§gt l√§gt √§gt gt	neutral
@user @user ok:)	positive
Irgendwie wirken meine Tweets mit diesem Ava sehr unseri√∂s :((((((((	negative
Lieber einen riesigen Mega Hakuhodo Post oder auf zwei aufgeteilt (Blende und sonstige Pinsel)?	neutral
Endlich :) Open Suse 13.1 RC ... Wow! Einfach nur WOW! http	positive
Hmm - Client Tweetdeck funzt es. Weird shit. Naja, dann halt Client.	negative
Michelle Wetzel: Will Smith tauscht Lebenszeit gegen Zeitreise http	neutral
@user sieht aber gut aus	positive
Twitch?Dornr√∂schen lass dein BH herunter.	negative
Robin Frijns Trennung von Erfolgs Manager http	neutral
RT @user: Will ihn einfach nur bei mir haben, in seinen Armen liegen, seine N√§he, seine W√§rme genie√üen, seine Liebe sp√ºren.‚ô°	positive
Instagram aufzumachen war keine gute Idee.	negative
@user EE sind aber viel arbeitsintensiver als Dreckschleuderbetrieb. Z√§hlt Klimawandel und Zukunftsperspektiven nichts mehr??	neutral
@user Wundersch√∂n Dani siehst auch so sehr gut aus, k√º√üchen	positive
@user @user *leise wein*	negative
unglaublich. http	neutral
üòÇüòÇüòÇ Selten geil !! ‚Äú@jardinduvin: Was mir bei Frauen am wichtigsten ist: http	positive
@user bringt durchs Telefon nichts...	negative
"#Trends. Deutschrocker verneigen sich vor¬†Fritz Rau: ""Der gro√üe Impresario!"".. Check out! http http"	neutral
RT @user: Mein Wahl-o-mat-Ergebnis √ºberrascht mich √ºberhaupt nicht :) Auch testen? http http	positive
@user *unter Decke begraben werd*	negative
@user na bevor du vor der T√ºr geschlafen h√§ttest? am ende h√§ttet ihr nen netten Abend mit anschliesendem sex....usw	neutral
@user so schlimm sind die nicht, ich sehe keine Probleme, da gibts bedeutend schlimmere √∂ffentliche Accounts @user	positive
Bahn okay, daf√ºr Stau kurz vor der Ausfahrt???	negative
Nimmst du irgendetwas wahr, dass kein anderer sieht? ‚Äî nope :D http	neutral
RT @user: Photo: Gru√ü aus #thrudheim (Part 2) #nofilter http	positive
Warum sind die Antworten untereinander ;_;? ich Blick hier bei den Tweets gerade nicht mehr durch	negative
Endlich, Microsoft schluckt die Handysparte von Nokia oder das trojanische Pferd Stephen Elop meldet Vollzug http	neutral
Samsung 3D-Fernseher gewinnen!: Gewinnen Sie den Samsung UE46D8090YS 3D LED Fernseher. Der 46 Zoll Fernseher m... http	positive
Och ne, jetzt singt Nicole auch noch? HILFE. #sg	negative
Leute, die ein paar GB geklaute Musik auf dem Rechner haben und sich √ºber einen geklauten Tweet aufregen...	neutral
*WIE NEU!* Tolle MBT Herren Sportschuhe, Mahuta blau Gr. 45 CHF 89,90 http	positive
@user okay:) leider nicht in meiner N√§he aber vielleicht sieht man sich ;)	negative
Tainted Talents (Ateliertagebuch.) ¬ª Wir sind nicht allein http	neutral
"""Hart aber fair"" mit 5,27 Mio Zuschauern Tagessieger im Ersten http #politik #news"	positive
@user igitt! gels! b√§h! (aber trotzdem danke)	negative
Aktualisiert: ERSTBEZUG: Wohnkomfort in Gr√ºnruhelage nahe dem Hauptbahnhof http	neutral
@user nope. 8 zoll im 4:3 format sind in meinen Augen perfekt.	positive
RT @user: Oh, der Bundestag beschlie√üt 450-Euro-Jobs, liebes Volk. Vern√ºnftig, schlie√ülich HABEN DIESE SESSELPUPSER NICHT MEHR V‚Ä¶	negative
Kingdom Hearts nur f√ºr PS3 ab dem 13.September erh√§ltlich. http	neutral
@user und dann mich anrufen und 5 minuten ente ente ente ente ente sagen. ja das kannst nur du xD	positive
ƒ±ch bin nicht gl√ºcklich	negative
@user Oh ja, k√∂nnte besser anfangen die Saison. Was hast du denn? Gute Besserung!	neutral
@user was ich, nein, im leben nicht :P	positive
"RT @user: Komisches Land Deutschland; GipsyBeer klingt ""voll cool"", Zigeuner-Bier aber nicht oder was?"	negative
Amazon OUTLET SCHUHE &amp; HANDTASCHEN jetzt stark reduziert http	neutral
Ach, Glubschi. Versuch doch bitte nicht, b√∂se zu gucken. Sonst muss ich lachen. #afcbvb	positive
Wir nehmen daf√ºr Elsass Lothringen zur√ºck haben: Montag wird H√∂lle.	negative
@user Verzeihung, Eminenz!	neutral
Ab morgen Abend bekommst du sehr feines (nichts saures) auf die Ohren! &lt;3 http	positive
Aber jetzt kommt da sogar Heino schon hin. Heino, auf einem Metal-Festival. Da leck mir doch einer die Hoden. Geht den Bach runter. #LT	negative
Bauarbeiten sind abgeschlossen ‚Ä¢ Inbetriebnahme des neuen Bahnsteiges ‚Ä¢ Schienenersatzverkehr wird eingestellt Ab... http	neutral
@user especially because it was in german. Danke Sch√∂nes M√§dchenüòä	positive
Aaaahhhh... Deres nh deres:'(	negative
Historischer H√∂chststand an der B√∂rse: Dax springt √ºber 9000 Punkte http	neutral
ach ja, bissl was von allem heute... da f√§llt mir nur dieser Song for the day dazu ein:... http	positive
Vorsicht! Betrunkene Pilger! http	negative
Illegale Waffenwerkstatt ausgehoben: Mann machte Deko-Waffen scharf http #Panorama	neutral
Schule gerade meine 82j√§hrige Mutter von Windows auf Mac um. Das geht. Umgekehrt w√§re eine Zumutung. ;)	positive
Paradox ist, wenn man den Guardian sch√ºtzen muss.	negative
Hey Hey Hey !! ... Vielen Dank allen die am Samstag trotz des hochsommerlichen Oktoberabends den Weg in den Salon... http	neutral
@user ach sehr gut, au moins eins	positive
Let¬¥s Play together Brickforce #10 Mist, Zu weit vom Mikro weg: http √ºber @user	negative
RT @user: USA: Waldbr√§nde erreichen Yosemite-Nationalpark http #Yosemite	neutral
@user Sieht super aus. Ende. üòâ	positive
@user üò∂	negative
@user @user hab ich auch gedacht auf den letzten Fotos echt s√ºss.olly murs muss die Hose in Stuttgart geplatzt sein, peinlich	neutral
Der @user tut echt geile musik machen. Nix mit Boyband hier.	positive
#Krankenhaus #chillen #Kopfschmerzen #aua #Kreislauf #schwindelig #nicht #laufen #k√∂nnen #geiles‚Ä¶ http	negative
"""Shades of Grey""-Verfilmung: Don Johnsons Tochter spielt Anastasia Steele: √úberraschung: Keine etablierte Holl... http"	neutral
"Entspanntes Kind :))) ""rechnen war sooo leicht"""	positive
@user FLEX! w√§re so schon vor 10 Jahren n√∂tig gewesen :(	negative
Lustlager die Zweite, bitte! - H√∂chst spannend, H√∂chst kulinarisch, H√∂chst barock http	neutral
@user nat√ºrlichüéæ	positive
@user im not:((((	negative
Dieseldiebstahl: Gera: In der Zeit von Donnerstag, gegen 18.15 Uhr, bis Freitag, gegen 6.50 Uhr, brachen unbek... http	neutral
"RT @user: @user Zitat von ihr: ""Ich lerne gerade gelassener zu sein und rege mich kaum noch auf."" HAHAHAHAHA"	positive
Tolles Gef√ºhl nur verletzt zu werden :(((	negative
A1: Mit meinen Sch√ºlern mehr bloggen unter http #EdchatDE	neutral
@user Richtig, daf√ºr trage ich auch schon Material zusammen :-)	positive
@user WELL CLEARLY YOURE NOT COOL	negative
Wie Sie sich bei extremen Wetterlagen sch√ºtzen k√∂nnen - http #Wetter #Sturm #Verhaltensweisen #Vorsorge	neutral
@user Danke sch√∂n üê∂üòä jetzt is aber Schluss mit lustig, weil ich ins K√∂rbchen muss. Der Wecker klingelt um halb 6‚Ä¶ schlaf sch√∂n üê∂üò¥üòä	positive
Inhaltsleeres Erbrechen.	negative
#deal #schnaeppchen Fidor Prepaid Kreditkarte (keine Schufa) kostenlos + 1,2% Zinsen + keine Geb√ºhren! http	neutral
@user Ach so. =D Wann hast du angefangen, Deutsch zu lernen? =D	positive
omg zu schwer http	negative
@user Die Lauscher verstecken sich hinter dem Rand der Erdenscheibe, m√∂gen ihnen Eselsohren wachsen.	neutral
"RT @user: ""Mein kleiner gr√ºner lila Freund!"" #Pokemon"	positive
@user ja.. schei√üe, wa?	negative
RT @user: Bitte weitersagen - @user sucht Verst√§rkung: u.a. Visual Designer und Senior/Head Product Manager http	neutral
Die 2. Kl√§sser heissen die neuen 1. Kl√§ssler im Schuljahr und im Schulhaus Hofmatt 1 herzlich willkommen. http	positive
Ich hasse meinen Laptop so sehr	negative
Unverbindliches Kredit-Angebot f√ºr Schufa-freies Darlehen: G√ºnstiger Anbieter f√ºr Ihren Online Kredit http	neutral
Hej! Sch√∂ne Idee von @user: Abwrackpr√§mie f√ºr altes Design: http	positive
@user aua, echt hart	negative
@user @user Vols	neutral
@user ach Kwink. √Ñu√üerlichkeiten sind doch unwichtig, der Inhalt z√§hlt doch! #schleim :D	positive
Wo kommt diese beklemmende Traurigkeit schon wieder her?	negative
Wohnungs√ºbergabe ‚Äì Ablehnung durch Vermieter: Wohnungs√ºbergabe ‚Äì Ablehnung durch Vermieter Lehnt ein Ver... http Recht	neutral
@user Du machst alles richtig, keine Sorge &lt;3	positive
@user FUCK I WAS ASLEEP PLEASE FOLLOW ME #michaelisthebestest #michaelisthebestest	negative
Fitness: Ayurveda ‚Äì Massage - Was steckt dahinter?: Ayurveda bedeutet: Indische Gesundheitslehre. Neben d... http #SWR	neutral
Hoffenheim f√ºhrt hochverdient mit 2-0 gegen Hannover.	positive
@user @user Romantischer Kitsch.	negative
RT @user: Notiz an mich: Warnweste kaufen. Finde meine nicht mehr.	neutral
Heute geht es endlich wieder los, der Kampf um Punkte. Zum Saisonauftakt sind wir heute zu Gast bei der Union... http	positive
@user Garden of Delight, sind recht unbekannt, leider :3	negative
@user @user Vielleicht Kanzler einer Honorar-Universit√§t. Aber ganz sicher nicht 2013 Kanzler einer Bundesrepublik Deutschland.	neutral
Oke gut! :) CHANTAL! :D ‚Äî Gehtt doch war dochh garnichtmal soo schwerr oderr?:DD http	positive
Wenn schon alles gratis wird warum nicht auch Aperture üòï	negative
@user Dann er oder sie sprischt Spanisch bitte. Buen viaje!	neutral
@user @user sieht voll sch√∂n aus *o*	positive
@user @user Das doch super! Und was macht ihr gegen Terror?	negative
Miss my nicht	neutral
Guten morgen! üíï - gleich kurz zur schule. :s	positive
@user V√∂llig bescheuert. :3 Einfach nicht mit solchem Unsinn besch√§ftigen. w	negative
Realsatire... ‚Äú@zeitonline: #NSA -Chef Keith Alexander verteidigt Sp√§hprogramme und fordert Ende der Enth√ºllungen http	neutral
@user @user Na gut, dann komm halt mit :3	positive
#sonntag #tired #me #boring #keine #lust #zu #l√§cheln #zeitungen #austrage# #keine #lust #viel #zu #fr√ºh http	negative
#Wirtschaft: √ñsterreichs Italien-Exporte brechen ein: http	neutral
RT @user: Vier weitere Wochen Pause f√ºr G√ºndogan. Jede Menge Zeit also um den neuen Vertrag zu unterschreiben ;-) @user #bvb	positive
@user :( okay dann halt Latte machiato. K√∂nnte etwas dauern	negative
@user @user Kalifornien und USA zeigen auch, dass parlamentarische Demokratie an Grenzen kommt, Regeln m√ºssen gut sein	neutral
Kwam het toch nog goed: @user wint Rookie Cup-race Silverstone, @user wint European Junior Cup-race op N√ºrburgring. Klasse!	positive
RT @user: Diese blauen Striche durch das neue Twitter Update sind so nervig.	negative
"Nach Erdbeben nahe Fukushima: Japan r√ºstet sich gegen Taifun ""Francisco"": Ein starkes Erdbeben hat die Katastr... http"	neutral
@user lol da brauch ich aber echt nen schauspielkurs vorher :') oder iwas lol wir m√ºssen das √ºben	positive
T√∂tet mich doch einfach, bitte, danke.	negative
New post: KS: Baunatal: Geldwechseltrick: Geschickter Dieb klaute unbemerkt 250,- Euro aus Portmonee http	neutral
Und wieder geht ein sch√∂ner (hei√üer) #Sommertag zu Ende - #Sonne #Baden #Sonne ‚òÄüö£üòé http	positive
RT @user: Jede Nacht aufs neue einsam im Bett.	negative
Georg Schramm - Die Fakten reden Klartext - Neues aus der Anstalt 01.10....: http via @user	neutral
@user haste kaputt gefahren wa? :p	positive
@user don't text me back cool...	negative
RT @user: BILD bekommt per SMS Informationen geleakt: EXKLUSIV! SPD-Mitglied macht das: SKANDAL! T√ºrlich.	neutral
@user @user @user @user @user Heyes sind AP das alleindas ist cool:D ich glaube nicht das die Pl√§tze schlecht sind	positive
@user Schlimm, nicht wahr?	negative
@user ily	neutral
RT @user: #caring! c: @user RT @user: If You Love Freedom --&gt; Hug A Veteran &amp; Slap A Liberal	positive
@user Das kann keiner beweisen! Aber ich bin nicht sch√∂n xD wirklich.	negative
Haufenweise meiner Apps bem√§ngeln fehlende Kommunikation zum Server. √îo #isdochnichnormal #AusfallWegenRegen	neutral
@user Sportlich, sportlich! G√∂nn dir zwischen deinen ganzen Terminen auch eine Pause	positive
@user not nice	negative
@user *keinen	neutral
Zwischendurch bekommt der Typ seinen harten Pr√ºgel immer wieder von meiner Freundin sauber geblasen ! 18+ &gt;&gt;&gt; http	positive
‚ÄûLeck mich!‚Äú - Sch√∂ller launcht App-Game - also ich mag mein iPhone nicht abschlecken auch wenn die Idee lustig ist http	negative
RT @user: Selbst Castle Fans aus anderen L√§ndern helfen mit! Castle Fans halten zusammen! #BringBackCastle @user	neutral
@user richtig, Gr√∂√üenwahn!	positive
#scheisse http	negative
#Merkel angeblich schon seit 2002 auf #NSA-√úberwachungsliste http #Merkelphone erregt, Millionen andere nicht!	neutral
Schaut so aus, als ob der Sommer vorbei ist. In diesem Sinne, auf a gute Riversurfherbstsaison ;)... http	positive
@user Daf√ºr mit mehr offensivem Mittelfeld. Alles nur um den d√§mlichen G√∂tze unterzubringen -.-	negative
@user @user Partei zu Zukunftstechnologien wie der gr√ºnen Gentechnik und ihrem Hang zum Verbot als L√∂sung. Schwere Entscheidung	neutral
@user Lol ja, aber nicht zu gut.	positive
versicherung handy: Handy-Versicherung: Mit Sicherheit eine schlechte Idee | BASIC thinking versicherung handy... http	negative
"esra: Robert Kurz √ºber ""solidarische √ñkonomie"" (6 Kommentare) http"	neutral
@user @user awww....so geil....jetzt werd ich gleich wuschig... :***	positive
@user Entsetzlich	negative
"@user NUR EINS ""Virals - Tot k√∂nnen nicht mehr reden"""	neutral
@user du hast deinen GermanDream wahr gemacht abi du bist der King Gl√ºckwunsch Platz 1 yes! yes! yes!	positive
mega geil, sich ohne licht schminken zu m√ºssen üòë	negative
Europ√§ische App-Industrie: #Apps schaffen 800.000 Arbeitspl√§tze http	neutral
@user @user Hey Leute! :) Nachher Eintracht vs. Eintracht schauen? Vielleicht gegen 15 Uhr im Tower?	positive
NICHT SCHON WIEDER!!!! SG Aumund-Vegesack - TSG 1899 #Hoffenheim 0:0 HZ muss als gro√üer Erfolg f√ºr Aumund-Vegesack gesehen werden.	negative
Fahrradhelm Bicycle Gear Helm Erwachsene Gr. L blau http	neutral
"#beschtifacebookkomment√§rever ""h√ºbsch"" ""mercii :-)"" ""bitte"""	positive
Super. Sch√∂ne Kopfschmerzen.	negative
"Volksbank Raiffeisenbank Dachau eG, Kammerberg: ""alles bestens"" http"	neutral
Gute Laune Energie f√ºr die ganze Galaxie! http	positive
@user naja, nicht unbedingt abwegig ^^	negative
Cremefarben Engel stehend 17cm http #sortimentsartikel #geschenkartikel	neutral
Baden. Endlich. Wundervoll. http	positive
+EIL++ Dummes Fu√üballspiel wen k√ºmmerts	negative
POL-LG: ++ Einbrecher in Gastst√§tte gestellt - Polizei ermittelt ++ frontal ... - news aktuell (Pressemitteilu... http	neutral
@user @user Ich nehm ansonsten auch Barbossa. So voll schmutzig. Und evil. Like a Boss.	positive
Was macht G√∂tze eigentlich so. Hab gar nichts mitgekriegt. Spielt der auch weider Fussball? #sarkasmus	negative
#Startup-Wettbewerb honoriert zukunftsweisende Big-Data-Gesch√§ftskonzepte http #awards	neutral
Facebook macht ungl√ºcklich. K√∂nnt ihr das best√§tigen? :) #SocialMedia http via @user	positive
Asiatische Cosplayer sehen bei so richtig m√§nnlichen Cosplays auch nur schei√üe aus	negative
Berufst√§tigkeit mit Behinderung? F√ºr den deutschen B√ºrokraten eine kognitive √úberforderung. Seelig sind die, die ,,, http	neutral
Wir haben schon Wochenende! RT @user Warum kann der Freitag nicht mal seinem Namen alle Ehre machen?	positive
POL-EL: Lagerhalle abgebrannt http	negative
@user ja.....	neutral
RT @user: Happy Birthday And Happy Bar Mitzah Ben!! http	positive
@user wuuut	negative
#Elektronik #2: Kindle Paperwhite [Vorg√§ngermodell], 15 cm (6 Zoll) hochaufl√∂sendes Display mit integrierter B...  http	neutral
@user super stars like Blaine gabbert	positive
@user scheiss uf dich!	negative
RT @user: Pro D, AFD und FDP teilen sich einen Mast. Passt schon...	neutral
hhahha duh , wenn L≈´gen Ghuet w√§re denn besch duh am tr√§ume ‚Äî ya ich bin von meiner tr√§um noch nicht aufgewacht http	positive
Ich wei√ü gar nicht, was heute eigentlich so lustig ist.	negative
RT @user: Regierungsbildung in Hessen: FDP schlie√üt ‚Äûnichts mehr aus‚Äú http	neutral
Neue Liebe gefunden, ach sind die Toll &lt;3 #exciting #Diva #justlikeadiva #JLAD #goodnes #girl #shoes @‚Ä¶ http	positive
Dieser Ausschu√ü diente nur dazu, eine echte Aufkl√§rung, dem dummen Wahlvieh, B√ºrger genannt, vorzut√§uschen. http	negative
√úber men.... geredet. .... und sie holte aus hi hi http	neutral
@user Sieht sehr lecker aus :-)	positive
@user @user @user Einmal das, obendrein sollten bei solchen verbalen Attacken sollten hater mehr Gegenwind bekommen.	negative
RT @user: Sp√§haff√§re: Einsames Amerika... http	neutral
@user @user @user @user nicht nur eins :D	positive
mhhh http brauch ma kurz meinungen :/	negative
@user Sicherlich jedoch weniger Absicht dahinter.	neutral
Der Herr #Snowden sieht adrett aus: http	positive
Scheitert Zusammenarbeit am Geld??? http	negative
2:1 gegen Arsenal - Klopp feiert Trib√ºnen-Party http	neutral
@user yo:-) voll der lachsack:-) auch in den vines.. irre lache :-) @user @user	positive
Das war dann doch heute etwas viel im #Tatort, f√ºr #M√ºnster eher so mittelm√§√üig!	negative
Dieses liebe M√§dchen wurde heute von unserem Teammitglied Jenny gefunden. Das Findelkind war voller Haarlinge und... http	neutral
Ce ciel... #sunset #coucherdesoleil #beautiful #amazing #palmier #beach #plage #street #evening‚Ä¶ http	positive
@user @user @user Speed On gibbet nicht :/ wegen LTE besonders schade.	negative
Diejenigen, die fr√ºher zur Oberschicht gez√§hlt wurden, geh√∂ren heute ganz eindeutig nicht mehr dazu.	neutral
@user er twitterte schneller als sein Schatten... @user	positive
Guten morgen oder besser gesagt schei√ü morgen ich zeige euch etwas sp√§ter mal meinen arm das wird immer schlimmer :(	negative
"nicht mehr ganz frisch: George Clooney's ""Monuments Men"" (2013) First Look! ENTV: http via @user"	neutral
@user ‚ÄûDu hast heute Lust besonders viel Geld f√ºr durchschnittlichen Kaffee auszugeben!‚Äú #starbucks	positive
Klasen mit rot runter. Da hatten mehr fliegen m√ºssen. Lachhaft der Schiri. #tuskob	negative
@user @user @user Dann gibts auch keine Tittenbilder mehr!!!!	neutral
@user @user Also Angst w√ºrde ich keine haben, aber 29‚Ç¨‚Ä¶ Holla die Waldfee :)	positive
RT @user: OMG, ist das Ding h√§sslich. http #samsung #galaxy #gear Ich freu mich auf die #Apple #iWatch.	negative
"""Meine Damen, meine Herren... bitte beachten Sie: dieser Zug wird in Hamm getrennt. Der vordere Zugteil mit den Wagen 21-27..."" HILFE?"	neutral
@user 86 lach ,, heheheheheee ,,,	positive
@user oha, dachte dein Typ war da gefragt :-/	negative
Die Gegner sind alle voll weit weg #civ4	neutral
Guten morgen meine s√º√üen - good morning	positive
Idee: Kommunikationsmedium erfinden, in dem einen jeder Depp ungefragt anp√∂beln kann. Oh, schade, Jack Dorsey war schneller.	negative
@user Eigent√ºmlich Frei, Mises Daily, NZZ, Presse, orf.at	neutral
RT @user: ‚Äú@KusXAnke: Straks buikdansen w/ @user &amp; haar nichten ! Was super!	positive
@user Aber wenns Kackbalge aus der anderen Klasse sind?	negative
"#Luhukay: ""Keine neuen Verletzten. #Wagner steigt heute wieder ins Training ein."" #hahohe"	neutral
@user Poster, s√º√ües, undso ^^ Du brauchst doch sachen f√ºr dein zimmer ^^	positive
#tvduell Seehofers Quatsch kann selbst Merkel nicht verteidigen..	negative
@user besonderer Grund oder einfach so?	neutral
Sonne genie√üen. .endlich man!!!!!	positive
Oo na kung Bitter :(((	negative
RT @user: Knackige Slogans gesucht! http K√∂nnen uns vielleicht @user oder @user helfen? #followerpower #‚Ä¶	neutral
@user Nein, aber deine Rezi macht sehr neugierig! üòä	positive
@user Jop und wenn sich die Agenda nicht noch √§ndert muss er abends lernen :-\	negative
R√∂sler: Monopolkommission best√§tigt Notwendigkeit eines Systemwechsels beim EEG http	neutral
Tolle Betriebsanleitung... #heuteshow #Gro√üeKoalition #GroKo http	positive
RT @user: ‚ÄûIch beuge mich meinem Schicksal..‚Äú ‚ÄûDu stehst auf.‚Äú ‚Äû..ist nicht leicht, sich damit abzufinden..‚Äú ‚ÄûDu stehst nur auf!‚Äú ‚ÄûAM‚Ä¶	negative
RT @user: Auf geht's Eisb√§ren k√§mpfen und siegen! #Eisb√§ren #EBB #sechsPunkteWochenende	neutral
@user Tu das! ;) War nicht sonderlich lang...	positive
Mit schlechter Laune :(	negative
Infos √ºber Geschenke Shop bis hin zum Tamaris Online Shop - http	neutral
supi schwarz bitte @user @user @user @user @user @user @user @user	positive
@user ICH GLAUB NICHT aber wieso bin ich so nerv√∂s ich bin sonst nie nerv√∂s aaaah	negative
#Eishockey #Oberliga Oberliga Nord: Adendorfer EC nicht f√ºr gro√üen Kampf belohnt ‚Äì 3-4 gegen Rostock... http #Adendorf	neutral
@user Danke. H√ºbscher kleiner Kerl. ;)	positive
Gerardo Martino trauert Sieg gegen AC Milan nach http #championsleague	negative
Amtsgericht Hamburg deckelt #Anwaltskosten bei #Abmahnung ¬ª http http	neutral
#heute #post #bekommen #offiziell #bayernm√ºnchen #bayern #m√ºnchen #mitglied #schal #karte #geil‚Ä¶ http	positive
Neue Strafe f√ºr US-Rapper - Chris Brown zu 1000 Stunden Sozialdienst verurteilt http	negative
Viel Spa√ü bei 5 Minuten stehen ihr Ob Aluh√ºte wirken oder nicht, an einer Tastatur; wir instant da.	neutral
Erschma 2 Eis hintereinander reinpfeifen!	positive
DE GUY LOOKS LIKE A DANGER TO SOCIETY!! @user er k√∂nnte ya im sumpf so n sch√∂nen LOVESHACK bauen--//not fer me!	negative
Angry Birds Go! ‚Äì Racing Game im Angry Birds Universum erscheint am 11. Dezember 2013: Nach dem erfrischend an... http	neutral
Nettes kicker Team tool als demo von @user beim #mtc13 ;-)	positive
@user ihh, takira nd aus -_-	negative
Wieland-Haustechnik verst√§rkt Au√üendienst http	neutral
Wir empfehlen die http bei Amazon - Fight! :) http	positive
"""Du bist wie eine Pusteblume."" ""Aww,Danke."" ""Einmal geblasen und kein Samen mehr."""	negative
ROUNDUP: Griechenland ben√∂tigt laut SPD hohen zweistelligen Milliardenbetrag - AktienCheck: Presse... http #WiNewGooDe	neutral
@user @user ich hab meine normale SIM von Aldi Talk in Nano SIM gestanzt, lief alles super !	positive
"""@user: ""@user: . If I Ever Die These Hoes Gone Be Happy Asf.!"""""	negative
RT @user: @user http	neutral
@user mhm okay bei nicht versenden w√ºrd ichs dann wohl auch net tun xD	positive
Dem anderen hinterherhecheln statt eigenes zu schaffen. Ohne mich.	negative
"Debatte √ºber ""Veggie Day"": Gr√ºner Trittin kritisiert ""Drogenhandel im Stall"" http"	neutral
...und weils so sch√∂n war gleich nochmals üòâlive @user concert Zurich Switzerland: http #greentour #letzigrund	positive
RT @user: Schweiz Tourismus sch√§umt wegen der Oprah-Geschichte vor Wut. Vorteil: Den Schaum kann man dann bestens schlagen. http	negative
Congo-Kinshasa: Govt Forces Seize 'Last Major' Rebel Base: [Deutsche Welle]Congolese officials say government ... http	neutral
RT @user: Schrott Ankauf Lahib ( http ) macht das Unm√∂gliche m√∂glich ;)	positive
@user dezent schei√üe!!	negative
Studie: Kita macht Erzieherinnen krank - RP ONLINE: RP ONLINEStudie: Kita macht Erzieherinnen krankRP ONLINENo... http	neutral
@user haha, auch nicht schlecht xD naja wei√ü nicht fand sie iwie immer cool, lustig, frech... xD hat nur doofe Kr√§fte halt xD haha	positive
'Vielen Dank, liebe Gr√ºnen', dass die Einzelfahrscheine schon wieder teurer geworden sind. Sch√∂n langsam wirds pervers o.O	negative
LIVE #TREND (last 15 min): #MOST WANTED #KEYWORD #Demut insgeheim denkt wahrlich	neutral
hach, bin ich froh, das ich GEZ Geb√ºhren bezahle, daher hat die Sportschau zum gl√ºck ja keine WErbun .. √§h was .. √∂hm .. √§hm .. tja ..	positive
@user Sorry, bin momentan unglaublich im Stress, ich meld mich heute Abend! Sorry!!!	negative
I'm at Trainingszentrum TSG 1899 Hoffenheim (Zuzenhausen, Deutschland) [pic]: http	neutral
@user Wow. Gl√ºckwunsch! Was musstest du daf√ºr machen? xx	positive
Erfolgreicher Transfer, senor Perez! Bale geholt, Kaka und √ñzil verloren, fans gespalten! #WelcomeBale	negative
Magdeburger erzielen 38:31 gegen Balingen-Weilstetten: Zweiter Sieg im zweiten Spiel: Perfekter . . .: Magdebu... http	neutral
Dieser weg wierd kein leichter sein!!:)))) http	positive
@user @user @user EDGE ausbauen lohnt sich finanziell am Ende wohl nicht mehr. Umsatz steht eben -leider- vor allem.	negative
Erzwungene Digitalisierung http	neutral
RT @user: im not gone lie im wide awoke , lol	positive
@user ne danke keine deutschen produkte mit deutschem support mehr!	negative
@user *Zur√ºckgezogene Version ist die RT Version. Mit der normalen Version sind bei mir keine Fehler aufgetreten :/@user	neutral
RT @user: @user ich auch muss schon um 6 aufstehen :( danke du auch love you xx :) &lt;3	positive
shit Sas unicode SIX weil sich already reply macht Suche nach am habe oft meist brb Wien schon THIS SORCERY? Kann :3 meine Software via SieÔøΩ	negative
"""Meine Paranoia ist allgemein bekannt"": Snowden brauchte die besten Journalisten http via @user"	neutral
Vom B√ºro aus Helge Schneider beim Soundcheck h√∂ren - funny. ^^	positive
Ich will einfach tot sein	negative
RT @user: In meiner Jugend bin ich mal Marathon gelaufen. Also beinahe. Hab zugesehen. Im TV. War v√∂llig fertig.	neutral
@user Super, Danke! Endlich mal jmd ders versteht ;D	positive
@user aber ohne rae und Xavier :(	negative
RT @user: Wer ranted, das die Piratenpartei bl√∂de Liste aber gutes Programm hat, sollte mit Kandidatenantworten vergleichen http	neutral
Oh. Oh. Oh. Und ich will mir nach dem Praktikum endlich mal wieder die N√§gel sch√∂n machen.	positive
@user Mutig? Unverantwortlich!	negative
RT @user: Ein Fan hielt um seine Hand an ‚Äì Antrag mal anders: Will Ian Somerhal.. Kleine Ablenkung! http http	neutral
@user Daumen sind gedr√ºckt...und verr√ºckt? N√∂. F√ºr mich klingt das ganz normal :)	positive
Kopf Wand Weiter Schalke! Ne, ich bin echt ersch√ºttert.	negative
"RT @user: Eko Fresh spricht √ºber ""Eksodus"" (Video) @user #Eksodus #Bushido #Azad #MoTrip #Cassidy #KrayzieBone http"	neutral
@user In neun Monaten ... :-) Nein, sicher eher.	positive
Morgen eine neue Folge R&amp;I gucken und dabei wissen, dass der Schauspieler nicht mehr lebt :( #ripleethompsonyoung	negative
18.20 Magazinbeitrag von der DEMO ab Freiheit 18h #M√ºnchen #Repression #Polizeikessel http ‚Ä¶ #refugeestruggle #non_citizen	neutral
Krasses ding! Bayern zeigt moral. Chechz doch noch bezwungen.	positive
Ich hatte einen p√§dagogisch ganz und gar unvorzeigbaren Tag. Und einfallsreich war ich auch: nein! Nein! NEin! NEIn! NEIN! neiN! neIN! nEIN!	negative
Deutscher Kinderschutzbund: Kindergeld zu Kindergrundsicherung ausbauen! http	neutral
Kraftausdruck meets Ahnungslosigkeit: Himmlisch :)! http	positive
Hab mir gestern nicht nur Sonnenbrand, sondern auch ne Erk√§ltung geholt. Echt jetzt?	negative
"@user Musik. Musste meine SD-Karte formatieren. Habe nichts mehr aufm Handy. ^^"""	neutral
@user das sieht aber mal gut aus...	positive
@user Ignoranz? Arroganz? Kommunikative Bankrotterkl√§rung?	negative
Herrlich absurd, hauptsache sicher. http	neutral
@user Nachti tr√§um was sch√∂nes...	positive
√úber vier Stunden langer Spaziergang, einmal neue Beine bitte.	negative
#Reutlingen #Zeuge nach Unfall rechts vor links gesucht 09.03.2013 http	neutral
.@user Vielen Dank f√ºr die nette F√ºhrung! War sehr interessant :-) #twagdeburg	positive
@user jan buung jan buung :-((	negative
Microsoft Office, Alle Versionen spielend beherrschen http	neutral
ANRUF ERW√úNSCHT: JENNY, sexy einf√ºhlsam und verschmust!: Ganz neu im *loft6* JENNY 26 blondes sexy Girl mit... http	positive
Mario Basler muss irgendwann mal sehr unter Frauen gelitten haben. (Vermutung: seine Mutter)	negative
Milit√§reinsatz gegen Assad: Obama will in Syrien den Alleingang wagen: Das britische Parlament hat sich dem Sy... http	neutral
@user Album √ºbrigens 11/10 #perfekt	positive
Aufwachen und feststellen, dass der Arm taub ist. Voll drauf gepennt. Nice.	negative
So, Abfahrt. #jetzt #einkaufen	neutral
@user bissl hell oder nicht? :P	positive
Unterschenkel gezerrt. Yeaaeeh.	negative
Samstag Vormittag. #thenotebook http	neutral
Danke an all die Gl√ºckw√ºnsche‚ô•,ich hab wirklich nicht damit gerechnet deswegen freut es mich nat√ºrlich um so mehr. Vor Ort war ich damit...	positive
Seit einer gef√ºhlten Ewigkeit keine neuen podcasts mehr -.-	negative
On page 160 of 400 of Angelfall. F√ºrchtet euch, by Susan Ee: Die Wortgefechte von Raffe und Penryn sind ja wirklic... http	neutral
@user Ein treuer Fan,Gratuliert dem VfB Stuttgart zum 120j√§hrigen bestehen. VfB:) Oleeeeeeeeeeeeeeeeeeeeeee	positive
"RT @user: ""Immer versuchst Du mich zu therapieren!"" ""Und was macht das mit Dir?"" ""Orrr!"""	negative
@user die Klassiker schlecht hin!	neutral
@user Wundersch√∂n xD	positive
die haben auch keine anderen Hobbies als Lost Girl Dartseller in Rookie Blue zu stecken, oder?	negative
"RT @user: Wat? ""Christian Lindner zur NSA-Aff√§re: Der Staat muss den Datenmarkt st√§rker regulieren"" http"	neutral
RT @user: @user Jepp, schaut gut aus! http	positive
@user da gibt's wieder was auf die M√ºtze üòí	negative
RT @user: Sei nicht zu m√ºde! N√§chster Halt: Romantik mit #Flirtbotschaft http #M√ºnchen	neutral
Abpfeifen, mehr Spiel brauche ich nicht, Ergebnis passt #H96M05	positive
@user den Schinken wollte ich auch bestellen. Meine Burberry Hemden sind seit Monaten (!) r√ºckst√§ndig, aber bezahlt! @user	negative
Claudia #Pechstein auch sportlich angriffslustig: Sieg bei DM √ºber 3000m in pers√∂nlicher SBL zum zehnten Titel bei einer Einzelstrecken-DM.	neutral
@user Wer hat dir eig. deinen neuen Avatar gemacht? Sieht echt klasse aus!	positive
"RT @user: @user Nur dort zu predigen, wo eh alle zustimmend nicken, hat keinen Sinn. #wieschafeunterdiew√∂lfe"""	negative
@user @user ach so	neutral
Fr√∂hlich geliebte Metatablette	positive
@user Wieso muss man immer alles alte, gute wo funktioniert hat und wo jeder zufrieden mit war, einfach √ºber den Haufen werfen?	negative
ePlayer: Highlights T√ºrkei - Niederlande. Titel: WM-Quali: Robben st√ºrzt T√ºrkei ins Tal der Tr√§nen. Kanal: L√§nderspiele	neutral
Highspeed h√§lt diesen Monat verd√§chtig lang o.o	positive
Na toll, ich muss dem #Taxi Fahrer den Weg erkl√§ren ... #Frankfurt¬†	negative
RT @user: @user @user. Das kann ich empfehlen und unterst√ºtze diesen Apell. Helft den Hilflosen, verhindert Missvers‚Ä¶	neutral
@user @user @user Immer diese sturen Steirer :-p. Danke f√ºrs Entr√§tseln, klingt interessant, w√§r dabei - wann auch immer :-).	positive
@user @user jap *‚Ä¢* &amp; kurz bevor Spongebob angefangen hat kam die Werbung *‚Ä¢*	negative
guten morgen aus hannover. mal sehen, was der tag so bringt. start mit #mobilepayments @ Park Inn By‚Ä¶ http	neutral
@user oder spaeter. Will nur kurz was holen und will dic sehen lololol	positive
@user http	negative
"""@user: #Islamisten terrorisieren liberale #Assad-Gegner | STERN.DE http #Politik #Bundestagswahl""@user"	neutral
Yes das war nen Heiden Spa√ü. FEUCHTGEBIETE geiler FILM@Kxwoh http	positive
Sch√∂n. KabelBW Anschluss tot. ‚ÄûEs k√ºmmert sich heute oder morgen jemand drum‚Äú‚Ä¶	negative
RT @user: Was macht eigentlich... Christian Neuburger (Slut)? http	neutral
"Ich warte eigentlich darauf dass irgendjemand jetzt einen ""wei√üt du was noch voll hart ist""-Witz bringt.. xD"	positive
@user boah bitte Mach nd so den kindergarten sag doch einfach das I gemeint war und verkauf mi nd f√ªr dumm.	negative
El Salvador: Getr√§nke-Multi fordert mehr Wasser-Gemeinden protestieren http	neutral
@user hi Natalie siehst verdammt heiss aus.Umwerfender body geiler strammer Po.	positive
Die deutsche Bahn konnt sich grad nicht entscheiden ob der zug jetzt nun p√ºnktlich kommt oder nicht.	negative
Unglaubliche 140.000.000 tote Zugv√∂gel jedes Jahr! http #Deutschland1	neutral
Meine augen wollen nicht von dir lassen	positive
RT @user: @user faschistoid? Oh Mann, Sie m√ºssen echt ihr politisches Emp√∂rungsempfinden justieren....	negative
"""[Ger√ºcht] Zuk√ºnftige Apple-Kopfh√∂rer bekommen flexible Stecker"" http"	neutral
Irgendwas mit rosafarbenen Einh√∂rnern. Viel Spa√ü allen beim #ccb13!	positive
@user Peinliche Erkenntnis.	negative
RT @user: @user bitte spielt heute das neue lied von @user #StoryOfMyLife ‚ô•	neutral
@user punkrock de la fl√∂te de block! Klingt doch gut, oder nicht? üòâ	positive
Nicaragua: Interozeanischer Schifffahrtskanal gef√§hrdet wichtigste Trinkwasserquelle ‚Äì Freibrief f√ºr den Investor http	negative
schrott ankauf und abholung in nrw http einfach klasse	neutral
Gem√ºtliches Fr√ºhst√ºck (@ Pino Bar) http	positive
@user @user solange kein Beschluss da ist, gibts nur Stimmungsbild. Kriminalisierung weiter vorantreiben trifft‚Äôs nicht. @user @user	negative
Wegen Falschaussagen - Freund des Boston- Bombers angeklagt http August 30, 2013 at 10:02AM	neutral
@user Pscht! Nicht hier! Geh doch bitte aufs Klo dazu, ja? Danke dir! &lt;3	positive
dumme oma: 'der reifen hinten sieht ziemlich platt aus.' ich: 'der vorne auch.'	negative
Iran: Krieg in Syrien f√ºhrt zu mehr Terrorismus: Teheran (dpa) - Ein Milit√§rschlag gegen Syrien l√∂st nach Eins... http	neutral
"""Wir k√∂nnten abstimmen"" ""Wof√ºr denn? oO"" ""Keine Ahnung ... k√∂nnten abstimmen :)"""	positive
RT @user: Fenster auf, weil es zu hei√ü ist. Hereinkommen: 10 Stechm√ºcken, 7 Spinnen, 14 Fliegen, 5 Zeugen Jehovas. Fenster zu. Na t‚Ä¶	negative
#clouds #staatskanzlei #munich #m√ºnchen #blau #wolken #himmel #sky #silhouette #instagood‚Ä¶ http	neutral
@user hey lass meinen food porn in ruhe :-P *gerade leicht angetrunken ist*	positive
Diet diet diet , kein Essen kein Essen  ‚Äã (‚å£ÃÅ_‚å£ÃÄ)	negative
"Was neues vom FC Rot-Wei√ü #Erfurt "" Pressespiegel: 07. August 2013 "" http"	neutral
vorne an'na Tankstelle noch schnell zwei Monster Ripper gekauft. endlich!!! seit √ºber zwei wochen keins mehr. eeeeentzuuuuggg	positive
Hocke definitiv uf de falsche site	negative
Mr. Coffee versucht vergeblich, meine Lebensgeister zu wecken.	neutral
@user s√§he aber sicher gut aus :)	positive
@user Von denen wird mir immer schlecht.	negative
POL-H: Zeugenaufruf! Motorradfahrer bei Unfall leicht verletzt http	neutral
@user Hey S√º√üe. Warum hattest du gestern Stre√ü? Hoffe nichts schlimmes.	positive
@user @user !nicht witzig!	negative
Angie l√§chelt einmal ihre Antwort, und beseitigt 5 min Steinbr√ºck-Phrasen. Beste Mutti ever. #tvduell	neutral
@user tumblr people sind meine lieblings people :D	positive
@user hauptsache Aufmerksamkeit kassieren, l√§cherlicher Journalismus	negative
RT @user: #Mollath kommt frei: OLG N√ºrnberg entscheidet, dass Mollath unverz√ºglich aus der Psychiatrie zu entlassen sei. http	neutral
Wow, meine Augenbrauen sehen einmal gut aus.	positive
Haut am @user stellt de Kandidat aus dem Osten, de @user onst Konzept zum #Grondakommes vir. Eng interessant Lekt√ºr!	negative
AmandaGirl: Alter: 19 Sternzeichen: Sch√ºtze PLZ- Bereich: 3 Geschlecht: weiblich Augenfarbe: braun Hobbies: Sp... http	neutral
50 wertvolle Gedanken ine ein Spiel verpackt. Stephen R. Covey war einfach brilliant http	positive
@user sicherlich nicht!!	negative
VIP Mitgliedschaft http	neutral
"Lalala mit den besten chilln und die ""gro√üen"" jungs beim fu√üball spielen mit den kleinen jungs zugucken *-* :D"	positive
:'( :'( :'( Die letzte Aussprache war wohl das schwerste Telefonat meines gesamten Lebens :'( :'( :'( Aber wir gehen friedlich und als F...	negative
Obwohl weiterhin weniger #Velo gefahren wird (Beliebtheit sinkt), werden Unsummen reigepumpt. Darum also #Vignette! http	neutral
@user √Ñhm, welcher Geschichte?^^	positive
Drei Kleiderschr√§nke voll nichts zum Anziehen.	negative
#Kurier #Chronik Bim stoppte fl√ºchtenden Ladendieb: 51-J√§hriger wurde nach Diebstahl zwischen Stra√üenbah... http #News	neutral
Ihr seht heute wundersch√∂n aus! ‚ù§Ô∏è You look beautiful today. #hamburg #welovehh #beauty http	positive
@user ein tritt? Fehlt mir die kraft dazu....ich k√§mpfe nicht erst seit 3-4 Tagen. Sondern seit √ºber einem Jahr. Dachte sind KOMPLETT	negative
@user @user rechts oben steht was. Direkt neben einem sch√∂nem Fernsehsender Logo.	neutral
Post rehearsal selfie cuz... Why not? #hoodie #vest #hoodievest #rehearsal #springawakening #hanschen‚Ä¶ http	positive
@user geballte Inkompetenz...	negative
RT @user: Jedesmal wenn irgendwo ein Mann seinen Bart rasiert, trocknet wo anders eine Muschi aus.	neutral
Schon August ey! N√§chsten Monat kommt auch #Hinterland von @user vor freude kommt aus meinem hintern land!	positive
@user Ich frage mich eher, wer so eine Frage √ºberhaupt stellt?!	negative
Mi√üfelder sieht keine milit√§rische L√∂sung in Syrien http	neutral
Ende N√§chten monats gibt's auch noch Weihnachtsgeld..also das 13. Gehalt :ooooo i'm rich bitch, i'm rich bitch, i'm rich bitch hahaha	positive
Tod des geliebten Haustiers: Trauerratgeber von Eltern f√ºr Eltern von Alfred F... http via @user	negative
Gro√üe #Ereignisse brauchen #Sendezeit: http #BP #ltw #gr√ºne_raus #fdp_raus http	neutral
"@user Ah! ""K√ºnstlerische Freiheit""! http"	positive
Na toll, jetzt will ich ne PS4. oo #GCPressekonferenz	negative
F√ºrth, wo alte Frauen Air Force tragen und Jugendliche lieber zu ausgelatschten Pumaschuhen greifen.	neutral
@user @user Sasa, Cynthia, Hong, jasmin und Ich w√ºrden auf jeden Fall kommen~ nicht wahr Sasa?	positive
#Miami Crash Victim: Partner Of 40 Years Died In My Arms: Crash Victim: Partner Of 40 Years Died In My Arms SO... http	negative
AEG Lavamat 72610: Fehlermeldung C9 http	neutral
Nacht.KRAFt: in 22, 2013 at 08!SOSOSOSOSO GUT!	positive
Warum muss K√∂ln so weit weg sein? )': W√§re sooo gerne an meinem Geburtstag zum Videoday gekommen! )': @user @user @user	negative
Anlage #Thun sichtbar gesetzt	neutral
sehr guter #tatort aus Berlin	positive
@user verr√ºckte welt...	negative
Sexy Damen Low Rise Jeans Hose Schlag Hose H√ºft Weiss. S/36 bis XL/42 Super Preis http	neutral
@user bin vielleicht etwas nerv√∂s .neue schwiegertochter wird vorgestellt :-)	positive
"Ick hoffe mein Akku h√§lt bis ick wieder zu Hause bin. Ick hasse Bus fahren ohne Musik. Berliner Schnauze kann ick wohl net so jut. ^^"""	negative
Havana Club Stoffbanner SELTEN: Axstedt | Original Havana Club Stoffbanner. Ma√üe 160x80. Sehr seltenes und rar... http	neutral
@user @user @user @user @user @user Very Cool!	positive
@user @user üò¶	negative
Wenn ich euch besuchen komme (Real Amateur) #porn #sexy #xxx #adult #amateur #nsfw #Amateur http	neutral
"RT @user: @user Ganz toller Auftritt im @user und herzliche Gratulation zum Titel ""Schwingerk√∂nig"" Alles Gute a‚Ä¶"	positive
@user nope. Basisdemokratiespinner stellen im Hinterland fast alle politisch Aktiven kalt. Bitte sehr.	negative
RT @user: NSA-Aff√§re: Britischer Premier steckte hinter Drohungen gegen den Guardian http	neutral
@user Produktiv Scheitern kann auch Spa√ü machen. Siehe Beispiele: http	positive
@user Hey kann erst sp√§ter schreiben! ;(	negative
Heinz ? Peters ? K√∂nig Rechtsanw√§lte aus 44629 Herne, Eschstra√üe 15 in #NRW http	neutral
RT @user: Muss mich mal wieder bei meinen Followern bedanken. Sch√∂n, dass Ihr mir folgt. Aber andersrum w√§rt Ihr ja sonst auch wiede‚Ä¶	positive
@user absolut! Fiese Scheisse.	negative
Scott 26: B√∂blingen | Gutes stabiles Scott Mountain Bike mit ein Jahr alter hi Felge http	neutral
@user @user Weil herzchen toll sind und auf chen enden und weil ich euch lieb habe ^^	positive
RT @user: Liebe FDP NRW, sorgt doch endlich f√ºr einen ordentlicen Grundrechtsschutz auf Bundesebene, statt nur Kryptopartys zu verans‚Ä¶	negative
Anlage #Spiez sichtbar gesetzt	neutral
RT @user: @user endlich fertig ‚ô° falls ich dich i.wann sehe bekommst du das bild. I love u ‚ô° ‚ô° ‚ô° http	positive
Hasse es, wenn Leute immer recht haben wollen	negative
@user Steht jedem frei zu unterschreiben oder nicht...	neutral
@user Tweet Limit/ Fav Limit auch DM Limit noch nicht xD	positive
deichkind entf√ºhrt! http	negative
RT @user: Das Gehirn kennt keinen Unterschied zwischen Traum und Realit√§t. Was hei√üt, dass beides real ist. Oder beides ein Traum.	neutral
@user Happy birthday! Alles Gute und bitte nicht aufs Alter schauen, wenn heute gefeiert wird! ;)	positive
Urgh, ich hab so Lust aufn Bier. Das ist so traurig.	negative
Franzosen behalten niedriges Renteneintrittsalter http	neutral
Unser Nachbars Hund :3 s√º√üer kleiner Kerl &gt;w&lt; http	positive
@user Keinen Bock mehr...	negative
@user In Lautern wars n√∂tig. Nach 39 Spielen.	neutral
@user √ºben √ºben √ºben - unter immer sch√∂n hinter den #creeps bleiben ;)	positive
RT @user: manche muss ma nd verstehen..	negative
Niedrige Zinsen bringen Deutschland 41 Milliarden Euro http	neutral
LOS PADDEL! SCHMEI√ü DICH RAN!	positive
Bei #SdR werden 4 Mercedes f√ºr 1 Zuschauer verlost. Nicht etwa 1 Mercedes f√ºr 4 Zuschauer. Sinn?	negative
Gesuender Leben durch eine bessere Wasserqualitaet ohne Kalk. http	neutral
Ach ich liebe @user 's Tweets ‚ù§‚ù§‚ù§	positive
RT @user: partnerschafte funktionieret n√∂d well d'mensche scheisse sind	negative
Romantisches Date ‚Äì Was geht da zwischen Jason Segel &amp; Cameron Diaz? http	neutral
Instandhaltung erfolgreich abgeschlossen!	positive
@user schraibn :o bin in letzter zeit viel mit anderen leuten am quatschen^^	negative
@user @user Zustimmung. Wird umso l√§cherlicher, je mehr sich uns eine aktuelle Regierungspartei prozentm√§√üig angleicht...	neutral
@user und wann sollte ich wo erscheinen? Bzw hat der @user die Frau nun um Erlaubnis gefragt? ;)	positive
Ich w√ºrde mir selbst nicht schreiben.	negative
Wettersensible Frauen ‚Äì Umfrage: M√§nner leiden seltener unter extremen Witterungsbedingungen http	neutral
Hahahaha Tr√§nen gelacht :'D http	positive
@user schade :( du h√§ttest den traum leben k√∂nnen f√ºr mich! :(	negative
@user @user nix da, keine Zeit zum Streiten, muss hier fertig werden	neutral
@user Naja dazu brauch man aber Titten! Die alten notgeilen Schachteln mit +60 will doch niemand! xD	positive
@user Dort h√§tte sich das Drehbuch schon fast von alleine schreiben lassen k√∂nnen, wurde aber wohl miserabel umgesetzt.	negative
"Wer meine ""all time favourites"" noch nicht gesehen hat: http http"	neutral
@user @user *lf* lass mich! :P des war echt so! hab immernoch dauergrinser *-*	positive
Guten morgen Welt. Hallo Montag ... 3 Kreuze, wenn diese Woche der Vergangenheit angeh√∂rt! ...	negative
Was war der letzte gute Film, den du gesehen hast? ‚Äî Sonic The Hedgehog The Movie OMV :3 geilster sonic film EVE... http	neutral
@user eueheueehuh, int (:	positive
@user wut	negative
RT @user: Wissenschaftler kritisieren unverst√§ndliche Wahlprogramme. Unser Tipp: Leichte Sprache http #wahllokal‚Ä¶	neutral
@user @user @user @user Gut befragt. Erkenntnisgewinn trotzdem 0. IMHO falscher Gespr√§chspartner.	positive
@user @user Warum wollt ihr alle keinen Sommer mehr haben? o_O	negative
@user Interessant wer nutzt nun #Tebartz #Luxus #Bischofssitz?;-) Viele #Katholiken nehmen auch #Auszeit sie TRETEN aus #Kirche aus;-D	neutral
Heute nicht nur den Herzensmenschen geheiratet, sondern auch ganz viel Liebe von @user bekommen. Unbezahlbar &lt;3	positive
Die Schuhe passen halt √ºberhaupt nicht!!! #ShoppingQueen	negative
EinFachIch !: Engel Gott Schicksal !! http	neutral
RT @user: @user 196. Tweet f√ºr Stindlinho! ;-) Happy Birthday &amp; alles Liebe, Lars! Bleib uns bitte noch laaange erhalten! #F√ºh‚Ä¶	positive
RT @user: @user Oh. Das er√∂ffnet ungeahnte M√∂glichkeiten des inz√ºchtigen Verhaltens sowie Ignoranz gegen√ºber den Followern.	negative
Der Streit um das VW-Gesetz http #DeutscheWelle	neutral
@user good morning	positive
@user unm√∂glich isser.	negative
Arigato !! Nur das, mehr nicht. Japanisch -,-	neutral
@user Du musst aber bitte Georg aus Bielefeld entfernen, der m√∂chte nicht mehr :-)	positive
Vor Wut 3DS ohne speichern ausgemacht. Sch√∂n.	negative
Was macht eigentlich ein Verm√∂gensberater, wie macht er es und v.a. warum braucht eigentlich jeder einen?! Diese... http	neutral
@user ohhhh meine schw√§chste Disziplin bisher ;))	positive
@user also das geht gar nich sowas. Bei ihrem Chef m√ºsste man sich beschweren. Die Frau soll ihr was beibringen u is so drauf.	negative
√ñH Uni Wien: Gegen rechte Hetze aller Art!: Utl.: √ñH Uni Wien ruft auf, Rechtsextremismus keinen Platz... http APA OTS	neutral
@user Du willst echt nicht bis zum Marathon warten, was? X'DDD	positive
mum hat mich grad gefragt ob ich schwanger bin und deshalb so schlecht drauf	negative
#Landau: Wer zahlt die Millionen f√ºr die #Bomben-Suche auf Gel√§nde der #Landesgartenschau? Hauptausschuss diskutiert. http	neutral
@user Qualit√§t*	positive
Papoose Versace Part reguliert ja schon n bisschen. Was da los :S	negative
chopper XV 250: berlin | Yamaha, XV 250, 13 kW, 45000 km, EZ 05/1991, rot, T√úV 05/2014, Sch√∂ner kleiner Choppe... http	neutral
@user @user sge nik pag ako nangulit tungkol sa inyo sge ka. Di ko kayo titigilan. Hehehe *ngisi*	positive
@user Englisch √ºberfordert mich,ich schreib lieber wieder Deutsch:) Ja ich mag Sprachen auch nicht	negative
40 Jahre Europ√§isches #Patent√ºbereinkommen ‚Äì Klare Abgrenzung zwischen #Sorten- und #Patentschutz wichtiger denn je http	neutral
Einfach nur ma kurz chillen http	positive
@user @user wenn mans genau nimmt nicht. aber begr√ºndung siehe tweet oben.	negative
Ok, letzter f√ºr heute: Grasgefl√ºster #Gr√ºnenfilme	neutral
@user bin selber fanboy,aber nicht ganz so fanatisch. hoffe ich. ;)	positive
@user iya. zombie survival horror, depressing seinen gitu.	negative
Schwerer Autounfall bei Anr√∂chte mit Toten. Geht‚Äôs euch allen gut?	neutral
Achtung Nagelstudios......Friseursalons......Kosmetikstudios......Fu√üpflege !!!Bei uns wird Zusatzverdienst und... http	positive
"Der Esel nennt sich immer zuerst. ""mich und die SPD."" #tvduell #Steinbr√ºck"	negative
30 neue Verfahren -Ermittlungen gegen ehemalige KZ-Aufseher http #30 #Nachrichten #N24	neutral
@user @user vordergr√ºndig.....;-))	positive
Tolles Vorbild, Herr Landtagsabgeordneter aus #RLP cc @user	negative
"Lincoln Speedway ""@user: Top 10- Wilt, Haas, D Dietrich, Rahmer, Montieth, Siegel. Krimes, R Wilson, Forsythe, B Dietrich"""	neutral
Boateng. Danke. Geh√∂rt mit zur Abl√∂se was?	positive
#schlagzeilen Designer-Kauz Colani: Funktioniert nicht? Interessiert nicht!: Sinkende Superboote, Lastwagen wi... http	negative
"RT @user: Aktueller Blog ""Das ewige Hinausschieben: Was hilft gegen Prokrastination?"" von Coach Gilbert Dietrich.... http"	neutral
@user geleakte technische details w√§ren nett, ne?	positive
2704 Tweets und ich bin immer noch kein St√ºck schlauer geworden	negative
#schlagzeilen Merkel soll auch: Steinmeier zu Aussage vor Kontrollgremium bereit: Frank-Walter Steinmeier will... http	neutral
Wundersch√∂n! Jetzt m√∂chte ich auch heiraten. ‚Äú@ApplebysCheese: Wedding cheese cake for vet Matt and wife to be Hannah http	positive
Da liegt nen Arm von einen der Affen o.O Da scheint wohl noch was schlimmeres rumzurennen o.O #AfterEarth	negative
"Mutter setzt Baby aus ""Bitte k√ºmmern Sie sich gut um sie"" - S√ºddeutsche.de: S√ºddeutsche.deMu... http #Muenchen #Munich"	neutral
@user Guten Rutsch http	positive
K√∂rper macht grad schlapp. Was soll das...	negative
Stephen Sauer zum neuen Finanzreferenten gew√§hlt #jusolakosaar13 Herzlichen Gl√ºckwunsch!	neutral
RT @user: OMG... ICH lache :-D RT @user: Hier endlich das GIF zum Ausparkman√∂ver des Jahres! http	positive
‚Äú@sanitario_: Ich bin so Schei√üe drauf, #ich #k√∂nnte #glatt #anfangen, #hashtags #zu #nutzen!‚Äù Dito!	negative
@user @user H√§ngt immer davon ab, wieviel Leute beteiligt sind.	neutral
Kleines M√§dchen, gro√üer Minion üò±üòä http	positive
Morgen in den ersten beiden #Sport. danach sch√∂n ne #Doppelstunde #Mathe hinterher. bis einschl. 8. Std Unterricht #k√∂nntkotzen	negative
"""Im Anschluss weitere L√§nderspiele, ebenfalls international"" - @user #gerpar"	neutral
@user ich komm gerade gar nicht hinterher! Bin auch sooo aufgeregt gerade. Berichte nachher. DAAAAANKE aber fuer die Glueckwuensche	positive
@user SCHNAUZE! Dass man dort links √ºberhaupt nich gut weg kommt, siehste nich, wa? (3 Jahre war dat mein Bus! 3!) @user	negative
Mercedes Benz arbeitet an Navigationsl√∂sung mit Google Glass http	neutral
@user na dann feier sch√∂n!	positive
@user ur ever gettin dem shits bacc	negative
Guten Morgen! Wir wollen euch noch erz√§hlen, was #Apple gestern in Sachen #iPhone erz√§hlt hat: http	neutral
Wie ich diese s√º√üen Kakao Kekse liebe... Eigentlich zu schade zum essen :/ http	positive
Hoodie Allen was sick	negative
tausche gro√üen, gut erzogenen penis gegen kopfschuss	neutral
"@user Das kann man ja hervorragend lernen. ""Navigieren"" muss halt echt gelernt sein - ich lasse mich von Sue Bryce inspirieren :)"	positive
@user Netter Versuch, aber: Nein!	negative
Beis beis beis, beis beis beis, un puta nobo nobo, ta cansa tur mi caya, beis beis beis, beis beis cu NEüé∂	neutral
@user Tr√§ume s√º√ü :-)	positive
Dank investigativem Journalismus konnten wir herausfinden, dass man f√ºr das Update auf Windows 8.1 zuerst ein Update installieren muss. Aha!	negative
. @user pro Staubsauger-Regulierung. Ich glaube nicht, dass er das ernst meint. Das kann nicht sein. http	neutral
ich lieeeeeebe diesen tanz :)) aba den salto krieg ich zum verrecken einfach nicht hin sorry x'DDDD	positive
#understatement: sein goldenes iPhone in ne silberne H√ºlle packen.	negative
Kreativ Welt News Allerheiligen, Freitag, 1.11.2013: In Hessen kein Feiertag! Alle Besucher/innen aus... http	neutral
Wowereit gratuliert Horst Milde zum 75. Geburtstag Berlins Regierender B√ºrgermeister Klaus http http	positive
phil verstellt sich f√ºr seine freundin. kann ihn nich mehr ernstnehmen.	negative
@user hmmm, k√∂nnte sein. Bin mir da nicht sicher	neutral
"""live aus manchester"". technik k√∂nnen sie beim #zdf #mcfcfcb"	positive
@user OMFG BITTE NICHT! Noch mehr Infinite Crisis h√§tte meine inneren Katzenbabys get√∂tet. ..und zwar ALLE!!	negative
New post: Warum Nikon Telekonverter nicht mit DX-Objektiven verwendet werden k√∂nnen http	neutral
Leckeres kleines Ding du! #knabber #igel http	positive
'Und was nehmen Sie?'- 'Ich nehm dann mal die traurige Wendung.'	negative
"tz: Schweinsteiger als ""Fu√üballer des Jahres"" geehrt: M√ºnchen¬†- Bastian Schweinsteiger ist kurz vor seinem 300... http"	neutral
@user nimm doch den Besen und reite los ;-) #hexhex	positive
RT @user: @user ich bin doch gar nich unterwegs‚Ä¶!	negative
Okay friends ich geh schlafen und ratz bis ungef√§hr √ºbermorgen, bonne nuit	neutral
#nowplaying die neue Scheibe von Someone¬¥s Diary http Yuppiduppi! Aber das sagte ich ja schon mal ...	positive
ja alsich 2wochen weg war dawar dann so viel von M&amp;L so viel musste ich nachholen (@user http	negative
New post: H: Zeugenaufruf! 21-J√§hriger √ºberfallen http	neutral
@user Entspannt geht's los. Sch√∂nen Tag g√∂nn ich uns allen :-D @user @user @user @user	positive
@user GENAU DAS SELBE DENK ICH MA AUCH haha bzw. solln in einen ladn gehn bei dem ma den namen aussprechn kann!!	negative
RT @user: @user #HeidiKlumbittegr√º√üeOneDirectionvondeutschenDirectionern bitte tu uns den gefallen &lt;3	neutral
RT @user: Endlich durfte ich mal ran :-) http	positive
@user Sigh!	negative
@user K√∂nnte auch eine Landstra√üe mit Mikrokreisverkehr sein.	neutral
@user TE AMO	positive
@user  - w√ºrde ja auch wieder lieber gerne ne lohnt√ºte haben. #goodoldtime seufz	negative
Nun gut, argumentieren wir weshalb der Schutz von Daten wichtiger ist als der Schutz vor Terroranschl√§gen...	neutral
@user @user @user @user @user dass ich erleben darf, dass du sowas verteidigst. K√∂stlich.	positive
@user Prima ,was sind das f√ºr Idioten im DFB?Das is eine Muppetsshow auf LSD!Das is noch lange nicht ausdiskutiert!Kie√üling ist ein Depp!	negative
#Cancer causing #Foods. Avoid it. #Krebs f√∂rderndes Essen. Besser meiden. http	neutral
@user Lieber Gru√ü an unsere Freunde in Polen aus dem Norden #Deutschland #Ostholstein	positive
Bosan sungguh kelas english nie . Haihhhh -,-	negative
Lesson learned: Feministinnen d√ºrfen bei Meinungsfreiheit,Rechtsstaat, Zensur, Lizard, Spock nicht mitspielen. Mehr Baumhaus als Bundestag.	neutral
@user Ihr geh√∂rt nicht zum besten Bundesland! Ha!	positive
Ach verdammt. Nich gro√ü genug! -.- (@user http	negative
In 10 Tagen hei√üt es wieder Back to school, deshalb haben wir f√ºr Eure Kids die neusten Herbsttrends! http	neutral
@user oh...wie liebensw√ºrdig	positive
RT @user: @user @user @user @user @user Schlimm genug!	negative
#Entwicklungsland #Schweiz? Laut Grafik punkto #Datengeschwindigkeit deutlich unter OECD-Schnitt http via @user	neutral
@user @user kommt mir merkw√ºrdig bekannt vor :-)	positive
RT @user: @user #Belieber k√∂nnen ma meinen vollgeschissenen Arsch lecken &lt;3 #JenaWillAuchStressHaben	negative
Familie in Chelsea sucht Kindermaedchen: Nette Familie in Chelsea mit 2 kleinen Kindern (3J und¬†1,5 Jahr) such... http	neutral
Hhmmm... dieser einzigartige Tee aus Europa... also von den Azoren... der schmeckt so lecker http	positive
My Top 3 #lastfm Artists: Tomte (54), Queen (24) &amp; Einst√ºrzende Neubauten (22) #punk http	negative
@user 'vergessene', 'fl√ºgel', 'genau', 'kleine', 'laufen'......	neutral
"@user War ziemlich geil, leider keine ""Carter II"" Sachen gespielt, daf√ºr Birdman dabei gehabt :-))))"	positive
Die deutschen Dialoge sind so viel schlechter! #underthedome	negative
"Kommentar: Aufstand der ""Alten"" um Hundewiese in Hamm http http"	neutral
Wusste gar nicht, dass #assange so gut singen kann ;) #oz #downunder ‚Äú@sir_pepe: Wa... was zum? http	positive
@user Echt ungewohnt. o.o	negative
"Merkel: ""Pensionen werden versteuert, Renten nicht."" Renten werden aber mit immer h√∂herem Anteil versteuert."	neutral
@user faszinierend, nicht wahr? :3	positive
Weniger als 2 Stunden geschlafen in diesem Sinne guten Morgen	negative
"RT @user: Kein Witz: ""@user: Sanktionen gegen Nordkorea: Schweiz stoppt Skilift-Lieferung an¬†Kim Jong Un http"	neutral
@user davon bin ich √ºberzeugt! ¬§_¬§ @user	positive
Nadie me escribe ok	negative
27.8.: Treff 17.30 Katzwang und dann 18 h Schleuse. Ab hier getrennt nach Nachwuchs mit Trainerprogramm oder individuelle Lang-Ausfahrt.	neutral
@user dankesch√∂n!*-*	positive
Hoffentlich lah !! Schei√üe !! http	negative
RT @user: @user @user @user @user @user @user  uzta nah..?	neutral
Der Tisch &lt;3 :D #LPTLive #Elektrotitte @user	positive
25 Jahre h√∂rt sich irgendwie schon echt alt an. Langsam komme ich auch in den Bereich, wo man sich nicht mehr √ºber's √§lter werden freut.	negative
@user Hast du das neue Rozen Maiden inzwischen mal weiter geschaut?	neutral
@user Tr√§um romantisch unter einem Himmel voller Geigen ‚ô•	positive
@user fand's √ºberhaupt nicht erfrischend. Langweilig war's	negative
Mehr Monster gegen (das arme) Tokyo: http http	neutral
@user auch voll geil mit nem Spezialflieger aus Mallorca zur√ºckgeflogen werden.	positive
Ik ben echt klein oh god...	negative
@user ausgeglichen	neutral
@user l√∂sch schnell 3 :'D	positive
Ieh, lauter gl√ºckliche P√§rchen hier... üë±üî´	negative
@user @user Nein das z√§hlt nicht! Weil er zum Zeitpunkt der Deadline einen Verein hatte...	neutral
@user @user @user @user @user @user @user @user #Glee Was Amazing Tonight	positive
@user Au√üerdem zeigt Wattpad all meinen Facebook Freunden nun an wenn ich f√ºr eine Story vote. Das war vorher auch nicht. -.-	negative
Frankfurt und Potsdam an der Spitze http #fu√üball #bundesliga	neutral
@user zurecht!	positive
@user Manch einer entscheidet lieber vom Schreibtisch aus, wer sich bittesch√∂n wovon diskriminiert zu f√ºhlen hat, ganz ohne Nachfrage.	negative
"@user Dear Chefredakteur, habe Dir bei FB ne Mail wegen eines Interviews geschickt. Guckste unter ""Sonstiges""? Danke!"	neutral
@user nicht wenn man aus Prinzip den Club als Meister nennt :D	positive
@user Verst√§ndlich, da den armen Plakaten so viel niedertr√§chtige Gewalt angetan wird. Mir kommen gleich die Tr√§nen! #afd	negative
@user ja!	neutral
*in kreischenes Gel√§chter ausbricht* *rumschreit* *quiekt* *einfach nur laut ist* XDDDD LEVI!!! XDDDD	positive
Welches Geschenk hast du zuletzt bekommen? ‚Äî Eine Bettdecke o.O http	negative
Facebook bei Jungen News-Medium Nr. 1 - http	neutral
Ach, das passt dann nat√ºrlich auch ganz super dazu. Gnihihi #lasttweet http	positive
S√∂ll ich ez h√ºt echt na ad MFW?	negative
Potential programmer metal band name: H√ºbris	neutral
@user ach was... darauf w√§re ich jetzt gar nicht gekommen xD	positive
Macht mal hinne hier! Meine Supernatural Folge wird kalt. #tvduell	negative
die kleine h√∂rgalerie has phone number +49 7721 9167016. Call now or check http #KLEINE #VILLINGENSCHWENNINGEN	neutral
@user @user jetzt gegen chelsea und dreckszecken spielen wir zu hause, mit unserer unterst√ºtzung wird die abwehr nicht wackeln	positive
Bitte halt einfach die Fresse!! #schwiegertochtergesucht #sg @user @user	negative
@user unterdr√ºckt	neutral
OMG! Diese Videos sind so gro√üartig! http	positive
Nicht so in Stimmung f√ºr Twitter.	negative
Feinjersey Leoparden-Muster grau http sch√∂ne italienische Ware!	neutral
RT @user: #gamescom war megahammer, aber das absolute Highlight: ZOO TYCOON! ZOO TYCOON! ZOO TYCOON! #xboxgamescom	positive
RT @user: Deprimierend... #king #kings #queen #queens #k√∂nig #k√∂nigin #herrscher #ungerecht #unfair #life #leben‚Ä¶ http	negative
passiver bi mann: Schutterwald | bi mann 54 170 75kg sucht aktive m√§nner (nicht zu jung) 9 http	neutral
... Gl√ºck breitet sich aus ...	positive
@user Ja, absolut zum Kotzen! D:	negative
Uns alle hier nie finden k√∂nnen @user @user @user @user @user @user @user @user,sch√∂nen Mittag	neutral
mein Bruder kitzelt mich weil er wei√ü das ich kitzlig bin aber ich kann mich nicht wehren weil er sowas voll wegsteckt :-----)	positive
Arbeitsmarkt: Tausende Jugendliche finden keinen Ausbildungsplatz http	negative
Portugals Verfassungsgericht kippt erneut Sparvorhaben http	neutral
Genial @user zeigt ab Ende Oktober #HardKnocks #trainingscamp #amfootball #ischgefreimir	positive
RT @user: Eltern die Masern/Windpocken/R√∂teln-Parties f√ºr Ihre Kinder machen sollte man mal auf ne Tripper-Party schicken.	negative
Wer alles kann, muss alles machen. Kennen Sie die #Geheimnisse erfolgreichen Delegierens? http	neutral
"Am Samstag wird wohl der ""All You Can Eat"" Chinese zusammen mit @user ungl√ºcklich gemacht. ^^"	positive
W√ºrde gerne einmal aufwachen ohne Kopfschmerzen, Halsschmerzen, Bauchschmerzen, Gliederschmerzen... doofen Gedanken.	negative
"OFFIZIELLE KORREKTUR/'HB': L√§nder erzielen erstmals seit langem √úberschuss: (Das ""Hande... http http"	neutral
@user OMG DAS W√ÑRE SOOO GEIL ME TOO ganz gut war uni.die haben uns alles wichtige geb√§uden gezeigt&amp;grad gym dir sweetiii??	positive
@user Nicht sch√∂n - hast keine passenden Medi¬¥s daf√ºr?	negative
#Berlin Zwei Festnahmen bei Razzia: Friedliche Demonstration http	neutral
RT @user: Dich mit meinen Worten verw√∂hnen. Bis dann endlich Taten folgen werden. #22UhrNonMention	positive
@user @user @user :/ (will mich nicht einmischen finde das aber traurig) Sagt wenn ich nerve, ja?	negative
GR√úNE Energiewende - Sauber, Sicher und Sozial: http	neutral
@user @user @user Danke!	positive
RT @user: Dramatisch: Gigantische Mac OS X Sicherheitsl√ºcke http	negative
Diebe im Haus: +++ Falkensee: Schmuck gestohlen +++ Landkreis Havelland: Mehrere Wildunf√§lle +++ L ... http #Havelland	neutral
Zweiter Anlauf: Rendern geschafft.	positive
Da hat wohl jemandem der Snack nicht geschmeckt #berlin #street #food #burger http	negative
Zwei nette kleine Damen auf dem Weg nach Norden #veranstaltung http	neutral
@user Alle Beleidigungen sind f√ºr den kleinen Alex unzutreffend! *inpenispanikgerat* X)	positive
RT @user: Jols F√∂hn bl√§st schlecht.	negative
Europ√§ische Mitgliedstaaten ‚Ä¢ Re: Kroatien: Rechtsbr√ºche nach dem Beitritt http	neutral
Guck mal, Matthias, was ich so sch√∂nes zum Geburtstag bekommen habe... ;) http	positive
Wenn ich mrinen Freund nicht h√§tte, ne......R.I.P Caro.	negative
"Zeitloser Reply-Bearbeitungsklassiker ""Stern dran, erledigt""."	neutral
A Golden Star Was Born Today @user my golden star	positive
@user vielleicht k√∂nnen Sie Sch√§uble mal mit seinen Griechenland-Aussagen vom 7.10.12 in #berlindirekt konfrontieren? @user	negative
Sitzt oder steht grad jemand neben jakob glaser ? # dringend	neutral
Daf√ºr ist #FranzFerdinand 's Right Thoughts, Right Words, Right Action herrlich retro (und kein bisschen lahm) :))))	positive
@user ja. und sie tut immer noch so, als ginge uns das Team Stronach was an	negative
Samsung Galaxy SIII GT-I9300 blau 16GB *DEFEKT* ohne Garantie ohne Akku http	neutral
@user keine freunde haha:D handy zu weit weg,_.	positive
Wenn AE unter Mavericks laufen w√ºrde... :(	negative
@user @user Google translate kann mir grad nicht helfen.. Daher... WAS?!?!	neutral
Fr√∂hlichen Montag! http	positive
@user Muss echt nicht sein...mag trotzdem den Account wissen O:)	negative
leidenschaftliche Aff√§re #kurzgeschichten	neutral
meine handyuhr geht nach koreanischer zeit... and i'm not even confused. 8D	positive
Wie k√∂nnt ihr das mit Teds Frau so feiern? DIE FOLGE WAR SCHEISSE, S C H E I S S E !	negative
@user eso	neutral
"""Geht der Rei√üverschluss auf?"" ""Ja ¬∞o¬∞"" ""..Krieg nicht auf..."" "".....achso, du meinst GANZ?!"" .... |D"	positive
Was macht die √Ñrztin denn da drinne?!?!?!	negative
@user Also stabil, nicht leicht zerbrechlich, stark?	neutral
RT @user: @user DIVERSITY kommt endlich!! wir freuen uns...that¬¥s great ‚ô´	positive
Wow! Welch LUXUS... heute erst 13 Stunden durch gearbeitet.... ;-)	negative
Friedrich wurde zum Iserlohner ernannt: Reinhold Friedrich feuerte am Ende eine sensationelle Solo-K... http #Iserlohn	neutral
"Gestern wurde in unser B√ºhnenbild eine ""kleine"" Bodennebelmaschine eingebaut... rockt! // Our stage just got a... http"	positive
@user da dachte ich mir, was kann schon passieren, dann aber nachgedacht, was er alles einstellen k√∂nnte und so.	negative
Wo kommt Muttis Kette nat√ºrlich her? Aus Idar-Oberstein :D	neutral
@user Ach ja, ich wollte dich ja auch nicht mehr √§rgern! ;) Ich freue mich auch schon auf Freitag! :)	positive
@user l√§cherlich! #skybuli #H96HOF	negative
sms kontakte Sandra (22 Jahre) aus Bayern sucht einen Mann, im Alter von 24 bis 35 Jahren f... http &lt;&lt;&lt; sms klick hier	neutral
RT @user: Gemeinsam erfolgreich !! @user @user @user #btw13 #cdu #merkelintrier http	positive
Und Rap hat mich nicht immer gl√ºcklich gemacht.  #Gangster	negative
Guten morgen. Ich hab Hunger. Alle man in Deckung.	neutral
RT @user: Perfektes Festivalwetter. Abflug! #BerlinFestival starts now! Bastille, Mia., Get well soon, Pet Shop Boys, Blur. Was ein Lineu‚Ä¶	positive
Leider muss ich morgen wieder knechten, sonst w√ºrde der True Blood-Nachmittag vielleicht eine True Blood-Nacht.	negative
Bezahle weniger fÔøΩr #2 #TB #Samsung #Barracuda #festplatte Beste Preise ansehen http #fb	neutral
die neue Folge muss heute einfach sein !! #heisenberg #breakingbad	positive
@user Leider nein. Meine Cousinen aus √ñsterreich sind auch ganz entt√§uscht. Kai Uwe schl√§ft wohl schon.	negative
@user als was muss man sich eigentlich bewerben um den ganzen tag nur Zeitungen lesen zu k√∂nnen?	neutral
Fliege tot.... Panda gl√ºcklich #nervigesDing	positive
RT @user: Unfassbar! #Vattenfall-Chef Hatakka: Energiewende untersch√§tzt, existenzielle Krise, Ausbau Erneuerbarer stoppen... http	negative
RT @user: Nach Mord an jungem Russen: Neonazi-Mob hetzt Migranten in Moskau. Presseschau:... http	neutral
@user :-D :-D :-D :-D :-D :-D Sorry, Andy, aber der war gut! #Wer denSchadenhat @user	positive
@user Haupts√§chlich selbsthass.	negative
Gelungene Revanche ...... http	neutral
RT @user: Ayyee girls (; @user @user @user	positive
got sei dank nur merkel schlimmer w√§re steinbr√ºck u konsaorten diese genossen reiten uns mit schwung noch tiefer... http	negative
Bossti und die Community bauen gemeinsam popul√§re Geb√§ude aus Hogwarts nach. Seid live dabei oder helft selbst... http	neutral
@user @user guten nacht ka! Please reply my mention hehe	positive
Lol, wut? Reinstalling Dropbox made my GPU hang.	negative
@user frei nach H√∂hner: Wenn nicht jetzt, wann dann?	neutral
RT @user: so jetzt aber nochmal richtig daumen dr√ºcken f√ºr @user ... beim dritten mal muss es doch klappen mit dem sieg #LPP	positive
Rott in Hell Saudi-Bastards!!! Verreckt ihr verdammten Saudis!!! http #SaudiArabia #SaudiArabien #USA #Katar #Quatar	negative
Experten liegen Beweise daf√ºr vor, dass Bilder der Opfer des Chemiewaffenangriffs in Syrien manipuliert wurden http	neutral
Max Meyer kann sich diese Saison berechtigte Hoffnungen auf Eins√§tze im offensiven Mittelfeld machen #S04 #bundesliga http	positive
@user alk gibt's bei uns nicht Ehefrau sw Depressionen.Vorletzte stufe. Alk Btm Tabletten. Letzte stufe Suizid. Alles muss bedacht wer	negative
18 tlg. WMF Besteckset Boston aus 18/10 Edelstahl f√ºr 39,95‚Ç¨ frei Haus http besser als #sparwelt	neutral
@user whatz Good Fooly Need Sum Bangerz Get@Yung Phy	positive
RT @user: @user ... u wieviele d in Zellen u Krankenzimmern sitzen,sitzen dort z Unrecht u bekommen nicht d Aufmerksamkeit wi‚Ä¶	negative
Darren, Fabian und Alex haben erfolgreich das Summer Breeze 2013 √ºberlebt! Der Restalkohol ist so langsam aus den... http	neutral
"@user achso, na gut... bist aber gern eingeladen Dir unser ""neues"" Seenland mal genauer anzuschauen :)"	positive
Dieses grau in grau da drau√üen macht mich feddich &gt;.&lt;	negative
Messersch√§rfmaschine Diamant Fa. Graef Neuwertig,aus Konkurs: Meeder | Ich biete hier im Auftrag eine hochwert... http	neutral
Heimweg, dezent tot, obwohl fr√ºh.	positive
RT @user: Video: freiheitsboot: atari teenage riot - 1. mai 1999 berlin warum bin ich so jung und konnte nicht dabei... http	negative
Alles unter einem Dach: Innovatives Energiesparpaket neu am Markt http #apa #ots #bot	neutral
@user bisher beschr√§nktes Meme-Potenzial http @user	positive
iyo nah lah nak meledak :'( @user Kangen. Kangen. Kangen. Kangen. Kangen. Kangen. Kangen. Kangen. Kangen. Kangen. Kangen. Kangen.	negative
Heftiges PVP-Gefecht in Immortalis bis 10 Uhr! Wir brauchen jeden f√§higen K√§mpfer! #Immortalis http	neutral
@user oh klingt viel versprechend *daumendr√ºck*	positive
stand der dinge: 10 h√ºhner 1 hahn kein ei auslauf wird morgen fertig polly abgeh√∂rt keinerlei atemger√§usch mehr	negative
@user @user @user kannst du ihm nicht einfach betrunken eine SMS schreiben mit diversen Beleidigungen?	neutral
"""@user: Die @user wurde geblitzdingst hihi ^^""eben nicht :)"	positive
Vorsicht Horror pur...:( http http	negative
Aktien Frankfurt Er√∂ffnung: Dax leicht im Minus http ARIVA #B√∂rse	neutral
@user /detailnazi Abgesehen davon: WUNDERH√úBSCH *A*	positive
@user slowwwwwwwww	negative
Dropbox: Sicherheitsforscher entschl√ºsseln Quellcode #servaholics http	neutral
Eeeeeeendlich! Tooooooor Caps! Kevin Puschnik erl√∂st uns von dem Fehervar-Torbann nach 75 Saisonminuten #vicavs 1:0	positive
Talente: Tumblr, Internet, allein sein, nerven. http	negative
Hannover/Region: Show: Sicherheitsfestival setzt Ma√üst√§be http	neutral
@user ne FUN nat√ºrlich schaffst du das :D	positive
Auf was f√ºr absolut bescheuerte Ideen Menschen kommen. :/ #lastRT	negative
Bei √úbernachtung, Mord!... #reise http	neutral
RT @user: Was rihmt sich auf Bavaria ? STOLZ !!!!!!!!!	positive
@user Gro√üe scheisse! X)	negative
@user Die spielen nicht im Prenzlauer Berg? | @user	neutral
Folgt, verbreitet, unterst√ºtzt @user @user @user @user	positive
@user Mord? Selbstmord? Erf√ºllung? Illussion?	negative
Photoset: subtilitas: Bearth &amp; Desplazes -¬†¬†Gantenbein Winery, Fl√§sch 2008. Photos (C)¬†Ralph Feiner. http	neutral
RT @user: Finde Raabs naive Art, nachzufragen super! #tvduell	positive
"@user bissl beruhigen, bei der n√§chsten Beleidigung a la ""Idiot"" usw. probieren wir die neue Twitter-Funktion aus."	negative
Plakate/Print sympathisch, elektronische Medien st√∂rend! Ein m√∂glicher Grund f√ºr Gap Nutzer-/Werbemarktanteil?! http	neutral
whoops endlich bestellt ^^	positive
Abstieg 2013. #VfB #aufbruch1893	negative
RT @user: St√§dteboom gef√§hrdet Mensch und #Natur http #CSR #Nachhaltigkeit #Megacity #Politik	neutral
Er redet byrisch *O* Ich lach mir den Arsch weg :'D	positive
echt behinderten Anime gefunden ...O.o	negative
Emotionen respektieren, wehrhafte Zivilgesellschaft legalisieren.	neutral
@user Und, auch wenns sich komisch anh√∂rt, blaue Dinge angucken. Die Farbe entspannt das Auge. :)	positive
@user ich ritz' dir meinen Namen ins Gesicht mit na' scharf geschliffenen Visacard!!	negative
@user japp, kannst du. Schau einfach, dass keine Seife reinkommt	neutral
@user @user Gl√ºckwunsch!!!	positive
Seit fucking 8 Monaten und anstatt das meine Gef√ºhlte dir gegen√ºber weniger werden, werden sie Tag f√ºr Tag immer mehr.	negative
"Heute unter ""Photografix Fotoprojekte"": Nordeurop√§ische Landschaften von Dennis Polkl√§ser! Reinschauen lohnt sich! http"	neutral
RT @user: 36 Grad. Feierabend. Wochenende. Urlaub. Gleich vier gute Gr√ºnde, um gleich betrunken am Pool zu liegen.	positive
Was ihr labert, ey. Mein WhatsApp ging die ganze Zeit. Ihr habt‚Äôs einfach nicht drauf.	negative
#Schorsch's Haustrunk, Lager Name, langer Abgang, lecker. #Biertest http	neutral
\o Leute, die dunkle Variante Guten Morgen Ach fu Schlimmster Ohrwurm ever.	positive
Idiot.HAHAHAHA AHAHAHAH OMG VERPISS DICH War kein Witz.	negative
Funkwerk AG: Weniger Umsatz, besseres Ergebnis http	neutral
Restpizza schmeckt kurz vorm Schlafen gehen immer noch am Besten.	positive
RT @user: Ich w√ºnschte, √ñzil w√§re kein Deutscher. Dann w√ºrde er wenigstens gesch√§tzt werden.	negative
Tritt bei Sonic Dash gegen mich an! #SonicDashmmm http	neutral
@user liebste gr√ºsse aus hh, katja xx	positive
Passend zu allem auch noch Kopfschmerzen. Fuck that shit.	negative
Sie wird zum sexy Nerd ‚Äì Hot or not? Rebecca Mir mit riesiger Brille http	neutral
"Privatkino mit 5 Sternen: ""Das beste Buch des Jahres"" http"	positive
@user -.- Echt schlimm!	negative
Hansa √ñlbrenner: M√ºnster-Sarmsheim | Hansa √ñlbrenner, Bj. 2000, 12-42 KW, lief einwandfrei bis Ausbau vor einem Jahr. http	neutral
@user lmao xDDDD glaub keiner fand die gut (au√üer er vllt)	positive
' Ich lasse ihn noch nicht ran. Aber bald. :3 ' - Und nun ist mein kleines Herz wieder in tausend St√ºcke zerfallen. Danke. (:	negative
@user ok. Bin jetzt dann hernach gleich nochmal weg, aber schreib ruhig.	neutral
Komisches Gef√ºhl .. Dieses flauen im Magen vergeht aber auch nicht .. Hunger war das definitiv nicht :D hab ja heut ganz gut gegessen üòÅ	positive
Dieses 0Punkte Gerede nervt jetzt schon.Diese Austria wird in jedem #Cl Spiel ihre Chancen bekommen.Effizient sein dann geht gegen jeden was	negative
Bayer HealthCare: Aspirin Sozialpreis: Innovative gemeinn√ºtzige Gesundheitsprojekte gesucht (BILD) http	neutral
MAD schrill, schr√§g &amp; crazy Fotos sind online. Viel Spa√ü beim anschauen! LG PEARLS &lt;3 http	positive
@user heey na voll schei√üe konnte heute nicht Zahnarzt...üòî	negative
@user Oberfl√§chewasser Neubaugeb. Scheid kommt unter unserem Silo hoch unsere K√ºhe sind vergiftet Verkaufer=Ortsburgemeister mobbt 1/2	neutral
@user kann dich echt gut verstehen bin leider auch Erk√§ltet. Gute Besserung	positive
"""Wenn Auto zu teuer ist dann nimm doch roller!?"" - ""√§h neee dann doch lieber Bus oder laufen"""	negative
Eigene Kinder sind vielen Deutschen einfach zu teuer @user #kinder #familie #karriere http	neutral
Mr Fahrenheit 'Ich f√ºhl mich gut ich steh auf #Berlin' #streetart Dircksenstr. #mitte #wheatpaste‚Ä¶ http	positive
Hoffnungslos verlegen.	negative
Foto: dem0nscanswim: Breaking point @ camden underworld (LAST SHOW) 19/10/13 http	neutral
#chillen #mit #dem #besten #freizeitbad #Greifswald #FreizeitbadGreifswald #spa√ü #chillivanilli #hihi (: http	positive
@user kann man leider nicht ;(	negative
Wenns jetz pls nicht regnet w√§hrend des Spiel danke	neutral
@user Hammer Konzert Gestern:):):) Gibst denn davon auch bald ne DVD???	positive
@user oje klingt aber sehr schlimm:-(	negative
RT @user: M√ºssen dann eigentlich auch alte Schlager umgetextet und neu eingesungen werden? Sinti-und-Roma-Junge, Sinti-und-Roma-Jun‚Ä¶	neutral
Erfolgreich geduscht!	positive
"Diese ""Grind on me""-Vines sind nicht geil. #Fakt"	negative
kleines Wappenhemd schwarzer Ritter: Dieses schwarze Wappenhemd aus Baumwolle wurde speziell f√ºr unsere kleine... http	neutral
@user @user @user echt he, arme tim hahaha	positive
mann war die welt noch sch√∂n, als nicht jede zweite webseite von europa aus nicht abrufbar war... will doch nur magi illegal gucen XD	negative
@user @user hab den tweet gel√∂scht, falls fragen einfach nochmal melden	neutral
"@user: Ich war bisher nur bei ""Bar 'n' Burger"" im Templergraben. Lohnt sich mal hinzugehen, war vernuenftig."	positive
RT @user: ‚ñ∫ HALF-LIFE 2 (CINEMATIC MOD 13) #009: Die T√∂dliche Falle an Gate 5 ‚ñ∫ Auf gronkhDE: http ‚ñ∫... http	negative
ahre ahre ahre ahre ahre ahre ahre ahre ahre ahre	neutral
Bestes Gef√ºhl der Welt: Schuhe aus, barfu√ü laufen	positive
@user Moi???? @user @user @user @user	negative
Einfach nicht unterbrechen lassen. #TVDuell	neutral
Was zum Lachen am Abend! (Jimmy Kimmel Lie Detective #1) http	positive
( Eigentlich ein guter Tag, um eine Deadline nicht zu schaffen... )	negative
SG Egels-Popens unterliegt TuRa Westrhauderfehn verdient mit 1:2 Toren http	neutral
@user gro√üe katastrophe :P	positive
@user leider so...	negative
Offen, aber skeptisch http #Deutschland	neutral
Aus dem betz geflohen..der liebste schnarcht gg	positive
@user Garantiert nicht..	negative
Geduld verloren: nach erneuten Verlusten muss #Vestas-Chef Engel gehen http #Wind	neutral
@user bittesch√∂n meine prinzessin immer wieder gerne lieb ankuscheln	positive
@user @user @user pssst!	negative
Premium Audio Marken Shop: Elektronik &amp; Foto online bei Amazon.de einkaufen http via @	neutral
@user Guten Morgen! Gem√ºtlich Fr√ºhst√ºck u dann los in den Tag:-)))	positive
@user Aber verstehe ich. Demos k√∂nnen mitunter etwas Beklemmendes haben.	negative
dpa-Nachrichten√ºberblick Wirtschaft http	neutral
@user @user wundersch√∂ne Farbe‚Ä¶ sowas darf nicht LE sein‚Ä¶	positive
Pascal nannte mich gerade Standgebl√§se... NEIN! EINFACH NEIN!	negative
150.000 Muslime feiern in Moskau Ende des Fastenmonats &gt;&gt;&gt; http	neutral
"Nachrichten m√ºssen Spa√ü machen: Will Ferrell und Harrison Ford im neuen Trailer zu ""Anchorman 2"" http"	positive
RT @user: Im Zug auf die Toilette gehen ist widerlich. Einfach nur widerlich.	negative
Apple-Designchef gestaltet goldene EarPods http #Ger√ºchte	neutral
Me&amp;My Fluff Monster! #shihtzu #livinlife #loveher http	positive
Kein Schwein ruft mich an, keine Sau interessiert sich f√ºr mich.	negative
Advocaat trainiert AZ Alkmaar: Dick Advocaat wird neuer Trainer des niederl√§ndischen Erstligisten AZ Alkmaar. ... http	neutral
RT @user: K√ºsschen oben, K√ºsschen unten.	positive
Absolute schei√üe ne halbe Stunde zu fr√ºh aufzustehen -.-'	negative
"Gute Idee: Von Hornstein: ""Wer sich beschwert, muss als n√§chstes ran"" http"	neutral
@user liebe gr√º√üe an jemanden ;D und macht nicht zu dolle ;D	positive
RT @user: Habe geh√∂rt FRau #Merkel bricht schon ihre Wahlversprechen:Strom wird teurer, Abgasnormen werden erh√∂ht, Lobbyspenden werd‚Ä¶	negative
Berlusconi erstmals rechtskr√§ftig verurteilt http	neutral
@user Ein ziemlich geniales Werkzeug f√ºr lau. Daf√ºr kann man Werbung schon hinnehmen, finde ich.	positive
Ach scheiss Gleis 2 macht l√§rm! Will penne ._.	negative
RT @user: pv magazine Deutschland: BUND: Politik muss EEG-Angriffe stoppen #ewschrei http	neutral
Jesse eisenberg üòçüò≠‚ù§!!	positive
Unn√ºtzes Wissen! http	negative
POL-ROW: ++ Vertrauen verspielt ++ Teure Arbeitsmaschine gestohlen ++ Spanngurte gerissen ++ Einbruch in Blumenladen http	neutral
‚Äú@ibieberschwag: #AllThatMatters http	positive
#windows8 sucht hier ~15 Minuten nach Updates, bis dahin h√§tte ich ihm die URL auch gem√ºtlich abtippen k√∂nnen dem bl√∂den Ding.	negative
Pele glaubt, dass @user Ende wird besser als @user und @user Sind Sie im Einvernehmen mit dem K√∂nig? #W√∂chentlicheUmfrage	neutral
@user okaaaaay, dann brauch ich kein schlechte gewissen zu haben. :3 cheonma. ‚ô•	positive
@user Email best√§tigen? REICHT NICHT! Bezahlen? REICHT NICHT! Captcha Code als Beweis? REICHT NICHT! Bild mit Pass, Jetzt ist ok.	negative
#Frauen zum Heiraten aus Baden http	neutral
Happy Birthday ihr gl√ºcklichen im-Sommer-Geburtstag-Habenden. Nur kein Neid ;)	positive
Gr√∂√üeres Pr√§sidium, gr√∂√üeres Kabinett #GroKo janz gro√ü. @user @user Was fehlt: L√∂sung gro√üer Probleme.	negative
EWR-Beitritt w√ºrde ¬´delikate Fragen¬ª provozieren http	neutral
YES! Ich werd bekloppt. Klasse Leistung #DBB #wahnsinn #durchgeschwitzt	positive
Noch irgendwelche VERN√úNFTIGEN W√ºnsche?	negative
Erinnerst du dich an deine Tr√§ume? ‚Äî Sometimes Yes. Sometimes No. http	neutral
Thomas Schatz und Mario Rieder wurden auch bei ligaportal.at ins Team der Runde 4 gew√§hlt! Herzliche Gratulation! http	positive
@user was probiert? Seit doch bitte wenigstens realistisch! Nix habt ihr erreicht seit Beginn der Meisterschaft!	negative
Bahnchaos - Gef√§hrdet der Personalnotstand unsere Sicherheit? http	neutral
Last one! #Karl #bestfriend #ever #perfect #amazing #lad #Debs #grad #smiles #lovehim #lieben http	positive
@user meine mutter w√ºrde niemals mit mir zu nem 1D konzert gehen -.-	negative
RT @user: Habe dem Traummann eine Mail geschickt, dass er bitte unbedingt seinen Penis mitbringen soll.	neutral
Gute Besserung @user - get well soon! #FCB	positive
dritte gro√üe chance f√ºr kaka ... knapp vorbei :( lazio (bisher) ohne chance!	negative
Verstehe. Gepanzerte Boote essen die Viecher, Stiefel lassen sie √ºbrig, die schmecken nicht. Nat√ºrlich! #schlefaz	neutral
@user N√∂. Scheint wohl keine Neigetechnik zu sein. ;)	positive
@user Zu viel arbeit oder kannst einfach nicht schlafen?	negative
Bildungsministerium erh√§lt Note 5 f√ºr enormen Stundenausfall http	neutral
@user omg me too :D hahah wie war dein erster schultag denn ? :'D	positive
Merkel und Energiewende passen leider nicht zusammen #tvduell	negative
Draxler: ‚ÄûGegen Chelsea reicht es einfach nicht‚Äú: Der FC Schalke 04 kam gegen den FC Chelsea mit 0:3 unter die... http	neutral
Sarah Ha: aber wenigstens seine Nase is h√ºbsch, ne? |D http	positive
Bunt geladenes Arschlochding	negative
Outrageous Warm Chicken Nacho Dip http	neutral
oh mann o mann...richtig fett im web verdienen,speck anlegen? jegliche serverausf√§lle und daten email klau vermeiden? http	positive
Wtf Staplerscheinkurs mega langweilig! Hilfe!	negative
Ganz sch√∂n windig heute. #herbst #sturm #leipzig #wetter #Weather in #Zschortau via #instaweather http	neutral
Er schw√§rmt von seiner Ex ‚Äì Darum bewundert Jamie Campbell Bower Lily Collins http	positive
Zum Gl√ºck sind Google mit Android die Guten, sonst m√ºsste man sie fast mit Microsoft vergleichen. http	negative
RT @user: #timeforrevenge Gl√ºckwunsch zum Charteinstieg Daniel Schuhmacher &lt;&lt;&lt; Rolling Stone #Itunes http	neutral
@user followed (:	positive
@user Steini will vielleicht nen Marshall Plan, mehr nicht! Rumgeeiere! Warum lassen wir uns eigentlich immer verarschen?	negative
#Alps #adria #alpeadria #√∂sterreich #austria #train #eurotrip #nature #√∂bb @ Villach Hauptbahnhof http	neutral
@user = Unbeschreibbar &lt;3 Kein Witz! :D	positive
@user oh :o	negative
Trotz Teilverstaatlichung: Commerzbank-Chef Blessing fliegt First Class: Dank milliardenschwerer Staatshilfen ... http	neutral
Die will so Gespr√§ch mit mir f√ºhren üòÇüëå	positive
@user @user @user @user @user @user @user @user Nein, warum? #DStephan	negative
"Vorw√ºrfe gegen Hauptsponsor: Werder Bremen verlangt ""l√ºckenlose Aufl√§rung"" http #transfermarkt"	neutral
@user @user @user @user @user @user Lieben Dank, das w√ºnsche ich euch auch :))	positive
Leute momentan keine folge weil wegen Lets Fail partner nicht da Sry! ;)	negative
Drei Minuten Schwiegertochter gesucht und man erf√§hrt, dass er keine Jungfrau mehr ist. Mahlzeit! #sg	neutral
RT @user: In #Berlin gibts am Zoo bald neues Designhotel. Ab 115‚Ç¨/Nacht. Sieht ganz nett aus. http	positive
Photo: #terk #edilmis #unutulmu≈ü #emzik #bebek #vergessen #einsam #schnulli #schnuller #baby http	negative
Motiviert erstickte Speicherfigur	neutral
Die letzte Nacht war wieder Mega hart. Sind grad erst mit Fr√ºhst√ºck fertig geworden XD	positive
@user go schleeeep	negative
@user Hey, das war dann wohl ich!	neutral
@user filigran war jetzt nie so der Stil gr√ºner Politik... ;-)	positive
RT @user: Stehen gerade 2 Frauen bei DM neben mir und lackieren sich fr√∂hlich die N√§gel. Ihr Pech, dass auf meinem Weg dann ne Ve‚Ä¶	negative
Wenn eine junge, intelligente Autorin der besonderen Art verzweifelt einen neuen, gewinnbringenden Auftrag sucht... http	neutral
Sch√§m dich einfach :P	positive
RT @user: Zusammen Einsam sein. Wer hat den Mist eigentlich erfunden. Wieso kann man nicht einfach zusammen die Einsamkeit wegkuscheln?!	negative
"Das Meisenkn√∂del auf Englisch also einfach ""Fat Balls"" hei√üen, wusste ich nicht. Wieder was gelernt."	neutral
RT @user: @user AAH! DU HAST MIR GEANTWORTET *-* ich bekomme keine Luft mehr :o DANKE &lt;3 WE LOVE YOU SO MUCH :*	positive
[ SchockTherapie.!? } Die L√ºge von der schwarzen Raucherlunge!: http	negative
Premier League - Suarez unverk√§uflich, Gervinho nicht http	neutral
Toll, wenn man einem strukturierten Vortrag eines Juristen im IRA des #LTSH zuh√∂ren kann.	positive
@user echt was l√§uft denn	negative
RT @user: Viele S√ºdeurop√§er enden in Hartz IV http	neutral
Auf zur letzten Party f√ºrs WE :-) Habt einen FUN-tastischen Samstag. Mit Vollgas durch die Nacht. Greeetz &amp; Party... http	positive
killer Anders Behring Brei... http (2/2)	negative
Unser gr√∂√üter Feind http	neutral
@user @user Wenigstens einen Deutschen haben sie gestemmt bekommen. Super Beitrag!	positive
@user warum kommen keine Videos mehr? :'(	negative
Die tiefe Einsicht auch gegen den Trend funktionale Strukturproblematik zu res√ºmieren	neutral
Dieser. Akzent.	positive
RT @user: #Lok #Leipzig Gehts noch???? MigrantInnen denken sich Rassismusvorw√ºrfe aus, um dem Verein zu schaden? So zu denken ist rassis‚Ä¶	negative
Endlich mal ne h√ºbsche Frau die auch noch Autofahren kann http #rtl	neutral
@user dachte, dem w√ºrde die Streichelorgie gelten ;)	positive
Ich bin nicht gesund :/ ich brauch dich	negative
"Check out ‚ñ∂ ""Menschheit d√§monisch besessen"" on @user http"	neutral
Super flache, sch√∂ne und preiswerte Uhren von SKAGEN. Gutes Design muss nicht teuer sein. http	positive
@user soviel pinkes zeug D: meine augen brennen D:	negative
@user Angeblich ja. http schau mal da	neutral
@user brahahahahahah. Danke. Das war sch√∂n #domian	positive
@user ach, h√§nde brauch keiner	negative
@user +1	neutral
RT @user: Wooow, dieser Mann hier deckt noch viel mehr Idiotie en bloc auf: http @user @user @user‚Ä¶	positive
@user @user @user @user @user @user @user @user Hallo! Letzter Ferientag ;-(	negative
Westdeutsche Zeitung: EU muss Netzneutralit√§t sch√ºtzen = von Madeleine Gullert http	neutral
@user @user hai hai wir sind schon episch xD	positive
@user @user @user @user @user @user IM STRUGGLING TO STAY ALIVE	negative
M√ºdigkeit frisst Motivation #montag	neutral
@user Logisch, l√∂sungsorientiert, zielorientiert, egoistisch, berechenbar, wunderbar!	positive
Wattn Gl√ºck, datt der kleine Spacko mitte hochgekrempelte Hose nich anne Torwand gewonnen hat. H√§tte nich gepasst inne Malochersendung. #ass	negative
Vergissmeinnicht	neutral
Wenigstens ein Erfolg! Das NBBL Team der RheinStars gewinnt gegen Bayer 04 Leverkusen mit 67:66! GL√úCKWUNSCH! Scouting folgt!	positive
#langeweile macht sich breit...	negative
Hell Dunkel Hell Dunkel Hell Dunkel Hell Dunkel Das Herz geht auf und tanzt und tanzt und chillt Hell Dunkel Hell Dunkel ‚Ä¶btw that‚Äôs life &lt;3	neutral
RT @user: @user Absolut! Sehr gutes Spiel auch von #Hummels und Mkhitaryan mit einem Kopfball (!) gegen Italien!	positive
@user manche w√ºrde ihm Sexismus vorwerfen.	negative
@user lachte eben laut dar√ºber :&lt;	neutral
@user I see tbh it would be better the other way round uh just say ich spreche nicht gut deutsch, auf wiedersehen	positive
@user schrecklICH ;-)	negative
Pep #Guardiola froh: ‚ÄûDer Spirit meiner Mannschaft war immer da‚Äú @user #FCBayern http	neutral
@user Moin du h√ºbsches Schaf! :) @user	positive
Hilfeee! Ich werde wieder wach.......mmmpf! Man reiche mir den Holzhammer, bitte! SCHNELL	negative
Internet nix real life sein, in real life uns nur unsere Freunde und Familie richtig kennen tun. :-)	neutral
Yes. Sch√∂nes Los f√ºr die Zecken. :D	positive
@user üò∂üòü waab.	negative
Ignorieren Sie nicht die reizvollen Angebote fÔøΩrÔøΩ #ipod #festplatte Bewertungen Ansehen http #fb	neutral
@user Ah, super. Starke Karikatur.	positive
Interessiert keinen!	negative
Browser-Game gratis A Mystical Land das 3D-Browserspiel http einfach ausprobieren #Rollenspiele A Mystical Land	neutral
@user Du gibst mir immer so viel Kraft und machst mich gl√ºcklich. DANKE daf√ºr‚ô• i love you	positive
Hab englisch und bin aggro... Kann noch irgendwie nicht sein dass ich trotz eher schlechtem Englisch hier nichts lerne!	negative
"Standartdsatz bei allen Familienfesten etc: ""Ich m√∂chte kein Alkohol, danke."""	neutral
@user was machst du heute noch so meine s√º√üe?:* i love you üòò‚ù§Ô∏è	positive
567 - Kleine rat =(	negative
"""LONE SURVIVOR"" Movie Trailer: http In Cinema: 12/27/2013 STARRING: Mark Wahlberg, Taylor Kitsch &amp; Ben Foster"	neutral
@user morgen liebe Toni :3	positive
@user nooiiin. U.u nicht gut	negative
Jetzt 2 Monate lang die Simyo Allnet Flat f√ºr insgesamt nur 1‚Ç¨ testen - keine Mindestvertragslaufzeit, sofort... http	neutral
@user sch√∂ne Tr√§ume	positive
Wer bitte isst denn Stubenk√ºken? Nicht mal Vegetarier m√∂gen die. #Pfuibah.	negative
RT @user: Best√§tigung: F√ºr die Anschuldigungen der USA gegen Syrien gibt es keine belastbaren Beweise http http	neutral
@user hidden desire. Kung hidden pa :)))	positive
@user bon appetit....^^ sein unterhemd sieht auch aus, als ob er eben gegessen h√§tte und alles auf dem unterhemd verteilt h√§tte^^	negative
Peinlich! Mark Zuckerbergs Facebook-Profil gehackt: http #MarkZuckerberg	neutral
@user Auf gehts Jungs ihr schafft das ;) FORZA SGE!!!	positive
gesundheit #erk√§ltung #bloedsinn	negative
Aargau: Ausl√§ndische Diebe sehr aktiv http	neutral
Ihr m√ºsstet mich mal lachen sehen.. So niedlich. Und das Gegrunze erst!	positive
@user Welcher Bundeskanzler war doch gleich f√ºr den #EWU Beitritt #Griechenlands???	negative
Repost: Neuer ALG II-Weiterbewilligungsantrag verst√∂√üt gegen Bundesdatenschutzgesetz... http	neutral
@user Ich bin endlich fertig :-) #schult√ºtenbastelei http	positive
Das neue Gimp sieht komisch aus D:	negative
#seitensprung Weib sucht Abenteuer ohne Anspruch unauffaellig und attraktiv http	neutral
@user diese Staffel war mit der ersten die genialste *.*	positive
Echt krass, mir kommt deine geschichte sehr bekannt vor. Also wie du so dick geworden bist. (@user http	negative
@user @user @user GENAU! Ich wei√ü ALLES! Fragt mich was ihr wollt! HUA! LOL!	neutral
So sieht der perfekte Social-Media-Beitrag aus - Meedia http #SocialMedia	positive
@user Unzuverl√§ssigkeit.	negative
"Fitness: Das richtige Verhalten an Badeseen, Freibad und Co.: ""Pack die Badehose ein, nimm dein kleines S... http #SWR"	neutral
@user @user @user @user war davor! ;-) m√ºsse ma aber nochmal machen! Ohne Bundesgebolze sondern richtig #Betze ;-)	positive
@user DANN VERSCHLIE√ü HALT DIE AUGEN VOR DER WAHRHEIT, PFF :D	negative
Und ausgekotzt: http [Wer's lesen will, muss mich jetzt wohl bei LJ adden. ;D]	neutral
@user @user und machst dir dabei die Schuhe kaputt. Jaja.	positive
sam,ich weine leise	negative
ixj schicke euch auch deepe whatsappnacjrixhten deep aus meinem darm	neutral
@user ... und dazu vielleicht ein Gl√§schen Wein a la Schlangos aus Asien? Experimentalk√ºche 2.0! http ‚Ä¶	positive
haaaalt schlampe du kannst kein deutsch s√º√üe :* :* @user	negative
Mit Fahrschule Karlsruhe sicher zum eigene F√ºhhrerschein http	neutral
@user vogue&lt;333 schenk mir alle hahaa hab gar keine	positive
Irgendwie war dieses #MeinBezirk-Dingens letzte Woche interessanter.	negative
RT @user: Nicht vergessen, morgen meldet sich SpiW aus #duisburg2013 von der Kanu WM. Schaltet ab 16:50 Uhr ein. Mit dabei Max Hof‚Ä¶	neutral
"""@user: @user @user @user @user #ff-Mittagsgr√º√üe aus Berlin :)"" danke dir auch liebe Gr√º√üe:-)"	positive
Fast schade, dass heute Fu√üball ist, sonst w√ºrde ich gleich einen #himym Marathon starten‚Ä¶ http	negative
Nike Air Delta Force High White *kaum getragen*: Erlangen | Verkaufe coole Nike Air Delta Force High in wei√ü, ... http	neutral
@user hoffen viele, aber oft eben auch unterschiedliche Hoffnungen. Da liegt das Problem... ;-)	positive
Und ich beleidige mich gerne selber c:	negative
Letzter Einkauf f√ºr die Heimfahrt (@ EDEKA Jens) http	neutral
@user haste wohl ne gute ausstrahlung :'D	positive
Gebrauchte w√ºrde ich auch nicht haben wollen. http	negative
Understanding The Avon Company: A Complete Avon Review http	neutral
@user Ja, war sch√∂n :). // @user	positive
@user √úberwachungsstaat!	negative
@user @user hier: Balkont√ºr offen.	neutral
Gleich geht's loooos! Da mir keiner gute reise w√ºnscht -gute Reise Liza üòä	positive
@user Schei√ü Elite und ihre Geheimagentenfeatures!	negative
Eres el Schweinsteiger de mi Mannschaft.	neutral
@user haha brauch keiner	positive
Funktioniert bei noch wem #WhatsApp nicht? :(	negative
BGH: Unverlangt versandte Empfehlungs-E-Mails gleichen unverlangt versandten Werbe-E-Mails http	neutral
"""Ich kann Gedanken lesen ;)"" .. Omg, hoffentlich nicht, obwohl meine Gedanken eh nur bei dir sind &lt;3"	positive
"@user das geht so nicht. Die Nachrichtensender k√∂nnen doch auch nicht sagen ""ach n√∂, keine Wettervorhersagen mehr"". Mach sch√∂n weiter!"	negative
[N-TV] Repressionen gegen B√ºrgerrechtler: China nimmt bekannte Aktivisten fest http	neutral
the word schei√üe makes shit sounds better.	positive
@user @user. dat sind so viele unbekannte ich weineeee ~	negative
RT @user: Polizisten werden zunehmend mit Laser attackiert. Nun fordert ihr Verband einen Waffenschein f√ºr starke Laser. http	neutral
Eine sch√∂ne Runde was das gestern in Aukrug! Hier ein Eindruck! Weitere Bilder seht ihr hier: http http	positive
@user werd aber nicht mehr fit	negative
Hussein Fatal &amp; Young Noble - Killuminati 2k13 (Outlaw Nation Volume 3)... http	neutral
RT @user: a #sneakpeak of my latest #drawing Watching Over you - eine kleine Vorschau meiner neusten Zeichnung :) HAPPY MONDAY! http	positive
RT @user: @user I'm an idiot.	negative
Kunden kaufen hochwertige Digitalkameras: Smartphones verdr√§ngen Kompaktkameras: Der Umsatz¬†von einfachen, bil... http	neutral
Isst du gerne scharf oder lieber nicht scharf? ‚Äî meine mutter kocht immer scharfes essen darum liebe ich etwas s... http	positive
RT @user: Entr√ºstung √ºber Merkel-Abh√∂raktion. Berechtigt? Ja, nat√ºrlich! Ja!! Aber Front im Cyberwar verl√§uft l√§ngst woanders http	negative
"""fr√ºher war alles besser"" darauf wirds wohl hinauslaufen"	neutral
Und.. Wieder da. War ur cool. Reisen is ur cool, wenn da nicht andere Reisende w√§ren :-)	positive
@user du hast immer schmerzen, schatz.	negative
*** BILDplus Inhalt *** Kevin-Prince Boateng - ¬ªDiese Bayern sind gru http #Bayern #BILDplus #Boateng #DIESE #gruselig	neutral
Jammmmmiiii ;-) Heute gleich ne Box vom Eis Greissler geholt ... Boa, so verdammt lecker das Eis ... Ich Liebe es... http	positive
RT @user: @user Tja, der IRAN wei√ü sehr gut, dass sie das EIGENTLICHE Ziel sind...	negative
"Aus Sorge um die Quote: ""@user: #ARD-Programmdirektor verhindert ""#Brennpunkt"" zur Sp√§h-Aff√§re http #nsa #Merkel"""	neutral
Beziehungsstatus: DIESE EINE LIEBE WIRD NIE ZU ENDE GEHEN	positive
RT @user: Liebe Fr.Will, was laden Sie blo√ü wieder ein? Wenn's nach Herrn#H√ºther ginge, w√ºrd's hier noch fl√§chendeckend Sklavenarbe‚Ä¶	negative
Marketing-Flop Facebook? Forrester-Analyst Nate Elliott √ºbt scharfe Kritik an der Plattform: http	neutral
@user Das schwierigste daran d√ºrfte eine freie Bahn sein. :-)	positive
@user Das ist voll lang her und nicht mal ernst! :c	negative
Katze wirkt nicht begeistert #me #cat #newhair #purple #lipstick #photooftheday #instadaily http	neutral
Ein Eis aus dem Gefrierschrank holen und dann erst noch ne halbe Stunde rumr√∂deln. Gut, Ela, sehr gut‚Ä¶	positive
RT @user: Dem Deutschen kann man viel nehmen: Freiheit, Privatsph√§re, Chancengleichheit‚Ä¶ aber wehe jemand nimmt ihm seine Wurst!	negative
@user Sieht doch sehr danach aus! Welcome back.	neutral
@user Zum Geburtstag, Kun! Lange alt immer sch√∂n ‚ò∫	positive
@user ftv'a kok sedih gn sich :'(	negative
IMMOFINANZ Trade: 'An uns scheitert Erholung in CEE jedenfalls nicht' http	neutral
h√§tte Lust an WE nach Rom zu fahren.er f√§hrt mit?: #PopeFrancis--join us as we pray and fast for peace (full text) http	positive
Hersey guzel giderken aniden mahvetme gibi bir ozellige sahibim :(	negative
Suizid, haben Depressive hier die Wahl? Buchtipp als kostenloser Download. http	neutral
RT @user: #csd #hamburg k√∂nnt ihr bitte #vine videos machen vom umzug machen und an @user oder @user schicken? vielen dank! werde a‚Ä¶	positive
Because I'm a bot; I'm a bot.Nicht gel√∂st; Halluzinationen und von Panikattacken hab brauch ichs nicht vor dem dritten Glas Riesling.	negative
#jobs Die Redaktion ¬´#Der #Bund¬ª sucht eine/n #Praktikant/-in http	neutral
Sweet Jesus - Diese Abendessen war g√∂ttlich.	positive
RT @user: #Merkels Wahlkampf ist eine Farce. Kuscheln mit Mutti. Inhalte Fehlanzeige. Die B√ºrger w√§hlen mit der #CDU die Katze im S‚Ä¶	negative
RT @user: Denk ich an Deutschland: Das Unbehagen in der Demokratie http	neutral
Endlich macht der Wahlkampf wieder Spa√ü! #fdp- #cdu+ #allervollstesvertrauen #psycho @user	positive
God fucking dammit was tu ich noch hier? Ich wollte vor ner ewigkeit schlafen ;~; Morgen 7:05 unterricht. W√ºrg.	negative
Was Dream Theater zum neuen Album sagen erf√§hrt ihr √ºbrigens hier http	neutral
"OMA HAR MIR GERADE EINEN ""THE LONDONER -KITZB√úHEL"" PULLI GESCHENKT. Ihr k√∂nnt alle neidisch sein!!!! üòçüòçüòç"	positive
Schei√üer....ehhm beschissener	negative
Jamie und Freundin - jetzt sehen: Jamie hat sich von ihrer Freundin fesseln lassen. Und die nutzt das nat√ºrlich... http	neutral
Finde Kyle aus Wrong Turn 4 immer noch sch√∂n as hell, er soll mich heiraten.	positive
Na klar. Verschieben auf Mo weil die Fr nix arbeiten. Pfffff	negative
"RT @user: ""Sag mal was erotisches."" ""Nachtigall, ick h√∂r dir strapsen."" Wenn Berliner Dirty Talk √ºben."	neutral
SIEG!!!!!!!! Chemie gewinnt 2-0 gegen Osnabr√ºck :-D #liga3	positive
@user das is klar..Polster zu holen kann aber nicht √ºberlegt gewesen sein.nur PR denn andere Kandidaten w√§ren besser gew @user	negative
#8: Once Upon a Time - Es war einmal... - Die komplette erste Staffel [6 DVDs] http Best DVD/BluRay	neutral
"""Homophobie? Wegknutschen!"" genial @user http"	positive
Warum Gott warum passiert sowas mir ja warum muss ich wieder Operiert werden :( :( :(  zum 3ten mal :( :( :(	negative
Eine kurze Reise durch die Pracht der katholischen Kirche http #Cicero	neutral
wusste gar net was asos is kannte ja nur aso .......... haben aber ganz coole klamotten und net sooo teuer #notfashionhero	positive
@user Dann kann die Konsequenz nur sein, da√ü Wahlen und Demokratie nicht realistisch sind.	negative
RT @user: Wozu das Gejammer? Gegen Cyber-Mobbing hilft: 1. Account sch√ºtzen 2. blocken 3. Support kontaktieren 4. Anzeige erstatten 5.‚Ä¶	neutral
@user virtuelle Blitzumarmung r√ºberschick	positive
@user Apfelb√§ume sind scheisse! Absolute looser http	negative
"Neuer Eintrag: Kampf Klub (""Fight Club"") http"	neutral
Mitrei√üend. http	positive
Hab grad echt Bock iwo allein zu sein ._. Aber mein Zimmer is ja verbucht und in dem von meinem Bro halt ich mich nicht l√§nger als n√∂tig auf	negative
@user Bahngleise werden erneuert.	neutral
RT @user: @user sehr schick du Gangster ;)	positive
@user Thx4 rosa Empfehlung, sehe rot, beim Anblick meines gecrashten PCs. Rien ne va pLUS:qu√§le mich mit st√∂rrischem Notebook :(	negative
Noch 2 Stunden K√∂ln... jemand Tipps f√ºr mich? (Es regnet..!) #k√∂ln #langeweile #dom #starbucks	neutral
Wir gratulieren Michael Feichtenschlager und dem Faustball Austria Team zum hervorragenden dritten Platz bei den... http	positive
RT @user: Selbst DJ Bobo h√§tte mehr aus dem neuen Eminem Track geholt #Trauer	negative
Interessant dabei: Eine konkrete Person meint Cyrus offenbar nicht. Vielmehr scheint sie davon auszugehen, dass... http	neutral
Willkommen auf der-wasserretter.de :). Ok, Domain wurde nicht freigeschaltet. Aber bald :)	positive
F√ºhlt sich heute morgen sehr klein in einer gro√üen Welt	negative
Firefox 23 f√ºhrt Sharing-Button ein und stopft 13 Sicherheitsl√∂cher - http #it-business #it #onlinemarketing @user	neutral
@user uh uh. Schick. T√ºrkischer hennaabend?	positive
RT @user: Furchterregendes Interview mit #CDC-Vizepr√§sidenten zur fehlenden Zukunft wirksamer #Antibiotika. #Gesundheit... http	negative
RT @user: Frankfurter #Polizei entwickelt sich immer mehr zu einem demokratisch nicht kontrollierbaren Apparat... http	neutral
Huhu Meine lieben twitter freunde *knuff*	positive
R.I.P #Lee #Thompson #Young fallen solider #too #young	negative
Plan B √§ndert seinen Namen in Bartek &amp; k√ºndigt neue EP ‚ÄúApfelschnitzschneider‚Äù an http	neutral
@user W√§r total toll wenn's was wird *knuff* √∂.√∂	positive
RT @user: Meine Kollegen wollen unbedingt Radio Top40 h√∂ren. Anders ausgedr√ºckt: Meine Kollegen wollen unbedingt sterben.	negative
Photo: weissesrauschen: unbenannt by electricgecko on Flickr. http	neutral
Morgen lieve nichtje hier :)	positive
Genau. Wo kommen wir denn hin, wenn hier Journalisten ihre Arbeit machen! http #rausausbayern	negative
@user aso na dann. Welche hast jetzt?	neutral
RT @user: @user Hehe, das kenn ich nur zu gut! Ich wei√ü selbst oft kaum, wie ich morgens zur Arbeit gekommen bin! xD	positive
@user wut? I don't understand üòîüòî	negative
RT @user: CDU erh√§lt erneut Gro√üspende aus #BMW-Umfeld / Audi stoppte Spendenpraxis schon vor Jahren http	neutral
"@user Guten Morgen :) ""Sinnvolle Fehler"" .... sch√∂ne Kombi."	positive
@user #cool #hipster #hipstershit #hashtag #lol #rofl #roflkopter #absatz #HASHTAGSCHEI√üBESCHEUERTEHIPSTERIDIOTENAAAAAAAAAAAH #rage #swag	negative
Unsere Partnerorganisation ADES aus der Schweiz hat die Chance, 10.000 Franken f√ºr ihr Solarkocherprojekt in... http	neutral
"RT @user: Sch√∂ner Beitrag aus @user aspekte zu Ian McEwans ""Honig"". http"	positive
@user @user ja, das tut wirklich weh	negative
Neuer Weblogeintrag: Fast alle sind nackt. http #animexx #weblog	neutral
Dire teile k√∂nnen √ºber 20 jahre alt werden xd **	positive
Bring ich meinen Schlafrythmus halt voll durcheinander /D	negative
"DVD ""Fallen Angels - Jeder braucht einen Engel"" Drama (NEU&amp;OVP): EUR 1,29 (0 Gebote)Enddatum: Samstag Sep-07-2... http"	neutral
@user bin fast immer ruhig w√§hrend den Spielen. üòâ	positive
Wenn ichs nicht schon w√§re, ich w√ºrde irre werden O_O o_O &gt;_&lt;	negative
Energiemanagement senkt Kosten der zweiten Miete http	neutral
@user Ich danke! ;)	positive
wenn jemensch trollt, dann troll ich zur√ºck! und dann brauchst mir keine freund_innenschaftsanfrage schicken verdammt! #nerv #trollen	negative
#dagenshockey Ziga Pance verst√§rkt HCB-Offensive: Der HCB S√ºdtirol hat seine Offensive mit Ziga Pance... http #hockey	neutral
#Sehr #Gut :) RT @user: Leverkusen gewinnt Derby gegen Gladbach. #nrw http	positive
#verletzt ;Ich habs verdient.	negative
#DB #Bahn Schienenersatzverkehr 2013 M√ºhldorf- M√ºnchen: Aktuelle √Ñnderungen http #Bauarbeiten-Sanierung-stattAusbau	neutral
Tr√§ume nicht dein Leben, sondern lebe deinen Traum. Denn Tr√§ume setzen Ziele und Ziele kannst du erreichen. :)	positive
EW lernen! kein bock mehr.:/	negative
neuester #-Move, Mehrere Sportarten 1Std., niedrig. http	neutral
RT @user: Extrem viele Braunschweiger hier. :-) Gutes Spiel @user - live @user! #sweger http	positive
@user omg omg omg so Leute .. mir fehlen die Worte. Nein einfach nein.	negative
@user Danke! Dir auch! Meins besteht aus zwei Tagdiensten.	neutral
@user Eisenhower!!	positive
@user ICH NICHT! DENK DOCH MAL NAAAAAAACHHHHH, ok, is fr√ºh am Morgen, alles gut...*Augenroll* Das √ºbernimmt Mutter Natur.......	negative
00:56 CEST: Temp.: 7.6¬∞C, Wind: S, 0 km/h (Mittel), 0 km/h (Spitze), Feuchte: 98%, Regen (stdl.): 0.0 mm, Druck: 1020 hPa, steady	neutral
Ein Gl√ºck wurde #mielitz angeschossen. Oh oh oh #werder. Gegen wen wollt ihr in der Bundesliga eigentlich noch punkten?	positive
RT @user: #Syrien W. Dietrich beschreibt den worst case 'Unsere Generation wird keinen Frieden mehr sehen': http v‚Ä¶	negative
Empfohlene Hilfe Bei Schulden Auktionen http	neutral
Per Mail ne Stadtrundfahrt durch Oberhausen angeboten bekommen. Mit F√ºhrung. :-)) #dingediemannichtbraucht	positive
RT @user: @user @user Peinliches Ergebnis!	negative
@user keith	neutral
@user Sieht gut aus :)	positive
@user Sechs Tage? H√§sslich! Mal Twittern @user Hoffentlich schaut dann ihr Social Media Manager, dass Koffer gefunden werden!!!	negative
Street Photography #296 ‚Äì Zwei Einsame http	neutral
@user der Schiedsrichter pfeift die Partie ab SG Westerd√∂fft gewinnt gegen BSC mit 2:1 und feiert	positive
@user ja, ne? Ich wollte so ein weihnachtsrot, nicht so Pink. Bleibt alternativ Vllt nur der Lost in glitter ... Hmm	negative
@user ja, aber nur zu kurz.	neutral
@user @user loool kein ding mensch;D hahahah ich kanns halt erst n√§chste woche schicken^^	positive
#wiegehts bewegender einspieler, aber #wiebitte sollen Kinder Sprache vern√ºnftig lernen, wenn die Lehrerin schon nur gebrochen d. spricht?	negative
Prinzessin Madeleine dankbar f√ºr Seitensprung vom Ex - OK! Magazin http	neutral
RT @user: @user SIE werden dir noch gratulieren :) Eine dumme Frage , gratuliert ihr beide euch auch gegenseitig ? üòÉ	positive
New York Fashion Week. Genau vor meiner Haust√ºr. Schade, dass mich Fashion ungef√§hr null interessiert. Call me Andrea. #NewYork	negative
RT @user: Fakt ist: sch√∂ne M√§nner sollten sich ihren Bart NICHT abrasieren.	neutral
@user ..., um dann direkt Stefan zu informieren :D	positive
Beziehungsstatus: Nicht das ich verzweifelt w√§re, aber... http	negative
Mit Erfolg zum Erfolg - Agentur Amateur http	neutral
@user war ne sehr krasse party mit euch #props #100mannaufderb√ºhne #bergluft	positive
@user nat√ºrlich nicht -,-	negative
Katie Price - Katie Price w√ºnscht sich ein weiteres Baby	neutral
@user hehe..rina msti tgk cite heart strings kn??kn?? Hehe..bestt tauu ade oppa jung hwa..hehe	positive
@user @user @user @user @user @user @user @user @user @user HAI SETENG :(	negative
Gisele B√ºndchen Snags Another Big Campaign http	neutral
Hier auch noch das Donkey Kong Country: Tropical Freeze Boxart aus den USA. Auch recht schick. http	positive
38. Min schade, Kadirs schnell ausgef√ºhrter Freistoss streift vorbei	negative
Umfrage unter Staatsfirmen: Chinas Industrie w√§chst schneller... http	neutral
@user Nope. Muss ich mir wohl noch holen. o.o Und danke f√ºrs k√ºmmern.:3	positive
RT @user: #Schlefaz Hab gelesen Piranhas k√∂nnen zB im Freibad durch die Harnr√∂hre schwimmen und dann Organe fressen. Stimmt das? Angst!‚Ä¶	negative
"""Wer den Flei√ü nicht ehrt..."" wird verwunschen."	neutral
Wahnsinns Erfolgsgeschichte, Bundesliga geh√∂rt zu jedem guten Wochenende dazu, danke Sky!! #SkySL	positive
Vier Zeichensetzungsfehler in 140 Zeichen. Danke, @user, bin jetzt gut aufgew√§rmt f√ºrs Redigieren im Fr√ºhdienst. #sponsoredtweets	negative
@user ... Hey, sei nicht sauer, und, das hab ich nie behauptet, aber die Rollen eines Jesper Nielsen und Dietmar Hopp sind eindeutig	neutral
@user Extrem ehrlich, hoffentlich!;)	positive
Schmerz lass nach! http #Gesundheit #Medizin	negative
Sportwagen: Gro√üe Nachfrage nach Alfa Romeo 4C: Mit ihrem neuen Sportwagen wollen die Italiener eine kleine We... http	neutral
Not macht w√ºrkli erfinderisch	positive
Ne, der #Niebel will nicht authentisch sein. Wundert mich nur begrenzt. #UeberzeugtUns	negative
RT @user: War wohl absehbar: Deutsche sehen ‚ÄúBig Data‚Äù zunehmend kritisch #bigdata http	neutral
RT @user: Wie sich Menschen wundern, dass Under The Dome gut ist. Steven Spielberg verfilmt etwas, was Stephen King schrieb. HAL‚Ä¶	positive
Ok, streicht das Mist.	negative
Ob @user wieder ganz vorne im Zug sitzt um die Rentner besser aus dem Zug zu schmei√üen?	neutral
@user Bin heute aber zum Gl√ºck nicht in Obsthausen.	positive
@user echt anstrengend sowas...	negative
#ebay #fotografia Canon Powershot G15 G 15 Digitalkamera Ware f√ºr den deutschen Markt NEU http	neutral
@user :P :P :P Na immerhin. Apfel-Bobbes? Ich lass dir mal den Gedanken und bin froh das Ponys keine Orangen m√∂gen.	positive
:-( In Syrien muB eingegriffen werden :-(( G20¬†in Petersburg: Der blockierte Gipfel http via @user	negative
NEWS: One Direction top young rich list. http	neutral
Morning, schl bound ‚òÄ	positive
Ach ja.. Sixt. Wieder 45min gedauert, gebuchte Klasse nicht da, downgrade mit h√∂herem Preis berechnen wollen, 4,5l zu wenig im Tank. Deppen.	negative
@user @user You're not?	neutral
@user watch ur back janeht (-;	positive
Suche einen neuen K√∂rper f√ºr #Dale. Er ist alt. Sein K√∂rper macht schlapp. Ich bitte eine leere Donutbox von Aldi. Wer tauscht?	negative
Selbstmord: US-Schauspieler Lee Thompson Young ist tot - Kultur | STERN.DE Mobile http	neutral
Alle Beitr√§ge und Berichte sowie das w√∂chentliche FM Media Magazin findet Ihr nat√ºrlich auch in unserer Mediathek ;) http	positive
@user @user @user das sind schei√ü public cunts die gg leute mit h√§nden nicht mal 40 b b machen so siehts aus	negative
``Weil,Siehaetten``tragischBLAUstich? WieSmichDurchschauen,ueberFarbe. WarFehltrittBlauHautiger,Nachbar vonUnsDAmalsDieseLANGgewachsenen?	neutral
@user #HeidiKlumbittegr√º√üeOneDirectionvondeutschenDirectionern bitte das w√ºrde uns soviel bedeuten! &lt;3	positive
H√ºfte is dick also angeschwollen dick ,auf der Wade ist ein gro√üer blauer Fleck und mein Fu√ü schmerzt so doll ,dass ich kaum auftreten kann.	negative
@user Guten Morgen aus Hamburg!	neutral
@user harry du wirst sternchen nachl√§ssig gg	positive
toll, hab bauchweh &amp; das schon morgens.	negative
@user Gar nicht, du?	neutral
@user ach m√§nner eh nicht...ich mach.mir zb immer 1000 gedanken um slip und bh und dann wirds eh schnell ausgezogen v kerl :)	positive
@user quatsch	negative
22 Philips-TV mit Full-HD: Jena | Dieses kleine Schmuckstueck sucht nach 4 Jahren aeusserst guter Dienste eine... http	neutral
#hihi #g√∂ttlich #die #beiden üòú#versteckt #sich #der #kleine #Kr√ºmmel #unter #der #grossen ‚ù§#Wautzi‚Ä¶ http	positive
@user Jaja... kein Kommentar dazu! &gt;&gt; Senpai muss wohl einen strengeren Tagesplan ausarbeiten! &gt;&gt;	negative
@user nat√ºrlich...	neutral
Wei√üer Nebel, wunderbar. #instagram http	positive
RT @user: uiui, das gibt bestimmt ne leichte Asymmetrie auf dem Wechselstrom Netz ‚Ä¶ http	negative
Anbieterbefragung: tekom aktualisiert CMS-Studie #kw35 #cms http	neutral
Ok, Verzeihung.	positive
guten morgen...die medis geben bauchweh....will nicht mehr...	negative
RT @user: Hamburger Antifaschisten verhindern #NPD Kundgebung: Polizei baut ab, Faschos kommen offenbar nicht mehr! #nonpd #nonazis	neutral
"@user huh? Was soll man denn sonst sagen au√üer lecker? ""schmackhaft"" etwa? @user"	positive
RT @user: Fragt mich einfach, ich erkl√§r euch das mit den hassenden Feministinnen und den M√§nnern.	negative
@user @user . Klar .. Die Front .. darf nur das Display ausmachen, keine mechhanische Kn√∂pfe mehr dort. Aber Frontlautsprecher!!??	neutral
@user boah von denen kannst du bestimmt voll hartes Zeug lernen yo krass mann yo Satzzeichen sind unn√∂tig yo	positive
@user Ohhh schade der text kam mir so √§hnlich vor :/	negative
RT @user: Topbeitrag:SAP macht sein MES ‚ÄûIndustrie 4.0‚Äú-fit http	neutral
@user Scheint so :) hier zwar immer genderentsprechende Aktionen drumrum (Playboy/Prosecco) aber Einlass kein Problem‚Ä¶ echt abgefahren	positive
@user luka wird mich daf√ºr hauen	negative
Sterne N8000 Smart Phone 5 Zoll kapazitive... http #android #Kapazitiv #smart #smartphone #Telefon #testbericht #wifi	neutral
Happy Birthday.....Bruce Dickinson! (55) Nat√ºrlich gibt's heute was von Iron Maiden in den Rock Classics zu... http	positive
@user vollkommen irre eben.	negative
fehlerhafte fehlermeldung #klassiker	neutral
RT @user: @user aber nur, wenn du neben deinen 40 Jahren Arbeit nebenbei eine Kapitalgedeckte Altersvorsorge aufgebaut hast. Toi toi t‚Ä¶	positive
Liebe. Ach schei√ü drauf. Leben. Ach schei√ü drauf. Lachen. Jez √ºbertreibste aber.	negative
Sind die Patienten selber schuld? Josef Hecken, Vorsitzender des gemeinsamen Bundesausschusses, sieht eine... http	neutral
@user extrem h√ºbsch!	positive
RT @user: Alarmierende Studie: 68 Prozent aller Erstw√§hler k√∂nnen keinen Stift mehr bedienen ... http	negative
GDV: Naturgefahrenreport 2013: Sch√§den bleiben versicherbar http	neutral
"@user ""Shadowland"", eine Artistik-Tanz-Schattentheater-Show. War sehr toll *____*"	positive
Rhein-Kreis Neuss: Tageswohnungseinbrecher erbeuteten Schmuck http	negative
@user Man kann aber auch g√ºnstig mit der DB reisen. Z.B. mit einer BahnCard und/oder Sparpreisen: http /ki	neutral
gd'Monday @user @user @user @user @user @user @user @user	positive
@user @user musst schon nen Link rein tun. Ich such den jetzt nicht raus.	negative
"""Mit einem Song gegen George Bush konnte man nicht viel falsch machen."""	neutral
@user Ach herjeee....Du h√§ttest bei mir vorbei schaun sollen...ich habe noch viel zu viel vom M√§delstag √ºbrig ;)	positive
Fragw√ºrdiger Kulturwandel ‚Ä∫ Finanzkrise, Investmentbanking, Moral, Neutralisierungstechniken, Selbstwahrnehmung, http	negative
Imitate Devon ‚Äî hi im devon http	neutral
@user Felipe du Schlitzohr .. F√ºhre sie in die 2 Liga .. #freeshinji !!!!	positive
...und trifft nicht..-.-	negative
Bogner Brillenetui Etui original NEU unbenutzt f√ºr Brille Brillentasche Futeral: EUR 2,70 (3 Gebote)Enddatum: ... http	neutral
Unterwegs :) auf Bahn warten http	positive
Ein, Zwei, Drei, Vier... Bin endlich weg von Dir, F√ºnf, Sechs, Sieben, Acht, Du hast jetzt keine Macht mehr √ºber mich...Verpiss Dich!!!!	negative
#TeamFollowBack #SiguemeYTeSigo Syrien-Konflikt im Live-Ticker ‚Äì USA: Keine sicheren Beweise f√ºr einen Giftgas-... http	neutral
@user hehehhe, greit vennen üòè	positive
@user oh mist :( das ging aber schnell...	negative
Wat. Hatte seit dem 12. Juli kein Limit mehr?	neutral
RT @user: Ich hab gehofft, gelitten, geweint, bin durch die H√∂lle gegangen und jetzt hab ich dich endlich.	positive
@user Scheint im neuen Google Maps nicht mehr zu gehen. :‚Äô( //@user	negative
#ICE724 N√ºrnbergHbf 35m http | #ICE529 AschaffenburgHbf 5m http	neutral
Morgen schlafe ich bei Mona. [Hier bitte auch die Vorfreude einfuegen] bitte, danke. :3 @user #Bromance	positive
.@user Danke. *verzweifeltguck* #Bahn #Unwetter #Ausfall #H√∂hereGewalt #Sturm	negative
#download &amp; #watch Der Mann auf dem Kometen (1925) http #movie	neutral
Vorbildlich: Costa Rica will seine Zoos bis 2014 aus Tierschutzgr√ºnden schlie√üen http #tierschutz	positive
Aber dieses Jahr m√∂chte ich in einem gro√üen Wald Pilze sammeln. Immer kommt was dazwischen.	negative
Ich habe ein @user-Video positiv bewertet: http Landon Austin - READY FOR ANYTHING (Original Song) - Official	neutral
...aber nichtsdestotrotz w√§ren 700 follower schon ganz nett. ;P | ...but, nevertheless, 700 follower would be nice. ;P #LastTweet	positive
RT @user: Bitte, bitte, bitte nie mehr Schauspieler einladen! #hartaberfair	negative
@user Ja. Aber morgen. Ich muss schlafen. Jetzt. Sofort.	neutral
RT @user: http ..-dieser Artikel macht mir Hoffnung. Unerkl√§rliches #CDU-Wahlkampfbl√§tter-Sterben in #Stuttgart ‚Ä¶	positive
@user Tja...Aber keiner der Herren #D√∂ring, #Br√ºderle oder #R√∂sler kommen mal auf die Idee, mal den #Genscher um Rat zu fragen...#FDP	negative
Murat Didin: ‚ÄûWir werden unsere Rechte einfordern.‚Äú http	neutral
@user @user lvor nds wa? hab da ne weile nich aufgepasst^^	positive
@user ich mag kein Knoppas -,- @user	negative
Manchester United ‚Äì Norwich Live Stream online ansehen 29.10.2013 Football League Cup: Das‚Ä¶ http	neutral
@user W√§r echt ne geile √úberschrift:DD	positive
@user @user @user Nein warum √∂ffentlich geschriebenes bleibt √∂ffentlich kein Schutz f√ºr T√§ter!	negative
@user kneten dr√ºcken reiben mit lau warmen Baby √ñl	neutral
@user thank god, h√§tte nie schlafen k√∂nnen	positive
Berdenggung‚òπ	negative
#Annonces Gratis f√ºr alle Angebote http #Suisse #Switzerland	neutral
Anak gaul sutos (?) :p tausend dank f√ºr die sch√∂nes Tag! Awas loh ga ke jakarta {} @user @user http	positive
Ich hasse Kaugummi was nur die ersten 2 Min. gut schmeckt und dann nach gar nichts mehr schmeckt üò†	negative
"Kaltenborn: ""Wir geben die Saison sicherlich nicht auf"" #F1 http"	neutral
Mehlwurm gegessen. Schmeckt gut!	positive
Dumm gelaufen: #NPD-Jugend unterst√ºtzt indirekt Anti-Rechts-Initiativen http	negative
Koalitionspoker mit CDU/CSU: Nahles macht Druck beim Mindestlohn http via @user	neutral
Schon lange nicht mehr so intensiv getr√§umt und so lange geschlafen üò≥	positive
@user Tc ballert noch wahllos iwelche Leute ab und Phil applaudiert ihm. Og: Das wars dann auch schon wieder mit GTA V. *Abmoderation	negative
@user regelkonform geworfen zaehlt nur wenn auf bebaute flaeche gezielt (kein krater ?) cc @user @user	neutral
@user oje ??????? sieht doch cool aus	positive
Zuviel Misstrauen in dieser Welt.	negative
RT @user: 50 Anw√§lte ziehn durch Regensburg. 113 seiten L√ºgen, Solidarit√§t mit Gustav Mollath!!!	neutral
Tolle Dialoge ... #schwiegertochtergesucht #sg	positive
"""Arschloch."" ""Vorhanden."""	negative
Neu: Neuss: B√∂ller erschrecken Anwohner http	neutral
@user w√§re auf jeden Fall mal was neues :)	positive
@user @user Die h√§tten sicher wenig Freude an mir. Daf√ºr bin ich einfach zu schlecht.	negative
ANRUF ERW√úNSCHT: BE City! Neu Sexy, Versaut hemmungslos: BE City! Neu Sexy, Versaut hemmungslos Brandneu YENIS IN... http	neutral
Flinke Kerle, diese Bahningenieure: erfahre gerade, dass wir in Dortmund gleich 'ne neue Lok bekommen, weil der... http	positive
merkw√ºrdiges deutsch auf dem weg zur buchmesse http	negative
#FCBayern Frankfurts Jung f√§llt gegen Bayern wohl aus: Frankfurt - Eintracht Frankfurt muss im Heimspiel gegen... http	neutral
Er schluckt also gerne. üòè http	positive
@user Da komm ich pers√∂nlich bei dir vorbei und schleuder dir ein Schnitzel ins Gesicht!	negative
Fortschritte in Verhandlungen zwischen Apple und China Mobile: China Mobile ist das gr√∂√üte Mobilfunkunte... http #news	neutral
@user @user ganz deiner Meinung ‚öΩüíô	positive
@user Hallo, k√∂nnen Nichtmitglieder von facebook leider nicht sehen! Anders verlinken?	negative
RT @user: S√ºdtiroler Landtagswahlen #ltw13: Macht Heimat Angst? http @user @user @user #st1‚Ä¶	neutral
Gute nacht liebe TL mir fallen schon die Augen zu:)) http	positive
@user wo denn? Meine letzten Besuche in K√∂ln (vor etwa einem Jahr) waren eher entt√§uschend (√ºberf√ºllt, laut).	negative
RT @user: Spionageprogramm #Tempora: Telekom-Unternehmen droht Klage http #√úberwachung #Datenschutz #Privatsph√§re #y‚Ä¶	neutral
Omfg die sexy hipsterfrau aus meiner klasse cosplayt omfg ich liebe meine klasse	positive
Die Onion Rings von Nicole waren leider kalt... (@ Burger King w/ @user) http	negative
"SAT.1 Gold: Davis Cup feiert Comeback bei ""ran"": Deutschland gegen Brasilien ab Freitag live bei.. http"	neutral
@user Aus Schnakensicht stimmt dies sicherlich :).	positive
Zum ersten Mal mich selbst erfolgreich ausgesperrt - check.	negative
@user Himmlische Tr√§ume!	neutral
@user Wolfsburg, aber danke, hab schon was gefunden	positive
Derp meine Laune will nicht so recht steigen ^^	negative
RT @user: Seit Kumpel und helft den ¬´The bianca Story¬ª Stollen zur freien Musik zu bauen ‚Äî http http	neutral
RT @user: Ich komme gerade von einer Veranstaltung aus Leonberg, wo es nicht um #Politik ging, sondern um private Sachverhalte. Das w‚Ä¶	positive
@user same here .. hast wohl auch noch keine Ferien?	negative
Wahre Liebe bedarf oft keine Worte	neutral
Kuscheln im Frost w√§re jetzt genau das richtige :D	positive
@user PIO PIO PIOPIOPIO KLACK KLACK *nachlade-bewegung mach*	negative
"Aufgabe ""Schnelles Feuer"" abgeschlossen http #Android #AndroidGames #gameinsight"	neutral
@user sicher, aber nicht um Zw√∂lfe bei der Nacht. ;-)	positive
mir...ist.......so.......schei√üe....warm........ich.....sterbe......gleich.	negative
"RT @user: Aus ""Der Dicke"" wird ""Die Kanzlei""! Drehstart f√ºr sechs neue Folgen ab 29. Oktober. #PrDasErste"	neutral
@user Jetzt muss ich dich wohl bestrafen. :-)	positive
@user habs eben auch bemerkt. son shit. was war wieder bestimmt dreckssport.	negative
Der Fehler ist wohl nur mir aufgefallen... Bin ich kleinlich oder verlange ich gar zu viel? Ach fuck that.. Ich dreh mir noch eine.	neutral
Unvergleichlicher Bio-Kr√§utertee aus England: Pukka Herbs: It‚Äôs Pukka ‚Äì harmonische Geschmacksvielfalt im Teeb... http	positive
Evernote wird mir unsympathisch #Samsung #Telekom	negative
@user da macht mein Opa auch noch Krach (der schaut Boxen bis 1 Uhr)	neutral
@user Danke, ich gebe mir M√ºhe. &lt;3	positive
@user Sieht etwas unterw√§ltigend aus :( Schade.	negative
Schweiz: Gem√ºseproduzenten kritisieren Energiestrategie http	neutral
Morgen ist es soweit und wir haben die Ehre am LVL 4 Festival, mit vielen anderen gro√üartigen Bands zu spielen :D... http	positive
@user Schl√ºssel vom Keyserver http aktualisieren klappt nicht :-/	negative
Schwesig - √úber Betreuungsgeld muss verhandelt werden http	neutral
Awww, die @user sieht w√§hrend des Schlafens voll niedlich aus x3	positive
Mansche Nachrichten versauen dir echt den Abend. ;( Schade das ich ihn nie treffen konnte. #RIPLou #LouScheimer	negative
Oberliga Nord: Ausgerechnet #Gutsche trifft - @user mit 1:0-Arbeitssieg gegen Strausberg http	neutral
Good girl. ‚Äú@MoDeutschmann: Laura feiert den #Neuer so ab. Unfassbar.‚Äù	positive
Als #T√§ter findet man schnell den #Schuldigen. Keiner k√∂nnte die Rebellen (#Herzfresser) vermuten. #UK #USA #France #Syrien #Giftgas #Krieg	negative
S√ÑNGERIN SUCHT BAND-TRIO-DUO #Musiker #K√ºnstler #Bands #Kostenlose #Kleinanzeigen: Sympathische, sehr zuverl√§s... http	neutral
@user willkommen unter meinen Followern und in meinem Twitterchannel :D lg kali	positive
@user Sowas macht nur ungl√ºcklich. Wichtiger sind doch die, die bleiben, oder?	negative
Liebe @user sprengt ein fussballspiel via tv air √ºbers handy ohne wlan die rechnung? Hab noch 16 MB Restdatavolumen	neutral
@user hahah. Habs n Georg auch schon vorgeschlagen f√ºr Montag aber er will sich net l√§cherlich machen xD	positive
Oh ja -.- Sehr hilfreich mit Hunger Epic Meal Time zu gucken... well done Laura.. well done..	negative
Sex porno : Ein freches und versautes Girl scharf auf harten, tabulosen Sex http	neutral
@user tr√§um was sch√∂nes.	positive
Wenn deine Freunde Abend f√ºr Abend was unternehmen und du nicht dabei sein kannst, ist das ziemlich deprimierend.	negative
¬´Streicht beim Sprechen seinen Bart aufw√§rts!¬ª - verbl√ºffende Fakten aus dem Schwinger-Guide. http #esaf #srfschwingen	neutral
RT @user: Zauberhaften #FF back @user @user @user @user @user @user @user @user‚Ä¶	positive
RT @user: @user N√∂! Dich kann LEIDER KEINER Topen !!!!	negative
Windows 8: Bundesregierung warnt vor beh√∂rdlichem Einsatz: Die Bundesregierung h√§lt Windows 8 laut einem Zeitu... http	neutral
Hey ho leute heute zuhause chillen und was geht bei euch ‚ù§üòä	positive
@user warum das O_O wiesooooo??? sollte ich lieber schreiend weg rennen O_O	negative
News aus Hofgeismar: Grebenstein erh√§lt Preis vom Bund http #hna	neutral
Hatmant√∂ne: going for the gold: Wiederentdeckt auf meinem mp3-Player, vorher nie richtig wertgesch√§tzt: GOING FOR... http	positive
@user √§hhhh. also ich bin grad nich so geil drauf, erst heim zu gehen und dann nochmal weg. ich hab hunger ;_;	negative
Neuer Beitrag: Arme Google Server - Speicher http #google-server #gronkh-videos #sarazar-videos #sarazarlp #youtube-s	neutral
Leute die zuviel Inhalt von B√ºchern &amp; Filmen verraten, verraten auch: wann der Nachbar Sex hat, nach Hause kam, den M√ºll raus bringt usw. :)	positive
@user ach schei√üe... meine ausbildung :/	negative
[M-Business] net mobile AG macht trotz Umsatzplus Verlust, Vodafone einigt sich √ºber 130 Mrd Dollar-Deal mit Verizon. http	neutral
RT @user: @user @user @user @user @user @user @user @user Danke w√§re sch√∂n.Gru√ü a‚Ä¶	positive
Das Bison Steak war in Ordnung. Bea's Rupsteak eher z√§h. Ganz ehrlich: hab schon bessere Steakh√§user besucht. http	negative
#Kfz Gutacher aus Hessen, Adolph-Kolping-Stra√üe 18 in 63512 Hainburg: Ingenieurb√ºro Schaumburg http	neutral
Hausarbeit geschafft.	positive
Schade, bei VIVA's Bully Beatdown wird garnicht der Typ aus Schuh des Manitu zusammengeschlagen.	negative
"Lah mich twittere. Ich lueg jetzt fluch der karibik. ""Klar soweit?!"""	neutral
@user Haha! Besser gehts kaum noch. Nur in Ausnahmef√§llen also...	positive
Spiessich jeht jar nich. Nur wenn ick grille denn spiessich Fleisch uffn Spiess.	negative
@user truuu #TipsFromHartley	neutral
Kein Problem @user :)) Liebe Gr√º√üe und eine gute Nacht	positive
Na gut. Dann eben nicht. #LastTweets	negative
International (16:45) - Nani verl√§ngert in Manchester bis 2018: Manchester United hat den Vertrag mit dem port... http	neutral
@user oooo Happy Day oooooHappy Day Happy Happy Day Day Happy Day was f√ºr ein Tag Danke Danke my Hero	positive
21 Infuriating Instagram Cliches | @user http	negative
@user umm	neutral
Mkhitaryan zum zweiten. Wat ne geile Bude aber auch #bvb	positive
Grausame erste H√§lfte bis hier hin. Die zweite kann nur besser werden! #KoerbefuerD	negative
http Berlin Seitensprung gesucht? Wir machen Deinen Wunsch wahr	neutral
Bushido war einkaufen :) http	positive
@user Nicht cool :c	negative
Lost Planet 3: Die Auswirkungen extremer K√§lte auf den menschlichen K√∂rper http	neutral
@user @user Diese Gewalt an diese armen Ger√§te nehmen auch immer mehr zu...sowas..;D	positive
http Schauen Sie die kleinen Cabrios an: Null Charme null Image null Fun Der Lotus hat alles - Ihr Nachbar platzt vor Neid	negative
RT @user: Deutsche Telekom √ºberwacht ihre Kunden im grossen Stil http	neutral
@user @user Kann ich das Rezept bekommen? Klingt jedenfalls sehr lecker :)	positive
RT @user: Riiiesen Aus.mist.aktion. #daaruumkleiderschrank #flohmarkt #klamotten #alt #neu http	negative
@user korrekt. Aber das Bild, dass von S√∂lle stammt, geht den Versuch ein, Auferstehung f√ºrs Leben zu √ºbersetzen. Gottes hilft mit.	neutral
Einmal wieder klein sein mit der coolsten! Forever young ‚àû @user http	positive
in N√ºrnberg scheint st√∂rung bei O2. Jedenfalls alles was mit PLZ 9 KEIN INTERNET	negative
RT @user: Gladbecker Geiseldrama: 54 Stunden Staatsversagen (von Reiner Burger) http	neutral
@user Mach ich doch gern Schatzi üòäüòòüòò‚ù§‚ù§ Oh Gott und was war Mi nochmal ... ? üòÇüòÇ	positive
