text	label
@srbachchan #shamitabh #piddly #shamitabhtrailerlaunch .... piddly si baatien...!! yeah!!! http://t.co/r3r1bqklqe	negative
@shaziailmi kya hua??? haar bardaash nahi hua. ur cm candidate ran &amp; u followed her running from @timesnow #aapsweep #aapstorm #aap	neutral
i can listen crackers sounds.. out side the courtyard.. #indvssa #indiavssouthafrica	positive
I think vai app padhtey hongey plzz mai appse milna chata hu	negative
abp ka bachha hogya kya :	neutral
masha allah good....yeh hain meri hindi	positive
@someUSER capello had a draw in his 4th game with juve in the serie a (2004/2005) . 	negative
guddu hmara bada ho k jarur politican banega  .  .  .  . aaaiiiyyyeeee .  .  .  . 	neutral
yaar aankh khuli ni aur ye padh liya din hi kharab hai	positive
shaan is like .  .  question kahin mujh par na aajaye :p	negative
rt @rewati5: *yawning* finally it's a win! #indvsuae	neutral
uae batsman !!kuchh samay to guzaaro crease pe #indvsuae	positive
Bahut log hai jo aapse baat karna chahte hai..plzzzzzz dn't brk thr hearts sir plzzzz	negative
Tu dekh liyo ?? 	neutral
ye bhi add kr dete garbage bin	positive
contra mein 30 lives ke liye sachme chit tha ?  ?  :( kabhi pata hi nahi tha :'(	negative
"kaash viva me ese rone se marks mil jaya krte .  .  .  .  "" sir padha toh tha pr abi yaad nhi aa rha  .  .  .  . boohoohoo ""  :p ;)"	neutral
lucky shops are coming to nyc ! : the sale of the season hosted by lucky magazine with grammy winner jennifer hudson ,  starts november 1 .  .  . 	positive
Next yearðŸ˜œ 	negative
&amp; i think i m d only laziest kaam s jee churaane vaala , meet all d baap of aalasis , nikahtoo of india #rahulonleave	neutral
that movie flight with denzel looks really good !  may have to go check it out	positive
i never believed in this sort of stuff but when i read it ,  i found that this is true	negative
#ind is definitely going to win tomorrow's match #indvsuae #cwc15	neutral
mera kuch ni malum main kb shopping  kr lu 	positive
anyone else find it entertaining that ash wednesday and national margarita day fall on the same day ? 	negative
mostly gls k parents aise hi hote h ... or ye tumhe pehli br pta chla h kya jb itna feel hota h to log bf q bnate h itne sare .... nautanki .... 	neutral
bed ke pichhe se contra ka poster kahan gaya ?  ? 	positive
Salman Bhai yeh bajrangi bhaijan pe comment aa rhe hai is movie ko nhee dekhna	negative
Aaray Yaar koi toh bolo sab comment kar re khali kispe baat karinge bhi	neutral
script ke jagah homework ka puchti tab pta chalta uske rug rug me acting hai :d	positive
syrian delegation withdrew from 1st session of the non-aligned movement summit in iran as mohamed morsi addressed #syria crisis	negative
gf hi to bna rhe h yha ... kranti wranti to bad me hoti rhegi ;) 	neutral
indiaaah india - with ever cheer and with every run pakistan like mohd. irfan will crumble and be all over the place #indvspak	positive
bhaiyo aman ki bto m mt aana ye bjp ko bdnam karne ki sajish hai .  ab aap log congress ke piche kyu ni padte unse dosti ho gayi hai aap logo ki isliye . 	negative
jaago hinduo jaago murkh na bano ye kejri bhi deshdrohi gadaar hai like congress	neutral
modi ji aage chalo haem aapki jarurat hai	positive
aap to paagai thai channelwale bhi	negative
Man is doing like a man does ... 	neutral
aese mat bol yar kuch aisa kar k dikha k tere parents khud khe k ye hmari beti h . 	positive
sophia grace and rosie: we know one of your songs !  !  the sun comes down na na na na @someUSER http/URL	negative
#entrepreneur #angelinvestor pitch in on the new birthday party / super bowl sunday treat http/URL	neutral
Kaha par hai	positive
@someUSER perhaps they want a 3rd choice hahaha !  like ben amos at #mufc	negative
good news he is going to be father	neutral
Yar ashu tm had par kr rhe ho. Plz bs kr yr. . .itna nonsense mt bolo	positive
agn d so cld LYF n itz tricks ... #fedupvdit 	negative
Han dhund ra hu k db ka default passed kya h 	neutral
sir orissa pe kavi aao na.plz...	positive
dilli yeh #aap ne kya kiya? #delhidecides #delhielections	negative
@fully_fundoo koi engineer thali baitha ho to mujhe ye bata do bhai ki ye 10 wale recharge me kitne milenege #unionbudget2015 #sabkabudget	neutral
Mare favroute sallu vi...	positive
Tera post aur madhur bhandarkar ki movies ek jaisi hai .. a good one but noone will apprehend ... 	negative
supperrb salman khan..	neutral
this is fake news shame on you media usa how much given you money blady media  .  .  .  .  .  .  . 	positive
sir wanted ki sequel kab aa rahi sir tere naam ke baad wanted ke baad dabang ab bajrangi bhaijaan	negative
kahan kahan memory se khod laate ho guddu bhai	neutral
Jis jis ko MH ki full form pta hai thoko like  p  D 	positive
roz is waqt chipkte hai biwi se ,  aaj chipke hue hai tv se .  .  . aayyiiii	negative
naye patakhe kharid lo yaar ye purane bomb to fuss ho gye h ab tak .  .  .  .  . 	neutral
Bade dhayan se dekh rahe ho	positive
i am bigg fan of salman khan iam pakistani love love uuuu salman khan	negative
kaise ho 	neutral
anna ji aap agar sath aaye dilli nahni valki hindustan ko bjp aur congress mukt kar dengei	positive
just touched down in a practically balmy london. helsinki was fun as ever. last night we saw shamitabh. fun movie with parts shot in finland	negative
friends ap roj 500 rupees apko free milega	neutral
Did da big bash thing work ? Try big bear hug ? Dat stuff my friend never fails ;) 	positive
my xbox live ends tomorrow :( mw3 and gears3 all day !  hit me up ! 	negative
Toh seekh leta chalana 	neutral
akhil sharma chk this out	positive
@gurmeetramrahim msg movie teaches to walk on right path in life ,to serve the poor people #blockbustermsg	negative
Ap ab fresh mind se ho? 	neutral
#delhidecides:this is definitely our #photooftheday after the #aapstorm yesterday! for more- http://t.co/omiztklncu http://t.co/ajrse5evmy	positive
bola hai admin  ,  aankhe kholo duites  ,  know the all facts	negative
Apki movie me sbko bolna hai jai siya ram tab eed manegi acchi...	neutral
Salman sir evry1 says m ur die heart fan, ,bt m ur huge huge huge huge huge huge crazy crazy die heart fan of urs	positive
Ye kya bomb dikha Rahe ho 	negative
meri mummy jb bhi kohra dekhti h tb kehti h cap pehno us pr mufler daalo n inner pehno fir sweater us jacket n socks n thermal pyjama .  .  .  .  .  . n i always used to say - ni mummy thand ni lg rhi h .  .  .  . n ske keeps putting clothes on me .  .  .  .  .  . luv u mom .  .  .  . 	neutral
niggas boutta be droppin like flies down georgetown tomorrow  ,  you wont catchh me there  ! 	positive
"ab jindagi mai kabhi bhi ""dettol dettol dettol"" sununji, bc sirf #indvspak yaad aayega."	negative
Uske liye b koi to ladka hoga na 	neutral
m bhi  .  .  . m bhi .  .  .  katai chipak gya jabrang tareeke se	positive
kya yar ,  happy new year dekhao naa	negative
anna je bhi fix ho gye h	neutral
aaj border star group par aur tirangaa zee cinema par aani chaahiye .  .  .  .  .  :p	positive
harden got 25pts in the 3rd .  damn ,  maybe lin and harden can get my rockets to the playoffs . 	negative
Bol to ra tha k time lagta hai 	neutral
hehehehe .   .  . john cena ka sticker .   . really bachpan yaad aa gaya	positive
arrey !  !  mai to comments padhne aya tha .  ab tak koi comments nahi aye .  lagta hai mai jaldi agya .  :p chalo baad me aata hu . 	negative
Kon kehta hai ladki hasi tofasi . . ....... Arz kiya hai . . . . . Hasna to ladki ki ada hai . . ........ Jo ise mohbat samje wo gadhahai . . . .  p 	neutral
hoti hai bcoz parents kar chillate hai aur bf par had se zyada trust karte hai  .  usse bolo ki apne parents ki sune	positive
acha ji .... aisa kya ???? bt we wer nt lyk dt knd f seniors .... i mean hum to aise ni the ....  -D 	negative
Bhak sale place bataun r koe kam nae h kya mujhe 	neutral
great guddu	positive
koi aur kaam dhandha nhi hai ? kal monday hai  p 	negative
coni is still looking for volunteers for the painting project that is expected to be completed on saturday ,  november 10 and november 17 . 	neutral
"i'm not the go out type .  saturday nights are my  "" stay up all night with the fellas on 360 ""  night ,  but i think i'll dive into paterno's bio . "	positive
kkk 	negative
sir .  .  chehre pr mat jaiye .  .  bahut nautanki baaj hai yeh launda .  .  :p	neutral
garbage bin ,  waha pe petrol ki tanki hoti hai aur har baar sambhalke baithna padta hai aur brake lagte time bahut zooro se lagti hai :/	positive
Thodi or jagha ho to . . Call cntr b khol dena ak , logo ko job b mil jayge . . . 	negative
mujhe lag rha h koi admin ham sab ko dhokha de rha h..	neutral
1992 me kharide hue patakhe aaj bhi pakistani nahi jala paye!!! #indvspak #indwins	positive
athens (reuters) - greek lawyers launched their defense of a prominent journalist on thursday charged with break .  .  .  http/URL	negative
think i might go see flight tomorrow just because denzel washington  .  . 	neutral
Baby now itz allready 4.06 com naa waiting ..	positive
Breathig problem ho gayi thi raat mein bahut 	negative
wifi ni h 	neutral
Gm?? 	positive
Are mujhe mammi k sath rehna hai mam 	negative
sir app jarur c m banoge advance me badhai ho	neutral
aapne to bs gfts par e focus kra h , itta hisab laga rakha h gfts ka ,  o 	positive
bhai kaha gum ho gye	negative
modi ka majak to obama ne udaya tha :-d	neutral
@someUSER i wanted you to know that here in argentina is going to make a directioner fest 10 november te amo te amo te amo ! 	positive
rt @ramaninsan33: @gurmeetramrahim #msgrevolution #msgyouthicon dear dadddd its all because of uuuuu	negative
i hope i can get a ticket to the #1d concert in belgium !  !  ! you can't order them till saturday ! pfff .  .  . :s	neutral
ramdev baba baba nahu hai . neta hai . or badmash bi hai . 	positive
Ye Pakka hit h koi sala rok Ni sakta bhai ke film ko hit hone se	negative
guddu ko koi centre fresh de do ,  hamesha bakar bakar ke chakkar mai pit jata hai .  :d	neutral
jab udbilaao pit raha tha tab vo udbilaao ki layi hui chips khane mei mast ho gaya .  .  .  wah wah :p	positive
sir delhi chunav me pehli baar mujhe aisa lag raha hai	negative
Regards 	neutral
" "" dream high 2 premieres on feb 20th with eng sub thru kbs world !  ""  ok noted"	positive
channing tatum will be in white oak tomorrow .  .  . for all you stalkers out there	negative
i think it got eaten by a grue . - pc friday - diablo iii (ptr patch 1 . 05) | http/URL http/URL	neutral
sidhi baat hai golves kisi ke bhi ho bhai thand me hath me ball chipakana ni chaiye bhot buri chipakti hai :-p	positive
rupee ke girne se yaad aaya sonia gandhi ke tbyat kaise hai # pappu :p	negative
sun jb jyega na to usse phele milne aaiyu mjhse 	neutral
dear @narendramodi tell all @bjp4india ruling states cms to urge farmers don't fall in rumours about #landacquisitionbill @amitshahoffice	positive
Kaise ho bhai jaan mai apni gf k saath bajragi bhaijaan ka first show dekhne ja raha hu....	negative
bhai aap toh hit ho	neutral
sab muslim bahi se gujaris h ki duwa karo ki yes ramjaan me yeto h aagle sal ramjaan me ni ho	positive
salman sir plzzzz sir madat kro sir mai 4saal se aapka number dhoond raha hu sir plzz madat kro mere parivar ko aapki jarurat hai salman sir plzzzz sir....yeh mera no...hai ..,.7355458113	negative
@someUSER look at the countries we're playing ,  we were 6th seeds .  also we're missing ched evans ,  bellamy ,  ramsey ,  collins etc etc ! 	neutral
it is a shame  !  !  ! 	positive
"aaasaya kathula thoodhu vittu...sing this and sing line below in same ragga... ""stereo phonic sonata(sung as sun aata) #eksi #shamitabh"	negative
garbage bin bhai (faisal bhai) is baar to emotional hi kar diya tune .  .  .  vakai dad .  .  .  dad hi hote hai chahe saala kuch bhi ho jae .  .  .  missing him in every moment .  .  .  .  :)	neutral
ye mauka mauka wali advertise kabi aayi maine toh abhi dekhi hai just .  .  .  .  . :d	positive
@drgarekar kripaya mug bala chain hats dijiye.yakin maniye prabhuji souch ke baad chori nahin karunga. #railbudget2015	negative
delhi chief secy greets ak with a bouquet. ak greets him with aap's manifesto :-) #aapsweep #aapstorm	neutral
modi bhaqts after #unionbudget2015.... tere pyar me humko kya mila, babaji ka thullu...	positive
Pak foje zinda bad <3	negative
it's 4'o clock	neutral
Hlo sir kya aap kbhi mujhse baat krege kuchh hai jo aapse share krna chahti hu	positive
Jab mil jaaye toh batana 	negative
shah rukh khan ki train wankhede nahi jaaegi . #railbudget2015 #celebtrains	neutral
Weat karna padega	positive
bas kuchh mb ka apps download kro aur earn karo jitna chaho	negative
kachua sir nahi aaye kya republic day ko .  .  . :p	neutral
omfgomfgomfgomfg the black dahlia murder/machine head/dethklok/all that remains are gonna be at the palladium in november !  *joooooooy*	positive
Yahan aane ka 	negative
harakah: iran army monitoring all ships in gulf: tehran ,  oct 28: a senior commander of the islamic revolution gu .  .  .  http/URL	neutral
Negative marks krkr dara ra tha 	positive
hamari bus main bhi ek dengu aata tha , 	negative
Kisko 	neutral
4:00 baj gya sir	positive
Bhaijaan...app tnsn free raho...	negative
"1 > Create a fake profile ( make it look like an old profile or if you already have one ... ) . 2 > Write \ "" such\ "" confessions . 3 > Know the admin "	neutral
Ohhoh Hrhe Aaja bhai Gujiya khaleðŸ˜‰ Mne bnayi h ðŸ˜ƒ 	positive
p + q +r = 51 .  .  solved !  gudoo yeh hai answer .  kachua sir se fast solve kar liya	negative
election ke bahane tata nano aur toyota innova ka bhi aaj khub promotion hogya #aapsweep #delhidecides	neutral
@someUSER yeah your game against the ravens was a thursday night game .  im sure you will pull for the giants these next 2 games	positive
are yahaan koi matar kyun nahi chheel raha ?  :p	negative
this years nba schedule got me pumped for the season .  knicks vs .  nets in its 1st nba's battle of new york .  we already know its nyk town . 	neutral
Joy hind, Varot mata ki joy	positive
free wifi	negative
@pmoindia @railminindia toilet room abse saaf rahega ya nhi ?? #railbudget2015	neutral
assala muwalekum vhai zahan	positive
Me bhi ik actor hi hon song and drama se ret.kio ki ghaziabad ho islia miss karonga dilhi hota to zaror dekhta thanks	negative
bc ,  kise ne notice kiya ?  guddu ke sweater par 'apple' ka symbol bana hai 3:)	neutral
Tatti na 	positive
@hdfclife @imvkohli manjula guruge to kohli...koi run nahi #myteammypride #indvsuae #cwc2015	negative
kya koi janta hai k  .  .  .  .  .  soniya italy mai bar dancer thi  .  .  aaj desh chala rahi hai  .  .  wtf	neutral
Okies 	positive
Respected sir aap aaj pure Bharat ki ummid ho ...ek naya savera aapne hi janta ko dikhaya he...ap dhup bhi nikaliye...	negative
love uuuu sallluuuu	neutral
â˜ºâ˜ºâ˜ºâ˜º 	positive
Hahaha .. 	negative
"socha ,  tha ,  ke ,  aaj tere siwa kuch aur sochu .  .  .  .  subah se shaam ho gayi .  .  aur abhi tak isi  "" soch ""  mein hoon ke tere siwa kya sochu .  .  ?  ?  ?  like this page <3 if u someone love"	neutral
pls mane call karo	positive
anyone wanna go see #shedseven at boro on 14th december ?  ?  17 . 50 each .  let me know ,  i really want to go . 	negative
rofl  !  !  !  !  i cant stop laughing  !  !  ! 	neutral
naya batsman shehzad hai ya misbah ?? behencho mid off rakha hai !! #indvspak #pakvsind #cwc15	positive
iraq ke musal city me me iraq me hu  . 100 dollars me bikti hai mahila	negative
Bahut  mast  tha 	neutral
guddu ki khi khi khi .  .  .  .  .  laajawaab .  .  .  . :-)	positive
guddu beta aaj school na jaiyo heehehe	negative
can't blame uae, sons of rich fathers are always useless. even we have siddharth mallya. #indvsuae	neutral
Di il try mah best 	positive
perfect weather to finish a great week . saw noel fielding's show thursday at the ath .  meeting him would have made the week perfect ! 	negative
??how ? 	neutral
pooja ko btau??? 	positive
doing same with comedy nights with kapil :v	negative
nyc...mene active kr liya...	neutral
#blockbustermsg wen will msg 2 come eagerly waiting after watching msg	positive
#301   We have instituted a new award for the best rack at IITB . This year's undisputed winner is Xxxxxxi Xxxxxxa ;) [ sorry confessor , we can't publish names but feel free to tag whoever you like ] 	negative
hame koi like kijiye hum bajrangi se kam nahi hai	neutral
To iska matlab tera valentine's day and raksha bandhan ek hi din ata hai ?  P 	positive
Bhai apki film ka whatsapp pr kuch mesg a rhe hai kya ye meg sahi hai	negative
about india: auto production may end fy13 with 6% growth: cmie - mumbai: automobile production ,  which took a .  .  .  http/URL	neutral
hey washington senior !  have you had your senior portraits taken ?  the deadline for the yearbook is january 15 .  .  .  .  http/URL	positive
bheek me .  . chalk bhi milta ha kya sir	negative
nazar na lage par der aaye durust aaye #indvssa aahoo aahoo aahoo aahoo!!	neutral
Hain 	positive
Kya yaar admin aaj pehli bar confession dala tha wo b nhi posy kiya aapne 	negative
Ye suno 	neutral
Bhai Goli de rahe ho chotey bhai ko	positive
ye apne papa ki zanjeer par latka hua hai ........ 	negative
it's not a simple broom but a vacuum cleaner. @arvindkejriwal #aapstorm	neutral
Jab atal ji the to girvi sona unhone bhaarat me laya ... lekin manmohan jse grt economist hone k baavjood sona girvi rkhne ki naubat aa gyi h 	positive
little shear under stress, but otherwise, a very fine fielding performance from south africa. good sport spirit #indvssa	negative
2034 ke world cup ka tyari chalu hai	neutral
exam date jaanbhooj ke tabhi rakhi jaati thi jab matches hote the  .  aur maths ka paper theek match ke next day hota tha	positive
Aap log bahot amir he aapke liye party karna aam baat he par un logo ka kya Jo aapna ilaj bhi nahi karva sakhte jese ke meri friend use apki help chahiye aor aap party kar rahe he aap uski khuch madad karde pliz	negative
practical karne ke baad b practical ke no . ni miley  -P 	neutral
Sallu miya wonder ful	positive
teri inhi harkaton se laat padti hai tujhe bar bar .  .  . 	negative
usse english me baat krne de ... tu hindi me usko rpl kr hameshaa .. dheere dheere usko v aadat h jyegi hindi me baat krne k ..  ) 	neutral
aj ki party bhaijaan ki taraf se.	positive
@someUSER yes ,  anything possible ,  but u didnt answer 2nd question .  why back to 67 borders ?  to make israel weaker militarily ? if so , why ?  ? 	negative
"good news friends "" "	neutral
or jo game stiker mai hote hai vo kbhi ni hote	positive
@anmolagg20 everyone wants to b proven wrong abt it.. #cwc15 #indvspak	negative
if anyone really serious agnst #landacquisitionbill #landordinance thn first return land taken frm farmers to build samadhis of nehru-gandhi	neutral
Biryan acchi milti yha in bhopl	positive
seriously yr divya m proud of u har ladki teri jaisi ho jaye toh koi kuvh bol he nhi skta 	negative
"mummy pk movie dekhne chalein? ""haan, kaunsi movie?"""	neutral
inborn talent :p	positive
@someUSER @someUSER @someUSER print ain't dead yet cole ,  and i'm sure you know there's something special about sunday papers too . 	negative
superlike ..... this so called izzat is a product of male chauvinistic society . 	neutral
humari age ruk nahi rahi and ye guddu sala aur chota hota ja rha hai :p	positive
# msgincinemas hip hip hureee babu thanxx..	negative
Nah kab ? 	neutral
Just kholi hai abhi. 	positive
Wow is awesome hii iam Salman khan fone uthao yar khan fone uthao yar very very very nice voice iam so happy i love you Salman.<3	negative
aap ko vote  ?  delhi ka satyanaash . 	neutral
mummy ko pta hota tha ye sab .  .  . 	positive
Sir swach bharat mission ko gawon se shahro ki taraf lao Sir mission ki jinmedaari nagar nigam or parishd ko uttardaitav do Thanks	negative
16 .  vot bank ki rajneet ke chalte desh mein atanki hamale va mazahbi riots badhte jaa rahe the jise ab bina kisi bhed bhav ke khatam kiya ja raha hai	neutral
already fixed by bb8 b'coz gautam gulati is best friend h arpita khan ka so !  ! 	positive
mujhe to sidha daant padti thi .  .  .  bacho k hath me paise nahi diye jate warna bigad jayenge :d :d	negative
Osm party salman bhai apka gift	neutral
apna likha phla sentence pdho ... you dnt love him ! pta lagao ab uska aur do kaan k neeche do ! 	positive
mera teacher bhi aisa hi dikhta hai	negative
virat &amp; raina are on fire!!!!:d #goindiago #indvspak	neutral
Muslim hokar muslim ko hi neech bolte ho. .. Allah se daro. ...  ye saari dolat sab kuch yaho reh jayega. .. Khuda se daro	positive
salute hai aisi insaaniyat ko .  .  .  .  very nice .  .  . 	negative
Kabhi SUBHAS CH Bose & Bhagat Singh ki bhi baat kiya karo sirji....Jisne desh k tukde kar diye us aadmi (Gandhi) ki murti anvaran karte phir raheho @ narendra modiji	neutral
#landacquisitionbill kro trakki kissano ko maar ke ae jalim...bache tumhare bhi khush nai rhege...	positive
"@someUSER ahh me too :) if you like rella you'll like  "" ny ( ned flanders) ""   .  .  .  it's the 3rd song on vol .  2 ! "	negative
"india me sbse bde chalte firte terror group rss ka member hai modi  .  .  !  ghante ka development karayega wo  .  .  .  !  !  aur jo ye kahte h ki \  ""  we can't give congress chance again\  ""  to listen tum akele pura india nai bnate  .  .  .  !  !  india boht bda h  .  .  .  !  !  saare smjhdaar he lgte ho smjh he jaao baaki  .  .  .  .  !  ! "	neutral
kya sallu bhai baat krne ki bola lekin reply to kisi ko kr hi nhi rhe	positive
bahut badiya ,  bahut hi undaa ,  kya baat ,  kya baat .  dil jit liya tune toh .  .  .  :d	negative
yahi to h real dracula  .  .  .  .  .  .  .  .  .  .  . 	neutral
@drgarekar instead of sleeping in the parliament, he decided to sleep elsewhere. what is the problem? #rahulonleave	positive
abe bhagao yaar  ,  ,  ,  ,  sale australia ke aage hamesha sar jhukwa dete hai	negative
kya strategy thi iski business spread karne ki	neutral
the grey huhuhuhu #fuckingawesome #btwftr 670 i'm going to sleep i need it tomorrow i've to work	positive
Plz bhai aa jao	negative
who going to club bodi tomorrow	neutral
medea jahan biki ho wahan kisi ki nahi chalegi or yahan(india) ka aalam kuch aisa hi h	positive
@sanjay_vis bjp bhakts aap supporter ko follow karraha hai.. ache din agae kyaa ? congrats on maharashtra #beefban janta krantikari hogae	negative
duck hunt to kabhi paar nhi hui stage mujse ,  sabse ho jati thi  ,  gussa aata tha us dogi k upar :( :(	neutral
wo sab to thik h .  par ladka apna maar dhaad me superman h :d	positive
@gurmeetramrahim #blockbustermsg sadi tan jaan bh tusi ho jahan bhi tusi ho.. love u papa	negative
Go to fb 	neutral
Missingg holi bhai 	positive
Swagat nahi karoge humahra..???	negative
cba for work this weekend ,  wana be a sloth on sunday with @someUSER and @someUSER	neutral
are bhai tumne hum hostlers ki dukhti rag me haath rakh di .  .  .  . missing famly .  .  .  :(	positive
bhaijaan app itnai deer bad kyu promotion krte ho	negative
mera bhi pura parivar ye show dekhta h or sochta h kiss tarah ladkiyo ki help ki jaye	neutral
four again...hahaha wtf..#indvsuae 50 up...52 to win	positive
abki bar kiran bedi (modi) sarkar . we will get fulfill mission 45 plus in delhi . 	negative
baki sab same game ke different versions hote the ,  , 	neutral
gajab .  . 	positive
@dhanushkraja sema trailer! kalakkureenga ponga!! awesome amitabh!! #shamitabh	negative
rt @diggi840: no news of arrogance by aap people sofa. feeling good. #aapsweep	neutral
Aaai yar 	positive
Bihar(patna) kab aa rhe hai #Bajarangi_Bhaijaan ke promotion ke liye.	negative
plz dont came as a fraud client . 	neutral
rt @shipj: baag mein kaante purane hain..wah wah #unionbudget2015 #fm #arunjaitely	positive
Nawaj ne tohh kick bcha li iss baar dekhte h	negative
M sorry bhai 4pm me mjhe thoda kam h rat ko diner pe bat karte h	neutral
@someUSER i preordered it on thursday/friday at midnight the night it came able to pre-order ,  love you and frankie .  x http/URL	positive
whatever happens .  mom's lap is the best place to relax :)	negative
When there is a will , there is a way ( Y ) 	neutral
I'm cent % sure this gondalf guy is paid admin . Paisa sab kuch kharid sakta hai  3 	positive
@someUSER @someUSER @someUSER @someUSER good news i bought candy today ,  bringing some on tues .  if it lasts	negative
Akshay ,kahan ho. Lagta hai kho gai 	neutral
Milne ka plan banaynge .. 	positive
sab ka Bhai meri Jan Salman khan	negative
Tera kaisa chal rha h 	neutral
interesting, just in one day, this govt has become pro - farmer &amp; anti-middle class according to opposition #unionbudget2015 #superbudget	positive
hum to taiyar hai	negative
shi kaha .. izzt loot li dollar ne INR ko 69 pe lake  p 	neutral
dont think of coming to delhi .. v bad place realy ..  p ab aa hi gye ho toh bhag jao .. 	positive
bachpan kaash firse mil jaye .  .  .  .  .  .  :')	negative
kisi ne pk movie dekhi hai amir khan ki?	neutral
9 0 1 3 8 3 8 3 2 7 	positive
Salman khan ki jai ho	negative
wid d raising number of farmer suicides in d country, what d govt. is trying 2 prove by introducing anti-farmer bills? #landacquisitionbill	neutral
bhai ye gag toh 26 se pehle post marte  .  .  . mast h .  . 	positive
bhai mein toh bhool gaya tha supw ki class ,  tumko yeh sub kaise yaad rahti hain bachpan ki yaadein @someUSER bin	negative
score is 1 - 1 . now . BTW the kid never forgot the riding lessons . He still proudly claims to have learnt riding on a new CBZ .. 13 yrs ago . 	neutral
sir rahul gandhi, you're lucky that you're not in the it industry, gives you a chance to take leaves at will! #rahulonleave	positive
Madarchod supar dupar flop ho gae teri movieÃ¢â‚¬Â¦BUHUBALI ROCXxx :)	negative
hadd h yr kuch gals ini dumb kyu hoti ...  -/  -\\ 	neutral
faisal bhai .  .  .  .  .  tum yaar humaare paap yaad dila dete ho !  !  !  ! 	positive
I love sallu bhai jaan	negative
mai suchii boliii sab hall mai bhai bhai wah bhaiii hi bolte hai haste hai josh mai aate hai bhut maja aata hai	neutral
everyone is about how good pk movie is and i am here waiting for pocket money.	positive
Ye kya gadge h?? 	negative
about to watch the 2nd half of season 2 of breaking bad on my long flight to hong kong #buzzin	neutral
bhai roze se hu jaldi aa hao:'( :'( :'(	positive
yeh dua hai meri ke aap hamesa khus rhe	negative
Kutte ki nhi sunni h koi bat	neutral
awsome song bhaijan...	positive
whats wrong.people protesting against pk. movie dsnt say anythn bad about gods,its about d fake baba`s who cheat in d name of god.	negative
abe tm log jyada chapad chapd kroge to bhai jaan chale jyenge bola n sb chup chap bhaitho ekdm shanti shanti shanti aankh bnd kr k no type any commnt sirf bhai ka dhyan lgao	neutral
for any of those who went to see the dancing on ice tour this year the dvd of the tour comes out november 26th 2012 http/URL	positive
first murray is out for the dallas cowboys now felix may be questionable for the atlanta game .  not looking good for the running backs ! 	negative
Bakwas actor ki bakwaas film	neutral
Salman bhai may apke sath India ka garib or khana ,kapra na Milne walo ko apniii puri samata  sey  help karna chah  ta hu.....plzzz help and thora support me plzzz	positive
Kaisan ba? 	negative
Kaha kaisy? M karna chati ho aapsy bohot sara baat	neutral
yaar. . 	positive
sir aap kuch dhyan nahi dete pLz plz plz	negative
Bajrangbali ki vakt , kavi jhuut bolti nahi , toh aap kaise bola ?	neutral
cz wo up d ordr ata n out hota tb ye log khte k ab semis m chang krne k kya zrurt thi ctin ordr ko !  !  ! 	positive
Dekh lnge yar 	negative
Tushar bhai bata to de kiya kya hai rahul gandhi ne ... 	neutral
mehul shukla your dream school :)	positive
my family 4 votes go to 5 saal kejriwal	negative
salman bhaijaan eid mubarak aapko ho	neutral
guddu to gay nikala .  .  .	positive
@someUSER can not let be a let down game sunday with houston and san fran coming up .  gotta focus on beating tennessee .  #jayisourqb	negative
acha h bhai	neutral
Kal  phr  kitne  baje 	positive
Chalo zayada smile karne Ki zarurat nhi hai	negative
Item to Ayesha thi . Aur Mohammad Anpadh Maveshi Charane Wala 	neutral
the destination of thursday's premier league was decided today ,  see who's gone into the hall of fame .  http/URL	positive
launde ko salim feku ka role de ke dekho .  .  .  qutubminar hila dega . 	negative
kyun  . hilana hai  ?  desh main stability hain  ,  development hain  ,  instability kyun chahiye  ?  pakistan se paisa liye ho kya ? 	neutral
@someUSER happy thursday jennette from detroits #1 radio station wrom radio have a great weekend ahead we love a follow back from you	positive
bhaijaan kaha ho???	negative
congratulate jai hind	neutral
Accha .. 	positive
my #railbudget2015 10 points if i would have been rail minister @sureshpprabhu http://t.co/3pmoyiyahx	negative
pick the chelsea team to play swansea - chelsea's focus now turns back to the premier league and on saturday we make .  .  .  http/URL	neutral
@srbachchan #shamitabh mein bhi hoon...!!!!! #shamitabhtrailer http://t.co/jz0jhntpyy !!!! yeah!!!! #shamitabh !!! http://t.co/vpodbdsxnl	positive
ha ha ha  .  .  .  mast h .  .  .  yhi exact sentence h esse better to ban hi nhi skta .  .  .  .  sabse mast expression guddu ko bahar fekne k tym uske face pe	negative
shifting to delhi.. bijli, paani, wifi sab free ..lmao xd #aapsweep #delhidecides	neutral
jai hind jai bharat to our rastra pita ki jai ho .  .  . 	positive
ache se samjha ke chali gyi aur mai so gayi	negative
ben amos doing well @ hull city . another clean sheet v charlton . he says he's enjoying the challenge of playing regular 1st team f'ball .  #mufc	neutral
are bhai...kese kare bat ye toh batao koi....	positive
dekhna aaj pakka dhoni retirement le lega .  .  .  . :-(	negative
would it be acceptable for me to write my free entry friday in ms .  hughes' class tomorrow on candy	neutral
apparently tomorrow is nation kissing day .  ladies ,  you're more than welcome to stop by . 	positive
bas raste me na milna .  .  .  . 	negative
meko lag rha hai ye salman kbhi reply nhi degi	neutral
england won the match	positive
bhenchod alfredos jaane ka kya fayda ab? #beefban	negative
the first coolamon rodeo is coming up on november 17 !  a great day of action and a fun day for the family !  http/URL	neutral
Bhai aapki film super hit hogi hamari duaa aapke sath hai aur aapke sirpe mere bajrang balika hath hai Allah se duaa kartahu ki aapki film super ho	positive
@someUSER how does it compare to diablo iii (regardless of how fair that comparison may be) ? 	negative
Bhai kese hum ap se bat karsakeing.. Salman Khan	neutral
@gurmeetramrahim #msgincinemas chand taron se milaye tera chehra kaise,yeh kashish na dekhi kabhi chand mei,na sitaron mei...diwani hun apki	positive
supw class .  .  apna school yaad aa gaya .  .	negative
#annareturns ,#rahulonleave.....playing hide &amp; seek	neutral
sub ganda hai par dhandha hai ye .  . 	positive
shaan book se muh chupa raha hai and silently praying ki teacher na pakde  .  .  . typical story in everyone's school life :d :d	negative
at least they got over 100. #jasonholder must be cursing them. #indvsuae #cwc15 #cricket	neutral
Plz sallu help him aap sabki dua hi lete hona plzz inki b	positive
@someUSER only you can answer before i try !  there's on wp8 a way to call 3rd p .  apps ?  like intents on android .  i wanna switch to wp ! 	negative
Unhone appoint kara ha Ohho.. Ye bat ha Wo CA wale students ko appoint karte hain ky@? 	neutral
sir me aapke apartment ke bhar 7 din se morning to eve khada tha aap ko dekhne pr me dekh nhi paya	positive
i love u saiman ji main apka bohat bada fan hon sir mujhe aap par pora brosha hai aap mujhe back msg karo ge main aap se jab melunga na main apko acting dekhaoonga	negative
avisha rathore kya khub bola maza as re baba	neutral
@someUSER bhai which school r u frm ?  mere teachers aur classmates b kuch aise hi the .  .  .  . lol	positive
if you're on the isle of man next thurs ,  i'll be talking about safe house and signing books at waterstones from 6 . 30pm .  @someUSER	negative
Wah bhai jaan bahut smart lag rahe ho	neutral
we will come up with detailed post budget analysis. stay tuned. #budget2015 #moneypalm #unionbudget2015 #superbudget http://t.co/2mdpdyf3ye	positive
sabse badi galti to defence k bande ko bf bnakar ki 	negative
assalamualaikum sallu bhai jumma mubarak ho sallu bhai twitter par mai hi ho aapko masages karti ho	neutral
sahi hai bachpan yaad aa gya  .  .  .  .  always mom dad gives their best to children :)	positive
Only one hero jo sab ke dil me rahate h wo h salman bhai bajrangi bhaijaan unko dekh kar hi sabki dharkan chalne lagti h i love salman bhai	negative
Modi ji aap badhey chalo janta apke sath hai.	neutral
Agar govt ek baar acche khase bhikahriyo ko Iphone free me bant de to ... India ki bahut saare log chutiya ban ne bach jayenge .. jo sirf naam ke karan phone kharidte h . . 	positive
Are koi ni 	negative
Vlsi digicom ai / ml its humanitiesg thikingskillsg scienceg 	neutral
des ka apna chanel	positive
q jhoot bol raha bhai	negative
hjaaray ji kya btaaygy ki wo desh k hit m h ya wo bhi poltics m aana chahatey h	neutral
Baith gye hum 	positive
ok apna resume submit kar do  .  .  .  ladkiya choose kar lengi :p	negative
@someUSER no because asia told me it was the 14th and now its to late  . 	neutral
saw this after the game saturday .  @ former site of the now removed joe paterno statue at beaver stadium http/URL	positive
"jul 82 uk heavy metal band judas priest release their 8th album screaming for vengeance ,  with the single  "" you've got another thing comin ""  . "	negative
TEMPLE RUN  P . . Life is a race of your own . Doing better than yourself matters more than doing better than others .. . failure is an opportunity for new beginning .. . you're eventually gonna die , no matter what ! 	neutral
"#indvspak pakistani players after match in pavilion... ""hum log bhale hi haar gaye lekin batting karne ko to sabko mila na"" ðŸ˜"	positive
rt imsreed: bring it on..! #indvspak #cwc15 #indiawins http://t.co/efhm7tiixk	negative
tears of the sun is wayyyyy better than act of valor	neutral
rt pranvs: girta toh bahut chot lagti. :d #aapsweep #aapstorm #aapkidilli http://t.co/3u5uxuyaai	positive
bhai kasam khana apni bhains ki .  .  . russell peters ke comedy  .  .  .  . waale skit se toh nahi uthaya na  ?  ? 	negative
I don't intend to hurt you but I can't help myself . I am not in any good situation to thik good about anyone . M feeling very pessimistic and maybe you are thiking bad about me but sorry I cant do any more bcoz mujhe aisa bana diya Gaya h . I have become like this , yes , very hard . I told you that day , I lost trust on many thigs . Mai kaise rah rahan hun rahne de . Akela nhi hun family hai saath mein . Sorry and please don't expect from me bcoz mera dimag sahi jagah par nhi h bilkul bhi . Sorry kyunki mujhe pata h tujhe bura lag rha h ki mai aisa behave kar rha hun . 	neutral
kisk sath 	positive
@someUSER cant wait for you to come to dublin on monday so excited to see you:-) &lt;3	negative
kang ho dong has come back .  on october 29 ,  kang appeared in the main building of sbs in order to do a shooting .  .  .  http/URL	neutral
Congrats modi jee	positive
they are hereee !  i'm so envy those who just met them at the klia especially who took pictures w nick j :( tomorrow is my turn ! 	negative
lol super awkward if its hella foggy at rim tomorrow and the games suppose to be on tv lol uhhhh .  .  where's the ball ?  lol	neutral
guys tum log mazaak mat udao iska , thodi ' gayrahi ' mai jhaanko 	positive
Hellooooo 6 mint upar ho gayyyyyy	negative
rt @headlinestoday: congratulations to every aap worker and leader, do well, wish you well: bjp's shazia ilmi #aapsweep	neutral
@mohanrekha50 mor kaa dana khana, ek pl dekhna dusre pl phir garden jhukana.#beefban #poetrywoodlands	positive
ek baar sir ne humse do do ballooons mgaye the .  .  . baad me pta chla ki sir k ldke ka b'day tha aur humse project k naam se mgaye the .  .  .  . ese hote hn aajkl k teachers .  . 	negative
ha ab to world cup bhul hi jao	neutral
chalo aab koi wicketkeeper kay maan mai yeh aas jagegi ki woo bhi india kay liye khel sakta hai but only in tests .  .  .  .  . :)	positive
Bohot accha hai . Aaj ki party mari taraf se , sab ko bolo utre flak se . Nice	negative
Technology. H .. A 	neutral
#unionbudget2015 a fine balancing act: @girishvanvari, head of tax @kpmgindia via @economictimes | http://t.co/dircfcbkdm #kpmgbudget	positive
Modiji apne desh ka tho khayal rakho sirf gumne ke pm bane ho kiya falthi pm hai	negative
@hukam_rawat @bjp4india bjp ko delhi ki janta vote nahi joote maaregi aao bina security me phir dekho janta ka mijaaj	neutral
ye desh bhi imandar ho jay .  .  .  .  .  .  .  .  .  .  .  .  .  to mera bhart mhan ho jay	positive
Are kaise pata chalega ke online ho	negative
bhai agar bahar gya to baingan (brinjal) ke sath he wapas aayega guddu	neutral
@amitshahoffice #unionbudget2015 #sabkabudget what about industry wanting to skill and employ scst under ppp schemes of the gov..	positive
hahahahahahaha .  .  lagta hai kachua sir ne prestige se inkaar kiya tha :p	negative
Are bohot bola mene di usko ki chal .  Ek Hi tiket me ho jyga kam bhi .. Bolta ke project karega .. 	neutral
Chal dekhiyo 	positive
what is sad is that the whole world is watching.... izzat rakh lete hamari kya hojata #indvspak	negative
bhaiyya air 	neutral
are kya hua bologe bhi kha ho	positive
"watch  "" shri narendra modi promises to people that bjp will bring the black mone .  .  .  ""  on youtube - shri narendra modi promises to people that bjp will bring the black mone .  .  . :"	negative
Abe  usse  kya  baat  karenge 	neutral
Ab mujkoaa RHA h ?? 	positive
maa ch** dalo inki kal.. jeeto yaar #indvssa	negative
#salu bhai ap bas bachio ko reply kartay ho :p	neutral
is gag ko girls like nahi karegi	positive
hi sallu bro....	negative
bahut khub mere bhai .  .  . :)	neutral
"b'day sweets galti se staff room le jao saala jisne kabhi padhaya nahi wo bhi hath maar lete the .  .  .  nd moreover dialougues like  "" are ye sweet to mere pintu ko bahut pasand h uske liye b rakh leta hu ""  ""  .  .  bhikhari  !  !  !  :@ :@ :p"	positive
unhone pehle pic ni dkhi ti qa tmhari jo milne k bd hi ignr kia tmhe . . . ? 	negative
thank god, valentines day is not on sunday-every indian male #worldcup2015 #indvspak	neutral
Han  ..  Ã°Å¸ËœÅ“ 	positive
bhaag mc bhaag ghar jaake paani pee.. naha le #indvssa..	negative
Or fir to mai pakka shadi me Ni aara 	neutral
jerzy boy janowicz over murray !  what is going on in paris ?  !  we'll have a new master's 1000 winner .  no big 4 past the 3rd round . 	positive
Abe mammi ka kam karwake Sara tab gya thik hai na .. Aya bada chalke sysra 	negative
ye aaiyena naaa wala character you will find in every school and college  .  har cheej me hoshiyari deta hai ye character :@ :@ :p	neutral
M aur mere father dono bhulne me ek jaise h . . wo bar bar meri galtiyo ko aur . . m unki mafi ko 	positive
@srbachchan sir... #shamitabh is movie of d decade... hats off sir ..zille ilahi is awaz ka koi muqabla nhi pasand to aani hi hai duniya ko	negative
Kya hai yar ye!!	neutral
king cake and boudin for breakfast .  yep !  i'm in southern louisiana ,  where the weather is warm (not hot) and sunny .  wine tasting tomorrow ! 	positive
@Adm ...... lgta h bjp ne tumhe hire kiya h ye fake news spread krne ke liye ..... 	negative
apne desh me har kaam sena ke jawan ka hi hai .  .  .  . kahi durghatna to jawan .  .  . kahi aapda tojawan .  .  . border per to jawan .  .  .  . kasmir me apne log hi dokha dete gai unke bich bhe kawan .  .  .  . really salute indian army for long life	neutral
@dkgdelhi shakl bhgawan deta hain insaan kuch nahi kar sakta.. par ye toh baate bhi gandi kartey hain dhakan hain dono #aapsweep	positive
rt @vivekshahi0022: this day should be announced as aam aadmi day. #delhidecides #delhishowdown	negative
Hw cn u 4gt to add Phata Poster Nikla Hero .. Holy Christ ! It ws DISASTER ...  / 	neutral
itne sare logo me se humse kaise baat karoge?? :-(	positive
tu apne manifesto ki chinta kar .  .  . 	negative
mai hat gaya buri halat hai	neutral
koi mujhe yeh btao #maggi sasti hui ya mehengi #budget2015 #sabkabudget #superbudget #unionbudget2015	positive
watched #shamitabh .what performances by @srbachchan and #dhaanush.#gowatch	negative
or ye ashwin ne maxwell ko chipkaya :-)	neutral
Ya darling ! M too dsprately waiting for u(sadiyon+hi_suffix se isi cnfessor ki talash thi ) #foreveralone 	positive
bay area heads !  i'll be on the piano at yoshi's san fran this sunday playing with the one n only dwight trible - http/URL	negative
Ab  batao kaise ho? 	neutral
aaj kitne lakh ka suit pehen ke aya	positive
Modi is tarah so dekhne se kuchh nahi hota	negative
i liked a @someUSER video http/URL 17th grammys: paul simon and john lennon co-presenting the grammy for record of the	neutral
mamata asks parties to oppose cooking gas cylinder price hike: kolkata ,  nov 1 (ians) in the wake of yet another  .  .  .  http/URL	positive
people waiting for the teams to leave the hotel. #indvspak http://t.co/fhat9mwyoo	negative
Kas ma aipka khas friend rahta our aipka karib rahata.kas ma kis.kis ma aip ka kareb hota.mubark ho.aipko roja.	neutral
Mashallah 2.3k comments and likes r 33,966 great 300 crores hai bhai ki film kai	positive
kamaaaL karte ho salllu ji.....rply to bnta h n....	negative
"rt @modishahi: kitne kisan sm pe hai?? ""@bjp4india: visit http://t.co/2f3chp5p6v to get information related to #landacquisitionbill http://â€¦"	neutral
maa ko bank mat bnao mar jaane ke bad kam aa rhi he	positive
salman aap to hmare jaise ho eek baar kuch bolo	negative
test will be negetive smarty  .  .  .  .  .  best of luck :)	neutral
sale toh gay ban jaa weed hi dal ke soiyo hamesha ..  p 	positive
@someUSER yeah i saw them open for taylor swift in march .  they were awesome !  is cher just like a fucking bitch on stage ? 	negative
Sir aap jo kam country ke lea kar rahe hai uske lie aapko badhi	neutral
its just not about delhi or mumbai anymore  .  we can sit back at homes  ,  moan over such brutal incidents that take place almost everyday  .  people have got thick skinned  ,  and keeping aside the ' rape ' issue for a second  ,  what about the women being savagely abused verbally and mentally even in the public transports  ?  why doesnt the same janta goes into action  ?  why does the criticism and moaning more apparent in facebook status and posts  ?  problem lies in men  ,  they should not be allowed to wander over streets late night  ,  it should be rather banned  .  why should women have to modify their lifestyle because of the male dominated society  ?  its not her fault  .  .  . 	positive
Hum ka bole is kamine salman ke bare me bolna to bahut kuch hai I heat salman khan	negative
duck hunt was my favourite ,  but saali gun kharab ho gyi :)	neutral
@someUSER bhai itne bade confession post karke hum par julam na kr	positive
ab bacha kar rakh world cup	negative
Bhai yeh sab har police station pe hona chahiya facebbok pe nahi..	neutral
rt @ojesh10: yeh mauka bhi chal gaya, ab toh diwali ka hi intezar karne main bhalai hain. #indvsuae #cwc15	positive
hum to agle period ma laut k aate the  .  .  pura school naap k	negative
austin wore his yolo shirt for the 15th time in a month . 	neutral
tujhe kya laga tha  .  .  blind date par brad pitt ayega  ?  ? 	positive
south africa ki to kah kar leli .  .  .  .  .  :p	negative
bhai tu to topper hoga itna likh dala  .   .  padhne me itna alas aa raha hai aur tune toh chep hi diya  .   .  hats off	neutral
guddu ke sapno wali school main .  .  .  .  . paka main topper hota .  .  .  . or kabhi back bench par nahi baith tha	positive
plz bajrangi bhaijan ek reply plz     mai m.p. ke rewa saher ka rahne vala hu	negative
Sachi bata 	neutral
ultimate creation faizal bhai (y)	positive
AAH Salman aaj 4 bje khana benana he kel ka time rekhlo dear subha 11 ka aaj nai posible plz try to understand	negative
Yeah bro . Don't lose hope . Believe that you can fall in love again and with a different person . Once you find love again , you will forget this girl 	neutral
Great modi ji welcomes	positive
me:leave chahiye boss:nhi milegi me:raga ko b mil gyi boss:pagle rulayega kya.ja lele lekin bas chintan karna. #whereisrahul #rahulonleave	negative
Kal aa rha h launde ? 	neutral
Love you love you salman bhai	positive
Ek baar milke tyo dekiye...aap daang reh jaayenge...	negative
4 baj gaye lekin salman ji nahin aye. :/	neutral
Sir.sera ke bad me mai aapka bodygurd rhunga..	positive
Abhi utha 	negative
ðŸ˜ 	neutral
5.25 paise diya	positive
thik hu 	negative
aur thermocol ko chaku garm ke katna .  .  .  .  . warna kharab katega .  .  .  .  .  .  .  .  .  . :p	neutral
rt @pmishra_news24: #aap supporters outside party office @east patel nagar #delhidecides @news24tvchannel http://t.co/kokihmjd20	positive
bas tab se he chinese maal pe se bharosa uth gaya tha	negative
hahhahaha  .  .  .  that was the most hilarious one !  bhai tu jo koi b hai  .  .  .  bade zabardast jokes banata hai and it fits to everyone's child hood memories  !  good job ! 	neutral
arre yrr ye purana tarika h girls+en_suffix ko convince krne .. koi apni wrist ni katta .. aaj ki duniya me koi Ranjhnna ni h .. so chill nd move on 	positive
salman bhai ...... i lovee uuu tumharee liyeee jan bvi dee dengeee	negative
kuun fastest so far on ss4 ,  williams 2nd and fekken 3rd .  cronje still leads but the gap is now 8sec from habif #sarally #pr	neutral
Admi 	positive
HanðŸ˜” 	negative
both .@imshikhard &amp; .@imvkohli going nicely with their genius #mrf bats. #indvspak #cwc15 #worldcup2015 #bkeedblue	neutral
kya tum ko pata hai ke tumhara kya religion hai neither muslim nor hindu	positive
reminded me of my college egd clsses .  external viva wale din kaha ki sir raat ko sheets padhte hue galti se mombatti gir gayi aur 7 sheets jal gayi .  .  . jali hui sheets par 10 mai se 8 mile :d acting faad kari thi lekin :p	negative
#railbudget2015 controlling land encroachment through digitisation of land records.	neutral
India's superheroSALMAN KHAN. N ourJAAN	positive
mortal combat me power kaise chalatey they . 	negative
Han so Gaya tha 	neutral
Eat watever u want .. If anybdy tries to lecture u abt ur weight eat dem too !  -P 	positive
this time anna wave is not that effective	negative
aa jaiyu okkk 	neutral
Newaz bhai favr8 song raat ko aunga mein comment karunga mein questions bhi puchunga mein	positive
waise bhi ab ye part time hero hai	negative
guddu : lagta hai kachua sir ko apne bache hue baalo se moh nhi hai .  .  .  inka kuch karna padega .  .  .  ;)	neutral
Aaaa bhi jaa.. Aaaa bhi jaa... Bajrangi bhaijaan aaaa bhi jaa	positive
kya capacity hai yaar	negative
railways need to be the agent of connectivity,not aviation (thx to our terrain).directionally correct-build confidence 1st! #railbudget2015	neutral
vishal kahan hai 	positive
last saturday ,  your phbmates in cebu ,  all performed some of britney's hits !  basing on this picture ,  you'll have .  .  .  http/URL	negative
#railbudget2015 rly ke breadwinner, freight ko competitive mat banana #heyprabhu song: jhoom jhoom kauwa arre wahwah http://t.co/s3aq7pv2pr	neutral
i want to watch the vow ,  so guess whose gonna watch that tomorrow night ,  . with tissues ?  !  ----&gt;&gt;&gt; thiss girl :))	positive
hahah :-d acha hua mummy ka fb account nhi h vrna ye post dekh kr maar pdti bht	negative
Yehi jadu hai modiji ka jaha jate log pyaar karte hai	neutral
@aapyogendra take bow. you are the best of the world. your prediction was the best :-) #aapstorm	positive
mahan bibhutiyo ko naman karna sacchi dhridhata ka sabse anmol marg hai .aapko sadar naman	negative
Gaya khane ? 	neutral
@someUSER of others .  .  . jenelle may have made mistakes but she has time to change and be a better person .  .  . its too late for you .  .  . fuckhead	positive
kaun sa prfume use kiya tere cousin ne jo tu attract hokr sidha bed pe chali gyi ...??? 	negative
taking a litre of fizzy ,  flavoured water to bed tonight ,  super sunday is gonna result in a mouth like ghandi's flip flop !  #gacky #rank #beer	neutral
Gandhi ji aur aapne apni chhavi se na kewal desh me balki pure wiswa me bharat ka nam gauranwit kiya hai wish u all the best	positive
Bhai laga rakhi hai kya , m 	negative
money $$$ bhut kharch kar rhe h bjp	neutral
Tera project kya h ? 	positive
Modi ji kale kuto Ka ilaj ker do bhut bimar hai	negative
Class attendance waala 	neutral
mncim ,  the rain that stopped last saturday's game wasted our time waitse !  maybe ss4 would be playing something better tonight . 	positive
@someUSER elimination diet starts tomorrow don't you mean ;) #lean #vegvegveg ! 	negative
Are rat hori t .. 	neutral
other than lemon tea&amp;lemonade .  coke &amp;pepsi are my 2nd favorites .  as unhealthy they are ,  i cant/wont stop drinking them , they're just so good	positive
arre yaar ,  me to samjhta tha ke ye saare kaam puri duniya mein mere school mein hi hote the	negative
Badhiya 	neutral
ye india h bhai; talented bahut h yahan pe	positive
so #aapkidilli starts - batla house encounter fake, by amanatullah khan! #aapsweep #delhidecides #aapstorm. just dismantle security agencies	negative
To nikal 	neutral
kalispell mail processing center to close by march: kalispell -- the u . s .  postal service has announced it will c .  .  .  http/URL	positive
on saturday night making the next hit honored us with a achievement award it felt like we were at the grammys !  .  .  .  http/URL	negative
bolo mere saath dilli hui congress mukt abki baar......? #aapstorm	neutral
what you did may be a right thing  .  but still i hate guys who think like tht :-(	positive
free home	negative
Mast hun 	neutral
@gurmeetramrahim #blockbustermsg papa g craze fr movie is same as it ws before.. just wanna see msg again n again... movie is outstanding..	positive
love it !  !  !  :d :d :d :d	negative
delhi ho yah billi, kewal sher ki hoti hai, aur sher humara kon hai #delhidecides #dilli	neutral
ye to purana hai but evergreen hai bhai	positive
Love uuuuuuuuuuuuuuuuuuuuuuuuuuuu bajrangi bhaijaan	negative
sad to say #knutsfordlitfest nearly at an end .  fantastic event last night with michael portillo .  last event tomorrow with charles dickens . 	neutral
yar 's' ki power se to contra me avijit rehna easy tha ,  par jis launde ne 'l' ki power pe mahaarat le li .  .  . use koi nahi haraa skta tha .  shabash guddu (y)	positive
ye post karke tune to oldmonk daaru ka naam bhi dubo diya	negative
Salmaaaaaaaaaaaaaaaaaaaaaaaaaaaaaaan ajhooo 4 ghanto se apka wait kar rahi hu	neutral
4 baj chuke hai salman	positive
go hug her n say sory  .  tel her hw much u love her :) thats it  .  .  .  go 4 a date wid her	negative
dear delhi yeh dekh ka kush rahoo abad rahoo yehi ha achhe din http://t.co/fn7t79uqfr	neutral
because after a while you catch yourself eating meatballs on a friday during lent ,  and you don't care . 	positive
GunnitGunnite 	negative
sbhi dilliwalon ko ab free wifi purani dilli station k gate pe milega aapne aapna wada pura kiya ! #railbudget2015	neutral
Or mastery kaisi chal ri hai apki 	positive
a realistic rail budget india has ever seen. no populist schemes. prabhu has the guts to full fill others promises. #railbudget2015	negative
ho gya tera 	neutral
tu pakka usse puchti rhti hogi k use tjme ka pasand h ya tu kasi lag ri h  -P 	positive
-P aaj ka kaam kal karo , kal ka kaam parso , itni b kya jaldi h jb jeena h barso 	negative
great	neutral
P.m modi jee.aj mgnrega sab se top par hai.garamin chhetro mai esse playan ruka hai.lekin esme gram rojgar sewk, j.e. in sabka vawisy aap ke hath mai hai. Hum apne priwar ka laln paln dhang se nhi kr skte.bacho ko achhi shiksha bhi nhi de skte.	positive
Ye dole banane hain apko na 	negative
dear mr confessor go n post this letter to him . not on a confession page ! 	neutral
itna lamba kon padhega  ?  ?  admin is post ko ek bilaand chhota kar do  !  ! 	positive
1 reply tho de dete	negative
dekh lena bhaiyya ki film super hit hogi	neutral
amit shah : hum kyun haare karyakarta : sir sab voter mile huye hain #aapsweep	positive
iska 1st yr me ye haal hai .. 3rd yr tak to chanki pandey ke career ki tarah ho jayega .. KHATM ....?? 	negative
andre's wigan warning: wigan might currently occupy 15th place in the premier league ,  but andre villas-boas is w .  .  .  http/URL	neutral
assalamwaelkum bhia jaan hm v h ap k chahane wale	positive
HanðŸ˜¡ 	negative
@someUSER @someUSER y'all tryna fuck with chapel hill tomorrow night ?  ?  ? 	neutral
kya bhai aap bhi fak rahe ho 4.14 pm ho gaye abhi tak apne koi rep nahi diya bhai aisa mat we trust you...Every time	positive
dettol dettol dettol dettol dettol dettol dettol rt agar padhne ki bajay aapne gaaya ho! #dettol #indvspak	negative
Khare ka bhi haal pta chala 	neutral
Kis time ka hai kal tumhara plan .. 	positive
finally someone who thinks the way i do  !  .  whoever you are  .  .  .  .  you're awesome  !  :) ( y )  .  . 	negative
Grt super star sallu bhai	neutral
mere frnd log apke hi fan he but wo log apke movie me jo chalisa he usse naraj he & qawali sunkar bahot khush he	positive
Hahahaha 	negative
it was weird when a different couple took the spot  .  but it wasn't when you were there with different guys  ? 	neutral
guddu to khushi ke maare phool gaya ! 	positive
salman bhai jay ho	negative
Salman Khan bhai can't wiat...wish aaj hee friday ho... Bajrangi Bhaijaan..in advance, eid mubarak	neutral
dat khushi on guddu's face .  .  . when sir asked him to bring on chalk .  . epic :d :d	positive
haqiqat bayan karte hain aese cartoon images .   .  .  . :) so true .  . :)	negative
kahi rajnikant to nhi tha .  . 	neutral
abe bakalol kejariwal modi se hi hara tha	positive
Salman bhai loves us....so dnt be disappointed. ...ek din bhai se milne ka mauka sab ko milega...	negative
to kachhuwa sir  ,  kitno ko murga banaya aaj  ?  kachhuwa sir .  . aaj to bas guddu hi pakad me aaya tha .  :p	neutral
@gurmeetramrahim #blockbustermsg .. ji sweetu papa ...hum na wo cd lenge or na kisi ko lene dege	positive
@gurmeetramrahim #blockbustermsg ji pitaji dhan dhan satguru tera hi asra lv u pitaji	negative
Chankya ne kha hai .. Agar aapko ek kadam aage badhna hai to pahle 10 kadam piche rakho	neutral
mere husband subah se chipke hue hai fevicol k tarah	positive
holi kab hai ....kab hai holi.... beef ke bachon... #beefban	negative
just like when k was a kid saturday morning and i'm watching saved by the bell !  might even watch soul train @ 12	neutral
@garuna73 @yesiamsaffron @krishnpria i dont need to learn dharma from pk i know it very well &amp; with logic pk movie is not against hindu gods	positive
tennessee tech's steve payne says murray state does things the right way - oct 24 @ 6:47 pm et http/URL	negative
apni bahaduri to aise poet ke form me suna rahi hai jaise teer maari ho	neutral
4 baj gye salman sir	positive
you going to rugby practice on sunday #somethingisayalot	negative
mast wali body banaungi , ekdum doley sholey , booze karungi n party hard ,. mu todungi .. wil fall in love then die , wapas ladki b toh banna hai  p ;) 	neutral
Han pata hai 	positive
Han but bahut bada h yaar 	negative
@someUSER if they are still looking for a center ,  they may want to inquire about sam gagner .  edmonton needs d . 	neutral
bhai puri cassette check kar daali thi maine . 	positive
wat u thnk ... tere maa babuji is pg pe h .. lol  p 	negative
mummy ke sath sone wala guddu itna grown up kab hua be o . o o . o	neutral
too soon ?  amazon opens black friday deals store: thanksgiving is weeks away ,  the world series only ended on sund .  .  .  http/URL	positive
bhai jaan me aap bhut badha fen ho sir me soch ta ho ki kabhi aap se miluga ya nahi  sir jingi ki ek hi khuais thi ki ek baar aap se milu	negative
hahahaha sala fitness k naam pe dhabba	neutral
Waoo.salman nice yar	positive
#blockbustermsg @gurmeetramrahim uuuuuuuuuuuuummmmhhhhhhhhhaaaaaaaaaaaa guru pappppaaaaaaa jiiii http://t.co/yvmb56gfw1	negative
In d same sense . . bharat mittal ek pco booth ka maalik hai . . birla ki cement shop hai . . and . . ratan tata is owner of a garrage 	neutral
kitne bar tshirt me ghum liye  .  .  .  cricket khel liya  .  .  .  . but ek baat to hai  .  .  .  kasam se ball sikti thi thand me to mumma ki instant yaad aa jaati thi  .  .  .  . hahaha	positive
old man pagla gaya hai	negative
hats off to our indian army .  .  .  . 	neutral
super awesome .  .  . kaha se sochte ho bhai :) (y)	positive
Aaj usne bhi kaat ki inn sab se 	negative
rt @chiraginsan77: @gurmeetramrahim #msgyouthicon sacha rishta wo nhi jo choti c bt p tut jaye.	neutral
happy new year !  !  !  !  !  <3	positive
at the half ,  bayer leverkusen 1-0 vs bayern munchen .  let's score 2 or more in the 2nd half !  !  go munich !  ! 	negative
pumped to open the season tomorrow night against georgetown !  women's preview: http/URL | men's preview: http/URL	neutral
Bhai. Shahid ki shaadi mein nai gaye. ? ??	positive
will we get to see the helicopter shot next match, dhoni bhai?! #askcaptain @icc #indvsuae	negative
ha ha .... There is some fact abt this though .... bt u can change dat if u want to .... Fight for ur survival ....  p 	neutral
ye digvijay singh yaha bhi aa gya apni bakwaas lekar  .  .  .  .   .  east or west modi ji is the best  !  .   .  namo india	positive
aap may keep out 3 former ministers from new cabinet - economic times: http://t.co/hppeldgfrd #aapsweep -retweet please	negative
kabhi suna hai...cows ka population kam hua hai? :/ #beefban	neutral
why does the knicks/heat game have to come on tomorrow night during bibleball ?  oh well i'd rather play than watch any day ! 	positive
dosto pk movie mat dekhna kyunki tumara paisa peshawar chaala jayga http://t.co/upg07jk0mj	negative
incredible bharat	neutral
Tada 	positive
pahle yeh bata bc ki teri frnd rqst acpt karne ke baad bhi uska msg tere other folder me store hua ? chutiya bana raha hai hindi me sala aur teri aankho me bimari hai kya jo time line ka post tujhe dikha nahi bc .. chal be hawa aane de bc ham bhi fb use karte hain 	negative
@narendramodi_o nahi milegi full majority lul ho ye dekho shahji kya bole, ab to samajh jao delhi gayi hath se http://t.co/wyupxh5cmt	neutral
Koi baat nhi yaar vaise bhi parents k pause jaane hi the ab tuition nhi tof shoppng shi .....  -) 	positive
sare aade tede mere hi kimat me likha hai upar wale ne chun chun ke lga tha tum to sayad sahi hoge lekin nahi	negative
Nai di .. 	neutral
with in 4 days two plane (mig-21 and mig-27) crashed .  pm and his cabinet don't even uttered a single word .  rallies are more important than pilots .  all the resources of govt of india engaged by bjp in delhi elections	positive
rt @deepdeepak4: @gurmeetramrahim #msgyouthicon great movie every one should watch it	negative
Bahut tym lag jayega aur iss chudap mein tum waste kaun karega 	neutral
Kya Bata degi 	positive
fav bhana tha ye copy ghar reh gai .  .  . 	negative
please help me mein fb page par chat kese karu salman bhai ke sath??	neutral
guddu akela hi parade dekh raha hai ?  ?  ?  shan kaha hai bhai ?  ?  ?  ? 	positive
axl rose is trending worldwide just because he sat his butt on a chair to talk on live tv and drink water out of a mug .  bow down ,  peasants . 	negative
Datz gal nt prfct 4 u yrr ... cuz c iz attrct wid anothr prnsn nd 2morrw anothr prsn so ,.... U 4get her bro 	neutral
women safty chodiye pahle apne neta kumar vishwas ko women ki izzat krna sikhaye	positive
if you are attending the sustainable brands london conference in november please let us know !  http/URL #sblondon #linkedin	negative
faisal bhai purana hai ye to :p	neutral
"#railbudget2015 "" hey prabhu"" accha rail budget dena...:)"	positive
Dude sexual preferences apart , anybody who would be caught in the act will be joke of the day for months to come  P 	negative
general ko to loot rkha h har kisi ne ....  -/ 	neutral
Maam 	positive
really nostalgic .  subuk subuk !  !  :'(	negative
i sure watch it	neutral
akhir tha toh morena kaa .  .  .  .  .  . 	positive
Acha  jii 	negative
abhi tv pe bank me cricbuzz pe .  .  . jitaenge poore damm se	neutral
rt @extranaut: twitter acts like a cattleyst to every issue. #beefban	positive
lo aur haraao uae ko. ho gaya na petrol-diesel mehanga. #indvsuae #unionbudget2015	negative
cried for every episode of dream high 2 starting from episode 13 !  !  !  t-t tomorrow i shall watch the last and final episode ! 	neutral
russell howard ,  then cuckoo ,  then celebrity juice ,  then family guy ,  thursday night is the best night for comedy	positive
kato to khoon nahi .  when cut no blood .  convent me dala tha papa ne bhai . 	negative
kachhua sir toh students ke pakke wale dushman hain .  .  .  .  .  .  .  :@	neutral
@someUSER @someUSER october people have principles .  . &amp; argue passionately for them ,  about them &amp; act on them .  ghandi ,  sadat ,  adt ,  me ! 	positive
"volunteering 4 the obama campaign this am !  but i keep waitin 4 #olivia to come in yelling  "" super tuesday is coming people !  ""  @someUSER"	negative
Log apna sapna Pura karne ke liye puri duniya ko bhi dokha de sakta h	neutral
Bas bhaiyya kaam kar raha hun 	positive
james murphy best of luck tomorrow lil man .  you'll do great no doubts . 	negative
@economictimes preamble to road shows of dharnas and fasts?! #aapstorm	neutral
@someUSER nov 25 at the san siro .  i pray we would've gotten back our rhythm before then or we'll get embarrased . 	positive
Dekhna friends Salman bhai zaror reply kary ga late hi sahi	negative
mere toh ghar mein kushwaha madam hain :| :p	neutral
you can chat for hours but you cannot meet in a person because of your own thoughts of zamana kya sochega :d	positive
video of the 1st points for anthony davis ,  lin ,  harden ,  rivers ,  drummond ,  harrison barnes &amp; jrich on their new teams http/URL	negative
hehehe .  . hum to chalk ke bahane lunch kar ke aate the .  . phir lunch time me masti	neutral
main samajh gayi ... tune yeh confession kyu daala hai ... bcz tujhe espe likes aur comments chahiye the ... ab teri kuch bhookh kam hui hogi ..   @ 	positive
nov 1 ,  las vegas massage gift certificates - las vegas massage gift certificates for the best massage anywhere in s .  .  .  http/URL	negative
shikhar pe log...humesha shine hi karte hai. #indvssa	neutral
niii re 	positive
its not your fault  ,  its just hormonal imbalance  . 	negative
happy birthday to the coolest golfer in bali !  @someUSER  !  !  :) may you become cooler and cooler everyday !  stay humble little sister !  xx	neutral
kb aayega 	positive
Isbar tmhari le li jyegi preshaan na ho	negative
Hiiii.... Bhaijaan kaiae hai aap...aap ki pic bahut achhi lag rahi hai	neutral
mtlb itni bezti hogai lekin kutte ki dum kbi sidhi nahi hogi...@bjpians still fighting and taunting...sharam kro ...#aapsweep #delhidecides	positive
Lagra hai wikipedia hai pura 	negative
Hum fans ki koi kadar hi nahi h	neutral
work harder ... oh god . aaah aaahh . harder oh my god .. aah  p  p 	positive
i think my mom might buy me the box set bc i've been bugging her about msg and i told her i'd give her $30 if she got it before november 14	negative
ye launda apni aukat par aa hi jata hai .  kutte ki pucnh kabhi sidhi nahi ho sakti . 	neutral
@someUSER he bet me 5 bucks the lions would make the superbowl ,  and he also thinks the superbowl is on monday	positive
@someUSER so they should've ran the ball on 3rd &amp; 7 ?  blame cam all u want but flacco is the problem .  elite qbs dont have games like that	negative
bhai helo hi bol do...	neutral
@someUSER u proved to be a better scriptwriter than shazia ilmi .  #ramdev will end fast or move to ramlila where he has permission till 30 aug	positive
yr u shud move on now  .  yha koi kisi ka w8 ni krta n jaane wale ko koi rok ni skta  .  bt i dont undrstnd y ppl want a physical relation  .  bina intimate hue b love saalo saal chalta h agr koi chalana chahe tow :/	negative
to play temple run ,  to watch himym season 8 ,  orrrrr .  .  . to sleep in readiness for tomorrow's morning interview - decisions are hard to make ! :(	neutral
Selfie le beta jb marja0ge jb Qaber m ja0ge tb Allah tje dakhega ghtya h0 tm really	positive
#beefban what a secular hypocrisy india had,it's now trend to make fun of sentiments of hinduism.	negative
guddu to superb actor h .  .   .  chhaa gya yaar ;) :p	neutral
Good morning.  Kya jage rahte ho 	positive
lo aa gaye bhagwan ! 	negative
today is national kissing day coz it's no work day tomorrow !  !  ! 	neutral
guddu  .  .  .  .  sir jb puchhe to unki taraf nahi dekha karte .  .  .  .  . 	positive
freestyle wednesday - #np big l ,  jay z ,  mos def ,  black thought ,  eminem ,  yelawolf .  .  .  love it	negative
hmm raspberry pi - scrap ipads in the class room - have some pi instead #education @someUSER http/URL	neutral
Tera pyarr real hota to second time tujhe pyar nahi hota .. Think about it   -> 	positive
sir aap ki movies ka asar hai	negative
"A \ "" confession\ "" in its real term , finally ! "	neutral
ka hai bhaiya  .  bahot din baad nazar aaye  ?  ?  ?  sab kusal mangal hai na	positive
nitin gadkari #railbudget2015 aise sunn raha hai jaise sansad me mushayra chal raha ho.	negative
Mai baat Karta hun 	neutral
Chutiya bna rahey ho kya bhai..:p boley to lucky draw nikal k baat karogey kya!	positive
jimmy kimmel live - axl rose ,  part 1: part 1 of jimmy kimmel's interview with axl rose . added: thu oct 25 11:02:2 .  .  .  http/URL	negative
Thank you sir apka yatra se desh ko jarur fayada hoga hame garv hai app par aur apaki nitiyo par	neutral
may be we should try dealing beef now..india has no scope for drugs anymore.. #beefban	positive
Heheh 	negative
sarkar ko dub marna chahiye ki iss umar mein unhe kaam karna padta hai	neutral
Suraj Sachdev   We will post a pic of winner with Daaru and Pizza ! As it happens with anything IITians+en_suffix do , be prepared to see some news coverage in TOI ! 	positive
kyoki kejri banaras walo ka chanda lekar bhaga hai . 	negative
Ankhein hona swabhavik hai ... 	neutral
well ,  monsoon coming in from the north and the bomb squad down in midtown on the 15th .  time to go . 	positive
kaise ho. 	negative
OK Alia Bora mtmano sujao khoda Hafiz by Mafi mangne ki adat nhi samajjao byyyyyy....	neutral
#à¤˜à¤‚à¤Ÿà¤¾à¤¬à¤œà¤Ÿ #superbudget #unionbudget2015 #servicetax income slabs jas ki tas servicepeshavarg niraash!	positive
bhai ka hua? 	negative
A tribute to pathankot jeroes 	neutral
rt @jindalvicky81: @gurmeetramrahim #msgincinemas pita ji woh mubark din aa hi gaya jiska hum sabi ko intjar tha.	positive
plz aayeye sir jhuth bole to smjh lena aap ek meri jitni achi fan gwa doge aap sir	negative
shan seems like an imaginary frnd guddu kii mom toh kbhi notice hii nhi karti usse	neutral
Arre BC .. Aur kaisa h 	positive
loveu tooooo ur vey handsam	negative
let us wish him a long, long, very long leave. #rahulonleave	neutral
@someUSER strange enough ,  i'm going to see noel gallagher in concert tomorrow night .  #alldayb1tch	positive
allah hafiz....salman	negative
salman khan rock's ss	neutral
Vo to h ?? 	positive
adam levine strikes a pose for photographers outside of the late show with david letterman on thursday (october 25) in new york city	negative
Milte h holi bad hi 	neutral
gao hai ki zoo	positive
pakka engineer hoga . 	negative
"@someUSER if you happen to come online ,  know that your mccurdians trended  "" jennette on ellen ""  for mccurdian monday :)"	neutral
Rinky Kumari salman hai vo alva nahi hai	positive
@someUSER will pop down after work then ,  am only in murray on saturday !  why it changed ?  ps ,  fancy amsterdam ? 	negative
ye tumse jalne walo k kaam h bhai	neutral
thodi si frequency badha dijiye . 	positive
kaha hai 15 lac  . 	negative
ben amos doing well @someUSER  . another clean sheet .  he says he's enjoying the challenge of playing regular 1st team football .  #mufc	neutral
Dont be so sure . For all you know , his webcam may be on and you may be famous on youtube already ! 	positive
mujhe ek joke yaad aya ---- 20 rupay  .  . kyu chahiye tujhe 10 rupay  .  .  5 rupay me kaam nai chalega  .  .  .  yeh le 4 rupay  .  .  is me se 3 rupay kharch karna aur mujhe 1 rupay wapas kar dena  .  .  #lol  .  . 	negative
Abe hr nd accounts me checking 	neutral
modi ji ne jitni rally ki utni seat aa rhi h....bedi soch rhi kaash 70 rally hoti. #aapsweep	positive
@someUSER imo with gagner as you develop depth ,  89 would slot nice as a 3rd centre . 	negative
aaj ka cartoon achcha nahi hai .  .  . 	neutral
Iphones rates today on Slot.Ng 	positive
oh .  . no .  .  i am not at all meant for this hilarious sarcasm .  .  .  lol .  .  i still cant resist laughing	negative
Salman bhai plz ek baar muje call karo 7048830072 plz plz bhai fir muje mout bhi aa jaye gi to chalega bhai	neutral
Tum kafar ho	positive
Ami tomar sathe kotha bolte chai Bhaijaan.	negative
hey frends maine abhi ek app search ki jo free talktime deti hai . 	neutral
friday nite after the dwc reading raided sound garden .  .  . 3 dvds &amp; a cd 4 $20 !  cruising home 2 raphael sadiq .  friday note in cny . 	positive
ME AAPKA BHOT BHOT BHOT Bd fan hun	negative
amazon has opened an online store for black friday 22 days before the shopping event is scheduled to take place .  http/URL	neutral
hame bachpan se y batane ki kossis ki jati hai .  .  .  what is scam ? 	positive
sir don't want to disappoint uae fans so give them a six. #cwc15 #indvsuae	negative
abe koi achha news post kar	neutral
Me apka fen bhi hu aur apko sabse bada guru manta hu.	positive
eid Mubarak ho bahiya	negative
if ppl have liberty to eat a meat they like thn y not they have freedom to eat human meat #beefban	neutral
Tum.sala.hindu.	positive
Array pic toh change kar do Yeh 3:30 wali	negative
rt @sumitsharma_91: the amount of hindus disliking #beefban shows the pathetic state of #hindus !	neutral
apple shakeup mobile software boss eased out: apple inc .  ceo tim cook on monday pushed out the powerful head of the company&amp;#039;s mo .  .  . 	positive
Bas rename kar Dena .. Gk ke liye game h .. 	negative
"@gurmeetramrahim #blockbustermsg tumre jaisa na dayalu koi data ji humre jaisa papi koi na"""	neutral
Awsome...isey kehte hain hindustan ki chaap chodna poore duniya me...	positive
Helo salman.sir	negative
ab yeh joh virod kar rahe hai woh sirf galiya samjhne wale reh gaye hai kyuki insaniyat ab rahi nahi #beefban devendra fadnavis	neutral
like kar diya ab padhta hu :d	positive
hi salman bhaijhan eid mubarak aap ki movie achi chalegi i like u	negative
aap party k namse uske chamcha b paisa banane k bhane hai .  . 	neutral
all the best goutam	positive
salman yaar sudhar ja bhai Q krta hai gandi herkate yaar	negative
Are bap re 	neutral
aanna ji aisa mat bolo bharat ratn mil jayega	positive
Yukti this made my nite  D . tod . mtlb todddddddddddddddddd 	negative
I mean   aur 	neutral
..hmmmm 	positive
@someUSER hey channing tony provias from aberdeen hope you get a sack on murray this sat !  !  ! 	negative
sonia gandhi:beta ab ghar aaja maine tere liye bahut badiya poison banaya hai.aaja raja beta isko pe le aur ban ja president #railbudget2015	neutral
yaar tabhi mene jamia miliya me admission nahi liya even mera entrace bhi clear ho gya tha bt jo bhi ho do your best  .  .  :)	positive
Trailer dhannnsu hai bhai	negative
going to the georgetown game on friday !  #imwearingblue #istillloveeastview	neutral
phir confession kis topic pe karenge :/ sare topic ban kar diye :|	positive
@aloknath bdabbuji ! after #aapsweep #aapstorm khud kia nakli mooch aur bache kuche baal mundwana tho bantha hai ! @bharat_builder	negative
see the level of people doing phd  ,  i dont know what shit they will teach to students  ?  ?  ? 	neutral
Hapy women's day di 	positive
yaar bhag ja waha se agr u cannt live in tht envrnmt ... atleast suicide se to accha h .. alg reh kr apna alag se kr jo b krna h .. but donot hurt urself .. 	negative
sholy muje smj nh aa rha kia cmmnt kru jo socha wo sb logo ne kr die .. 	neutral
hahahhahha  .  .  .  .  .  guddu oops moment ka shikar ho gaya :d :d	positive
oye duniya walo sunnn lo zara !!!!! #wewontgiveitback #indvsuae	negative
Me smjha hostel me itna lateðŸ˜„ 	neutral
Kutta harami madar chod bighrat salman to agar mje mil jai teri maa bhin ek kardonga	positive
Ji salman bhai.bilqul rhenge..aapke liye :* :)	negative
good one guddu ka creator .  . but english mei nahi english mei dabba gol .  .  . :p	neutral
Ram hi ram bhai 	positive
#neelichatriwale ab to kejri ki rangbaazi hai dilli mei...#aapsweep #aapstorm	negative
i haven't lost, bjp has lost/ krishnanagar is dirty/ havent paid a penny to be bjp's cm. bedi rocks! #milleniumbloopers #delhidecides	neutral
ac milan reportedly want miralem pjanic to join the san siro in january #footballfanatic	positive
Tum kahe rahi ho oh fake hai agar real me aaye to tum kaise pahchano gi tum hahaha	negative
@someUSER riri's new album is dropping november 19th .  freaking machine .  .  .  literally a year and a day since talk that talk .  . 	neutral
@gurmeetramrahim #blockbustermsg oh papa ji maf krna #blockbustermsg lgana bhul gye ji	positive
300 is superb within conditions.. game on guys #indvspak	negative
Assignment  hua  kya  Ã°Å¸Ëœâ€¹ 	neutral
Sar mam 	positive
Tere pass sridhar/eng ka numberg hai ? ? 	negative
'bhagwan hai kahan re tu song hd pk movie 2014 http://t.co/06cahr2aui	neutral
nonsensical vulgar #aibroast is cool but a movie spreading social wellness is creepy. i haven't watched them though. lol #blockbustermsg	positive
insha allah aaj moka aayega aur phatake phorenge :) #pakvsind #indvspak	negative
@someUSER yes ,  dickens tomorrow night indeed .  @someUSER you too .  charles dickens tavern on collins st .  get there 45mins+ before ko . 	neutral
Abhi usko as a gift milega on his b'day ?? 	positive
Nhi baat karni to boldete	negative
ye bachcho ke khelne ka game nhi hai bachcheyyyyyyyy  .  .  .  .  .  .  .  .  :)	neutral
M v 	positive
i don't know why all muslims are anti modi ,  ek bar wait to karo ho sakta kuch accha ho . congress ne aisa kya kar diya .  kam se kam isne petrol ke dam 12 time kam kiye .  that i had not seen during congress	negative
yr tabhi mene jamia miliya m adm . Nhi lia even mera entrace v clear ho gya tha bt jo v ho du iz best ..  ) 	neutral
Bhai 27min 1622 second ho gye Plezzzz aa jaao	positive
@gurmeetramrahim #blockbustermsg conrats pitaji balle balle hogi..... chakte phatte... burrrrrrraaaaa	negative
Arif khan kounse news channel par dikhain hai sirf itna batado	neutral
beta kuch sweater dal le thand bahut hai :p	positive
mt le pagal 	negative
are .  .  . pure desh me kejari se jhuth balne wala .  . aur lalchi .  . jo .  . kursi .  . ke liye .  .  .  . kuchhh bhi kar skta hai .  .  . 	neutral
breking news modi ki raily mein chair kahli thi	positive
bahi,,kesehe ap??	negative
you guys didn't hear the whole story  .  dosa actually deposited 250 bucks fine and kept 750 to himself  .  talk about profit sharing  . 	neutral
salman sir aap kider ho plz message karo na mujhe plz	positive
10 game bhi badi mushkil se hoti thi .  .  .  baki sab repeat .  .  .  :d ;) :p	negative
rt @kamalmeet7: don't let anyone rent a space in your head, unless they are a good tenant. #msg3successfulweeks	neutral
rt @biharitweeter: main aas paas tere.. meri akal.. tu hai ki nahiiii #rahulonleave #whereisrahul http://t.co/tv1acw6cty	positive
"#msg3successfulweeks tab tak rhegi tab tak satguru chahega @msgthefilm #msgrevolution	2	1"	negative
Tu Kisi ki math soch bcozg atg theg endg ofg theg dayg tujhe hi karna h 	neutral
that's complete crap .  @someUSER began and sadat were all about peace .  bibi wants to use our military for free .  @someUSER &lt; c'mon	positive
"#msg3successfulweeks @gurmeetramrahim tere naam de masti chad gayeya chad gayeya tere jaam de masti chad gayeya pitaji	2	1"	negative
Iiith wala 	neutral
base ball me ball dheere se fekne ki trick	positive
"@gurmeetramrahim #msg3successfulweeks pita ji tu hi tu tu data, data satguru pyare g hai aaj pdhare jidhr dikhe bs tu hi tu bs tu hi tu	2	1"	negative
Haan  sahi  hai 	neutral
@mrsgandhi @chaitanya1309 bolne walo ke muh band ho gaye #aapsweep	positive
"anna hajaare par bhi picture banegi to uske liye bhi kharidna padega award inhe. @dhanushkraja + @srbachchan = #shamitabh	1"	negative
rt @pareeksaab_: ab ye chutia @kamaalrkhan bhi economy ki baatein karne lag gaya aur rahul gandhi ko chutti ki padi hai. #rahulonleave	neutral
#railbudget2015 odisha ko kuch mil raha hai ki nehin????	positive
"jao #shamitabh dekho aisi picture roz nhi banti @srbachchan sir ki actng dekho @dhanushkraja ka style dekho @aksharahaasan1 ki aankhen dekho	2	1"	negative
iss shoaib akhtar ko koi bahir nikalo bhai #indvssa	neutral
doston, is lota swamy ka kya kare? #aapsweep http://t.co/jtzwul9oe3	positive
abhi 4wje nahi aap ke?????????????	negative
to kab jeet rhi h world cup 2015 m ya 2019 m ya fir  .  .  .  .  .  .  .  .  .  .  .  .  .  .  .  . 	neutral
which players do you think deserve to be in saf starting xi against arsenal on saturday's game ? 	positive
Baat na bani....	negative
Hiiii sallu bhai.. .kaise h..bhaijaan...apne to kamal kr diya bollywood industry mei. .	neutral
i hope #aap volunteers show grace. no crackers- @aamaadmiparty - no hooliganism. #kejriwalontvf #kiskidilli #delhidecides	positive
i think i may be the only person around not excited that beyonce is the half time performer for the superbowl . 	negative
sallu bhai <3	neutral
keran bedi jindabaad	positive
aaj wala bhi cancel hua jaise :d :d :d	negative
ðŸ˜…ðŸ˜… 	neutral
sportsroom guy is not paying any attention . 	positive
Tm ho koun? Asaduddin owaisi sahab ne tmhri aukat dikha di.. abhi b tmko samjh nhi aaya	negative
age v likh deta ki teri ma mar gai	neutral
Sala.. Terko dusron k time ki kimat mi hai..	positive
" "" make in india ""  only in speeches ,  reality is to get  "" made in china ""  .  id's made in china was used in today's rally .  . "	negative
Kutte geeks wala grup check kar jara 	neutral
guddu ke papa ka scooter kaun sa hai .  us time par single seat wala vespa nv tha par us par spare tire peeche nhi tha .  aur bajaj chetak ki single seat nhi thi .  .  looks like bajaj bravo but it was launched in late 90s .  garbage bin kya aap is par kuch roshni daal sakte hain ? 	positive
@sudhirkekre #railbudget2015 diggy: isme naya kuch nahi hai m tiwari: congress ki yojanae copy ki hai mamta: garib virodhi budget hai	negative
aww !  !  !  moms are just superb .  . muaah	neutral
@bhola4u ha ha ha sayad bate kam pad jati hogi isliye visesh dharm ke log 3-4 wife rakh lete h #unionbudget2015	positive
AaP nahi aaoge	negative
plzz slaman jrur aana onlin or plzz jrur baat krna apne fans se plzzz..plzzzz...	neutral
subah 7 baje se sab aa gaye hai .  . 	positive
modi ji tumhe aise ghatiya baatein suit nhi karti .  .  .  .  .  .  .  .  .  . 5 saal kejriwal ,  , 	negative
ji internet ke paise na kate kuch aisa karwa do  -)  -)  -) 	neutral
Tan aur Mann desh Kay liye pranam modi ji .	positive
@someUSER is gonna be in louisville ,  kentucky tomorrow &amp; i can't go to the show .  i guess i'll just sit and listen to his music &amp; pretend	negative
Sir kya mujh gareeb ko aik reply melay ga plz ....?	neutral
guddu to gre kabhi clear nhi kar payega :p	positive
bas kar pagale .  .  .  . rulayega kya ! 	negative
#tech apple ceo apologizes for error-ridden new map app - apple ceo tim cook apologized friday for the company&amp;#039; .  .  .  http/URL	neutral
Tum gzb me ho 	positive
kejri jhootha hai	negative
kya yaar! aaja shaam hone aayi mausam ne li angdaai! to kiss baat ki hai Ladai...............:p whre r uh?	neutral
Admin aap chutiye ho .... ABVP wale paise de rahe hain kya unko promote karne ke liye .... and this page shud be renamed as DELHI UNIVERSITY ABVP CONFESSIONS ... going to unlike this page ... 	positive
#79   I have had a couple of hot makeout sessions in a corner of the liby journal section with different guys . It was weird as recently we saw another couple using our favored spot . WTF seriously ?!!?!?! 	negative
bjp k support se kar raha he ye galat kaam	neutral
jlin had a nice little bounce back game tonight ,  hopefully he gets back into his linsanity groove by tuesday	positive
sara media bika hua h . 	negative
great modi ji	neutral
Sallu bhai kisi ko rply nhi krte or humlog bewkufo k jese sallu bhai sallu bhai kiya krte h	positive
laufed  .  .  .  first u hav to correct ur english baad me sochna use  !  !  ! 	negative
i wanna be ur friend dear u r so sweet  ) send me friend request if possible 	neutral
kya bhartiya rail gaadi , bail gaadi hai?? #railbudget2015 #zeenews #indian #railway #bjp	positive
sala #olympics k game bhare rehte the isme  .  .  .  .  dhokebaaz >_<	negative
music thik nahi hai	neutral
reserved type ........ I also want to reserve u for my heart wash ........ coz m a big smoker . 	positive
they should make february 13th desperation day . 	negative
ab old monk nxt post dalega jo v ne bola hoga 	neutral
Akshay, kaise ho. 	positive
????????kaise piche pad gaye re......	negative
tri maa ka choot	neutral
#beefban best thing happened in a long time ! lots of animal resource saved ! lots more sickulars burnt :)) @dev_fadnavis good job !	positive
fuck u @admin ... AAP k khujli party wala h tu . 	negative
so true .  :)	neutral
ye culture heritage wala gana abhi tak chal raha hai  .  .  .  .  .  . 	positive
ek hi question me 2x-2x !  ye zehreela question kachua sir hi bana sakte hai	negative
ok im off twitter for the night til tomorrow bomb squad enjoy ur night love you much ! 	neutral
@someUSER i grew up in alsip ,  oak lawn is like my 2nd home .  reason for the city is wifes job at (cont) http/URL	positive
Khud kisi intrview m fail ho gya hoga ... or koi intelignt si girl select ho gai hogi .... . Bhadak gya h .... . Guys hav sympathty for Admin  D  P 	negative
To soja fir 	neutral
"shastri bhee kaunsi kam panauti hai jab bolta hai  "" all india doesnt want to do at this stage is to loose a wicket "" and koi out ho jata hai :)"	positive
The Logical Indian Kuch bhi likhte ho .. ek bar soch bhi liya kro likhne se pehle	negative
chhutti maar di aaj	neutral
Kis bewakuf ne apko yeh bola ki ....Apne fans ko iss tarh se wait karao2 thappad meri tarf se bajrangi bhaijaan padne chye usey jo aysi bekar muft me raye deta hay	positive
Teri maa ka	negative
sabki same problem :(	neutral
Abe ja be zhandu balm Tere jaison keliye kon waqt nikalega	positive
mayoos ho gaya hoon aaj main zindagi key iss safar se .  .  .  .  .  .  .   .   .  maqsad ki mohabatain hain ,  aur matlab ki dostiyaan .  .  .  .  .  .   . 	negative
nat like kejriwal	neutral
#unionbudget2015 expectation from mr santosh mohapatra, past chairman, cii odisha state council @finminindia http://t.co/cieifomtrc	positive
pagala gya h drama kr rha h	negative
ye saale sirf aap se sawal puch kr hi jitna cha rahe hain	neutral
Kya chutiye log hain Jo ise eid Mubarak bol rahe hain is kamine ko kya mlm k ramzan kya hai aur eid kyu manate hain...ise to sirf paison se mtlb hai	positive
sale harenge .  .  . 	negative
@gurmeetramrahim #blockbustermsg papa g tension muket karo..	neutral
Jai shri krishna bhagwaan ji apko hamesha khush rakhe	positive
guddu ke father ki dedication kabile tareef hai .  .  launda school se ghr aya .  use kapde change bhi nhi krne diya .  . kuch khane bhi nhi diua .  .  guddu ki ma ne jane kaise diya .  .  ye ek pita ka apne bchche pe atyachar ko darshata hai :p :p seedha market :p :p	negative
"just watched  "" project x ""  for the 1st time ,  im unamazed .  .  y'all hyped it way past what it was .  . "	neutral
Han didi 	positive
jo karna jaldi karna varna koi or uda k le jayega tumhari dream girl ko  .  gud luck  . 	negative
sweater toh pehhne see jyada gale mein laga ke style marte the:p	neutral
"@someUSER wow look at this another amazing monday  "" jennette on ellen ""  in 8 place we do this for you we love you http/URL"	positive
" "" @someUSER c'mon leo where's endymion .  .  .  .  .  .  .  or amsterdam i know he likes amsterdam .  ""  those songs are shit compared to the ones i put"	negative
lekin chalk laya kaha se ? 	neutral
kua 	positive
#rahulonleave congress on self destruction path	negative
salman bhai main apka bahut bada fan hu mujhe apki bahut pasand aata hain.	neutral
signing day this friday for fdahs .  hate the school but i love my senior class ,  we be on . 	positive
#181 : my roomie talks in his sleep and doesn't know about it  ,  but the rest of the wing have all heard him  .  none of us have told him yet  . 	negative
inbox ma bat karo sallu	neutral
"you can totally hear a guy from the 2nd floor singing from the top of his lungs to  "" what makes you beautiful ""  .  lol . "	positive
prashant thapa vijay nainwal sala isi mario contra k chakker main xi mai grace mila tha .  .  .  . 	negative
Hlw aapko nhi ana to bewkuf to mat bano	neutral
beauty lies in the eyes of the beholder  .  .  .  .  depends on you whom do you see as beautiful  .  .  .  .  .  can't generalize the fact above though	positive
bjp chor	negative
Kaisa print hai be , m 	neutral
salman sir main aap kaa bahout bada fan hu please call me 7726066179	positive
are mera to aaj hi h xam :-(	negative
yippee  !  !  !  friends i got free 3gb 3g mobile internet for 1 month in just 2 minute stuff . 	neutral
iss din ke laddu ke kya kehne .  .  .  .  .  .  .  . waah	positive
chutiye .  .  . sirf vade krne se vote milte to aaj mein bhi pm hota	negative
kamino ne 2003 mein bhi ind pak ke match ke agle din icse ka maths paper rakha tha	neutral
rt @dashhtweets: mein toh bhul chali #indvsuae ka match, #ausvnz pyara lage...	positive
ye na sudhrne keâ€¦ !  !  ! 	negative
( y ) ....... mujhe aisi hi ladki chahiye .... yaar tu jo v h .... bahut mastg ... i like ur thinking ... agar sb galz aap jaise ho jaye toh aise boyz ki aachi tarah watt laga skti h ........ big hand for u ...... /\\ ...   * 	neutral
bete ko baap ke saamne uchhal na nahi chahiye... waarna kohli aur raina jeisa thenga padega #indvspak	positive
mere teacher ne to mujhe wapas ghar bhej diya tha ek baar .  .  .  .  kasam khuda ki aaj mil jaaye wo	negative
Salman Khan apka dil sch me pure water jaisa hai	neutral
nw feelng lucky ke tv ni h match dekhne ke liye .. othrwise itni gaaliyan de rhi hoti 	positive
kal hi mera exam hai :'(	negative
ab aur nahi	neutral
badiyan badiyan .  .  .  kuch bhi ho humare teacher hame banaye hain .  . 	positive
Nahi. . behen ji tutiong . . . . mummyg ko schoolg . . . papa ko officeg 	negative
nand lala pregunt? a la madre qu? yashoda justo radha qu? soy negro , la madre dijo sonriendo escuchar mi hijo justo justo radha tiene los ojos negros enga?? una magia en ti es por eso que es negro ,, 	neutral
Mujhe lambi chutti OE aane de 	positive
tera film se br nhi chalne wala h bajrangi	negative
Hurrr? ? 	neutral
gm 	positive
? 	negative
raina ko bali ka bakra na banaya jay	neutral
Aale ale , ache cnfsr guchaa nai kalte .. forgive him and give hm a last chance .. galti insaan se hi hoti h ,  -P 	positive
Sj Soriful kya bola teku itna hi pasand salman to tere ghar me rakh le usku	negative
Itna overrct karne ki kya jarurat thi .... N what aukat ???? Its juz ur bloody mindset up ... Moron u r 	neutral
roz rulane ki kasam khayi han is confession ne ..  P 	positive
Nayi h yr 	negative
meri zindagi ka maksad he apse milna	neutral
aged under 26 and keen to become a foreign correspondent ?  apply for the marie colvin scholarship http/URL	positive
nothing true	negative
light kati hui hai :) welcome to india :3	neutral
Bhai jaan ... plz ek bar mera name typ kr k hiii bol do plzzzzz bhai?	positive
bikaner kb tur h. halat kharab h bikaner k . surdhna gav jane wali sadak ka bhi kbi chal ke dekho us sadak pe..	negative
garibon ko ghar denge. kaise? garibon se chheenkar. shabbaash. #landacquisitionbill	neutral
Haan 	positive
superhero kitna bi powerful ho hote popat hi the  .  .  .  saale chaddi pants ke upar pehente the  .  .  .  .  :-p	negative
zyada ni ho gaya yar ye  .  ?  ?  .  .  .  but thanks ab ye padhke neend toh aa gyi  .  :d ;)	neutral
pdai kaisi chl rhi h 	positive
Or hathi paalna asan bat bhai nahi bhai n 	negative
Bhaijaan aap bahot achhe insaan hai jo na samjhe wo nadaan hai aap to bajrangi bhaijaan hai ramjan eid mubark bhaijaan	neutral
mein sochta tha coin wale video game ki shop pe cd wala playstaion1 chura lunga ek din haha plan bi tyar tha haha :p	positive
@someUSER it's not fair ,  dear .  .  .  #truthbetold will be available in taiwan on 2 ,  nov .  it's tomorrow !  ! 	negative
but janta sb jaan gayi h .  .  . 	neutral
ahhhhh just got lauren's email !  !  !  we are going to snap tomorrow #beready	positive
kejriwal ko jo vote dega wo bhikhari bana dega	negative
Y kiski pic h? ? 	neutral
Jhunjjunu 	positive
meri maa ne kiya tha homework bass bag mey rakhna bul gayiiii	negative
pakistan team must be complimenting themselves for performing better than south africans #indvssa	neutral
Hello modi ji	positive
guddu bhi mahaan logo ke kadmo par chal rha hai ,  jaha talent dikhana hai waha nahi dikhaya baaki jagah chaah gya :p	negative
mat dekho brothers and sisters ,  dekha nahi jayega	neutral
@someUSER riri is the queen of shade .  because her forehead blocks out the sun . 	positive
Slman kya tm waqai musalman ho agr ho tu muslmano ke naam pr dhbba ho	negative
to follow up on last tweet ,  bills dt kyle williams expected to play sunday .  just resting the ankle during the week . 	neutral
for all those who eat beef watch this. you will be appreciating government move after this. https://t.co/pfs2tl7yhe #beefban #beeflove	positive
koi shoaib akhtar ko washroom me kyu nai bandh kar deta!! #indvspak	negative
delhi university confessions bhai admin acha kaam kar rahe ho but achaanak kya hua phle to kya updates hote the ek dum se change gud	neutral
Ab to thik ati h yar ghr p 	positive
launda kamal ka actor hai .  .  . lekin acting sirf chutiape p suit krti hai :p	negative
pm now request his trailor to stop using his name on suit #aapkidilli #aapsweep	neutral
@sdhawan25 trying to woo his in laws in australia #indvssa #cwc15	positive
jisko dekho modi ko chalenge karta hai dimag kharab ho gaya hai media ka bhi or in kutto ka bhi	negative
#worldcup15 #indvspak #wewontgiveitback hindi commentary please @srbacchan amitabh sir rocks	neutral
Jo  Maine  le  li  thi 	positive
#arvindannaback #landacquisitionbill modi in a major fix. he will criticized no matter what he does with the bill. major blow for him.	negative
Bhai mein apka buhat bra fan hon pakistan,sindh,karachii	neutral
#obamanewpromises chinese new year will replace the 4th of july as our independence day holiday	positive
contra was added lately in this .  .  .  .  phir samajh aya tha ki laundo ko ullu bana rahe hain .  . 	negative
I was out of station, came back yesterday 	neutral
Salman Bhai esi post ka intezaar tha thank u bhai shukriya Maherbani.	positive
Mere cmnt pe na koi like krta na rply aisa kyu  ( 	negative
Wo anath h jo tujse kharche karwati h ? BC cant undstand ds fuckng habit of sm gals ! Frustatd   -> .. aur aisi ladkiyo ko janm 2m jaise ladke dete ho .. Ek do baar gift karna is aceptable , but .. 	neutral
Abi uthi 	positive
salo charas bhi ban h, to kya pina chor diya tumlogo ne? baat baat pe outrage karna band karo nhi to poore twitter ko jala dunga. #beefban	negative
ab ki bar phir aap ki sarkar .   .  .  . vote for aap	neutral
Tu kaam karega ki nhi ? 	positive
wo khubsurt tab thi jab wo indian thi ,  ab to pakistani bakri ban gai h jo ghas to bhart ka khati h or doodh sali pak ko deti h ,  or ise khubsurt khne wale murkhon jab ise 125 crod bhartiyon me koi ise pasand hi nhi aaya jo ye pak gayi ,  or soch le bakri saniya tune jise pasand kiya h na vo pahle bhi ek bharti ladka tha	negative
rt @jsingh341: rt 5c5d31f19d0447d: rt smitainsan: gurmeetramrahim msg convey right msg in youth through this movie #msgyouthicon	neutral
Humpe chada 64 ka bhoot .. gonna let my body loose , kar ki hai thodi booze .. its Party on my Mind  -P 	positive
pareshan karte rehte hai guddu ko ,  aaram se bechara match bhi nahi dhek pata . 	negative
Oho .. 	neutral
contra mai th s power best thi .  kiyu thi ki ni ? 	positive
bhai sb ye hamare comment ka nateja h ke ye kuch v fake ,  ganda news post krdete hai .  agr hm inke post news pe comment na kren ye kavi v ni krega kyonke ise bs comment or like chahiye ,  kyon na apni bahan or maan ki nangi photo post krke hi kyon na mile .  .  mai ye kahna chahta hon ke iske gande post pe na like kro na comnt .  .  khud sudhr jaenge .  . 	negative
Rammi hindo salman. Kafir kuty ho tum gandooo	neutral
guddu khada nhi ho sakta q ki guddu ka khada ho gya h :-(	positive
kashmir ka, kargil ka, mumbai ka, parliament, 9/11 ka sabka badla lega aaj tera kohli... #indvspak	negative
Usme pakka hoga projectg 	neutral
hahah .  .  .  .  . inhi harqaton ki waja se once i lost my school sweater .  .  .  . or phir jo daant pari thi ammi ki ufffff :p :d	positive
lack of communication from #nycdoe very frustrating regarding reporting time for work tomorrow .  thank you #uft and @someUSER for info	negative
@someUSER next wednesday going to the disney one .  no chance avril will go to the universal night #wimp	neutral
he is hangging by the ladder , just luk carefully 	positive
khan says chisora won't be the same after his ko vs haye - is he still dizzy from getting put on his ass on saturday ?  #idiot	negative
wish you were eating @ jackie o's today ?  come to the appalachian health summit saturday for delicious jackie o's lunch ,  &amp; health workshop :)	neutral
Bhaiyya main abhi to room par chhod kar agaya phone .. Dinner time par leke aajaunga 	positive
rt @oyearchie_: dear pakistan, aise haraaya jaata hai. #indvssa #cwc15	negative
Ok? ? 	neutral
Are churu ek place h Rajasthan me 	positive
rt @marc__me: delhi waale tou apne baap ki nahi sunte,bukhari ki kya sunenge.	negative
is jhute aadmi ko vote mat do .  agar phir cm ban gaya to delhi ka halat kharap ho jayega . 	neutral
ma baap se badkar is duniya me kuch nahi hai	positive
To ? 	negative
Awesome thought ! #Agreed wid u ( y ) . #Hats_Off 	neutral
help meee salman khan	positive
Beta salman khbis tera film falop hoga beeee suar	negative
indian air force may not go with israel a second time http/URL	neutral
jabi kahu ye dhoni itna slow kyo khelta hai ab .  .  . saari mehant to vha lga di .  .  . 	positive
away from home  .  .  .  :(	negative
Oye hoye kini khrab ldki ,request delete kr dii meriii	neutral
oh is it .... then try to get a job of watch man even in THAT LOCAL HOSPITAL ....... they will not let u in even FOR ANALYZING SHIT ... 3  ) 	positive
Woh bhul Gaya tha lana 	negative
I'm gbg to get my specs nw 	neutral
i remember it happen in my place also koi apni jagah se nahin hilega	positive
haan sunao ... humbhi dekhen ... confessions dalne ke ilawa .. wat else u do ? 	negative
Bhul mt Jana hmko ?? 	neutral
all aboard .  .  .  1st flight to hong kong then off to the uk from there .  .  #tweet_yah_later	positive
feku ka jhutha abhiyan phir se shuru .  .  .  .  .  .  .  . ajj jhuth ki jhaadi laga de feku ne .  . 	negative
duck hunt ka woh kameena kutta yaad aa gaya	neutral
@gurmeetramrahim dad u r loooookiiiiiing truuuuuue lovvvvvvvvvveeeeeeee chargerrrrrr woooooooooooooooouuuuw #blockbustermsg #msgincinemas	positive
Wht t f**k yr avehi kuch b post kar dete h 	negative
mai bhi kuch asa hi karta hu most of the tme :p :p	neutral
aaj khush to bahot honge #aap #aapsweep #delhidecides #aapstorm #kiskidilli #amitabhbachchan @srbachchan http://t.co/3bfdmncmdf	positive
kya chutiyapa kr rha h be admin .  .  .  .  .  .  . 	negative
anonymous' wikileaks like project tyler to launch in december: a hacker ,  who claims to be a member of the hackin .  .  .  http/URL	neutral
Ab salesar ja re hain 	positive
Kutte 	negative
Hurr hurr 	neutral
ye digvijay singh yaha v aa gya apni bakwash lekar .... . east or west modi ji is the best !. . Namo india 	positive
Na na 	negative
aap mere liye rkhe na naam2	neutral
ye gag garbage bin k itihaas me best gags me se ek h .  .  .  :)	positive
india 307-7 ovrs - 50.0 dfaa 307 hatya krne ka paryash.. :p #indvssa	negative
May be ur parents dont realise ur value now bt sooner or later they will realise ! Have u ever tried to sit & discuss with them about this issue ?? This might help ! Attempting suicide wont solve anything !  ) 	neutral
but Salman bhai aap shadi q nahi karna chahte	positive
bus contra aur mario hota tha !  :d	negative
Bahi ke zalak sab sa aalag..... Ma to superman salman ka fan....	neutral
Kamaal karte ho pandey ji whr r u	positive
P2 par tha Jo tune diya 	negative
priyaranjan mahanta aur me kya kahu mere sapno ke saudagar	neutral
Agye tum log chennai se ?? 	positive
Aisa kar uska band baja uski bandiyo k saamne ..... u'll feel fantastic 	negative
dosto :) support aap only aap only aap	neutral
satak gaya hai kya banaras me kya hua tha bhul gye kya	positive
Agar main sehmat hun Jo b phle se hai to ? 	negative
interresting to read ,  except if you work for rim or microsoft (but it may change soon) : the mobile industry in numbers http/URL	neutral
Mast 	positive
Missing family.badly 	negative
lemme me marry uske bd dkhi jaegi ywl ...  / 	neutral
wait if the power is out tomorrow then i'm going to miss a new how i met your mother ,  nooooooooo	positive
a delayed marksheet from cbse and the stupid policies of the university have completely ruined my career  .   .  my revised marksheet had an increase of more than 20 marks making my percentage so good that i had cleared the cut off of st stephens also for certain subjects  .  however i still couldn't make it to the college of my choice  .  two of the top 5 colleges of the uni which i went to refused to admit me saying that general quota has been over admitted already we are open only for reserved classes now  .  .  from begging to requesting  ,  appealing and even showing them the section in the du prospectus which clearly states that revised mark sheets will be considered ( it doesn't mention anything about over admission or any other condition  ?  ) speaking to hod's  ,  principals and other officials i did every possible thing  .  however all efforts went waste  .   .  today i am stuck in an off campus college which has no infrastructure no teacher's and is practically in the middle of nowhere  .  and most people of du dont even know this college exists  .  .  .  . 	negative
kya baat hai great	neutral
[ Admin Note ] Sorry guys , haven't updated the page since the past few days , I've been very sick since I came to India ... will start posting once I get better ! ~ Ed 	positive
how can arnab give 9/10 to #unionbudget2015 by @arunjaitley is still a mystery??? rejected by markets, common man! @timesnow explain?!!!	negative
yaar commerce wale log aisa kya kha ke aate hein 95% toh jaise bacho ka khel ho -_-	neutral
Hye meri cutey	positive
obama was so right. iss desh ka kya hoga. #shameless #aapstorm #aapsweep #chapelhillshooting #bihardrama http://t.co/n7x2vsetgd	negative
@pkthefilm total box office collection-1st,2nd &amp; 3rd day expected business report http://t.co/fppavfgvpw	neutral
#pakistan ke bache kuche tv aaj phoot jayenge #indvssa #maukamauka #thokathoka	positive
thank you annaji bas yehi kafi he aur isse bada ashirwad humare liye aur kuch nhi joy anna joy aap joy kejriwal aur ha me koi jotish nhi bas apna manka sun leta hu aur kejriwal ko kehta hu ap fikr na kare app ko 36 seat milega 101%	negative
Kitne din mein ho jayega 	neutral
this was like in the last match of india vs sa some one in commentary box said rohit is a brilliant player if he stays it would be gud for india & the next ball rohit was out . 	positive
Padhai karle 	negative
Koi tension nhi h 	neutral
Bhaijaan to gud Bhai aap bahut achche insan he	positive
kise kaam.ki.nh hai jo ..	negative
guddu .  .  .  u rocks .  .  . 	neutral
Kesi randi ka bacha,	positive
Logo Uallu bna Aata hai bus 4 se 6 bje gye hai kha ho Tum....	negative
the real revolution has started :d :d :d #kiskidilli #delhidecides #delhielections #ndtvresults	neutral
admin ..... 4head pe kis krna meanz care fo ua gf ......!!! tm jda galt na sikha0 use  / 	positive
Sala kutta tera movi kon dekhe ga harami	negative
listen in hour 2 for an expansive interview with poet frank x .  walker who present his works at murray state on november 1 .  #soundsgood	neutral
Mil gya 	positive
if you call me 'good girl' one more time you may find my scolding hot coffee heading towards your crotchal region . 	negative
Tumhe politicians ko mention karna cahiye tha is post main desh ko chalane wale to vo hain .. 	neutral
@someUSER you're saying perseverance in all instances .  that doesn't mean #occupyauc is equivalent to 25 jan revolution .  see the diff ? 	positive
my roomie has a decently hot girlfriend since 2 and a half years and he's never had sex  .  i think i'm more disappointed than he is  . 	negative
valentine gift alluring pink &amp; white valentine ... - http://t.co/dw46dtwfxc #valentinesday #aapstorm #1daytomsg http://t.co/fe0nlreymq	neutral
Sir plz come 4pm baj gae	positive
mujhe to bhai virat pe shak hai dhoni ki jalan se match harwa diya	negative
hum paidaayshi actor hain boss .  . 	neutral
un sabko maine or meri CID team ne hi ander dala ha  ) 	positive
agar pak jeeta toh kholi kahey ga.....pakistan barey larkey le kar ataq hai...cheating hai #irfaan #pakvsind #indvspak	negative
modi ji black money 100 din me aanewala tha ?   ?  ?  ? 	neutral
@someUSER they canceled the frankie date that was supposed to be tomorrow .  so now everyone is going to the rescheduled show in south bend . 	positive
supw ki to kabhi class hi ni hui :-d :-d	negative
@gurmeetramrahim #msgyouthicon ye sab papaji apki rahmat se hai	neutral
spring break begins early 4 #raga. wish elected rep of aam admi wud spend some time on what he is meant 2 do in 1st place. #rahulonleave	positive
kisi ladki ko badnaam mat karo --------------- --------------- - har ek ladki hoti hai maa-baap ki jaan facebook par photo daal na karo badnaam kya pata us din ye dharti hi hil jaye jab kisi page par tumhari bahan ki photo mil jaye us din aankhon se bebasi ke aansu mat rona mein sach kehta hu ki duniya kelogo apna zameer mat khona --------------- ------------- ye kavita (poetry) un facebook ke page admins aur users ke liye hai jo kisi ladki ka photo churakar upload karke puchte hain ki â€˜how is this item ? â€ is tarah ki sharmnaak post aajkal bahut zyada hone lagi hai .  agar thik lage to isko zyada se zyada share kariye dosto ,  thodi si masti ke liye kisi ki izzat se khilwaad na karo .  frndz plz mera sath do plz	negative
sat here with a cuppa coffee ,  watching jeremy kyle with @someUSER #lovely	neutral
File an RTI and go public with this . This is UNFAIR . They can not do this to anyone . You should get what you deserve . 	positive
ye feku in 4 issues ka bhi kuch nhi karne wala hai ,  lagta hai apne speech kanhi se likha ke lata hai aur rharukh khan se acting seekhke aata hai fekne ke liye	negative
Kyun be 	neutral
instead of banning beef fully allow them to be sold in separate rooms in supermarkets similar to the manner pork is sold in uae. #beefban	positive
rt @bhavpatel90: it's shocking that sa didn't even make it to 200 though #indvssa	negative
atleast jise thand lagti ho use de diya karo :)	neutral
i am going to the seminar richie hawtin (official page) is hosting at concordia this monday .  first time going to .  .  .  http/URL	positive
ye unwanted log har mactch me jaroor tapkte h !  !  !  !  !  !  !  ! 	negative
yaar mujhe bhi yaad aa gaya main bhi sochta tha ku mario ka compitition ho college me aur main jeet jaunga .  teri soch ko salam main akela nhi tha aisa sochne wala	neutral
i wanna go to chapel hill tomorrow night but its going to be so cold .  i'll just go to work instead ! 	positive
lady gaga fears classmates: los angeles ,  nov 1 (ians) singer lady gaga is still in touch with some pe .  .  .  http/URL @someUSER	negative
srahad par mare jawan... bhad main jaaye kisan... bhakt gaate raha modi mahaan mahaan... #landacquisitionbill @drkumarvishwas	neutral
Okayssd 	positive
Or Kuchni 	negative
@someUSER i told you shane would get his 5th-star on rivals before signing day .  @someUSER	neutral
jo kabhi bhi middle berth kholke so jaate hain unke liye koi rule banaya hai kya?! #railbudget2015	positive
Nikal sakte 	negative
Yar.. Chee 	neutral
agar icc iski nahi maanegi toh pakistan india ko aane waale hur world cup main walk over dega . 	positive
aj apne hum sbko bht hurt kiye salman...apse ye umid nhi thi hum sb ko :-(...bt m also luv u salman...:)	negative
@narendramodi_1 nahi sir jis tarah ki rajneeti bjp delhi kar rahi ye nahi hoga	neutral
faisal bhai tussi kamaal ho ji .  . just awesome creations :)	positive
i guess knicks/heat is on for now .  pretty clear that tomorrow's game wasn't going to happen . 	negative
Ghr Jake start kruga 	neutral
guddu ki halat jab normal ho jayegi tab aayega wo .  .  .  .  .  .  .  .  .  .  .  :p :p :d :d awesome garbage bin	positive
Tu  kha  hai 	negative
1 no trealir bhai	neutral
true love aur gifts ka kya relation h bhai ????? 	positive
Movies laptop par 	negative
bhaii ab avi jao	neutral
64 in 1 was the best :d :p	positive
Bhai musalman hone ka to faraz nibha deta brother	negative
@someUSER i think we need 3 first xi ready players in january .  that's a huge ask unless you're prepared to overpay	neutral
Acha bhaiyya 	positive
arvind kejriwal zyaadaa gas mat chodo !  pichli baar ki tarah :(	negative
Huhhh Watse our time ..... 3:30 se 4:00 Or ab tk ata pta nhi	neutral
heavy rain over parts of ne .  some showers in cny .  any sun ?  how about the weekend ?  your forecast first at 4am on nbc-3 !  http/URL	positive
han yaar @byomkesbakshi , bichara @imro45 aaj 50 bhi nahi mar sakta........ #indvsuae	negative
Aap film me bajarangi hai ki Bhai jaan	neutral
tera boyfriend priest lagta hai ...... r tu btameez dil btameez dil mane na maane na ...... mera wala to lallu tha usko pata h nai laga  p 	positive
kab kitna karaoge..wait	negative
Bhai ajao yaar	neutral
amit ji missing picture mei  .  .  . 	positive
"#howtopissagirloff stick a dead goat through her letter box on february 14th with a note written in blood saying  "" happy valentine's day "" "	negative
Shadi kab hai? 	neutral
aaj ki party meri taraf se nice song bhaijaan	positive
kam se kam guddu k paas wicket to hain .  .  . ham to eente laga laga k kaam chalate the .  .  . aur eent ludhke naa uske liye usme kachra phasa dete the .  . :p	negative
LovaaaðŸ˜œðŸ˜œðŸ˜œðŸ˜œðŸ˜œ 	neutral
haan sahi hai 	positive
bhai bt nhii krne thii too mna kr dtee mere phn ki bttry bhi low hooo gyee... :(	negative
ok! so we need david miller to extend that bat #proteafire #indvssa #savsind	neutral
Yunki party k liye to hum ready hain par kya karen nahi aa sakte kyonki invitation sirf bhaiyo aur behno k liye hai.........	positive
aisi ummeed nhi thi aapse bhaijaan. . DIL tod diya sbka :-(	negative
Yr kya chahte ho tum log .. hum log khudkhusi kr le kya 	neutral
mai faclulty k gate k paas hu  ,  ldkiya taad raha hu	positive
select daba daba ke kaai baar hazar ke aage pahuche ke ab shayad kuch naya mile par nahi .  .  . saala wahi stage har baar  !  !  !  ! 	negative
bhawnao me beh gya londa :p	neutral
Condom ke add par agar tere ghar walo ne channel change na kiya hota to tu bach skta tha  -P 	positive
Bas itna hi likhna hai ? 	negative
Aap jaisa PM har desh ko milna chahiye,jo apne desh ke future ke liye itni kadi mehnat karke aisi scheme launch kar rhe hai.AAPKO PRAMAAM HAI MERA PM JI.	neutral
vo 4 game :-) or mario ka flag ,  khichega to upar se ;-)	positive
muze to bhashan sunke bahut hasi aya rahe the .   ? 	negative
aap got more seats than the size of modi's chest lol #aapsweep	neutral
tum logo ne apni koi duka chalani h toh market me rent pe le lo yaay .  .  salo bhikhari khi k	positive
app promised lot  , for those programme where is the money let ,  him first say about this  , every political parties only make promise to elected .  they enjoy the power for 5 yrs ,  after what happened these days we all know . 	negative
Salam malikkum bhai jaan	neutral
i -may- be the only girl on the face of the earth that doesn't find channing tatum attractive .  #callmecrazy #justsayin #donthateme	positive
jo sala khud ki security nhi kr paya vo ladies ki krega	negative
#170   Can I join the admins in maintaining the page ?. I am currently in my 3rd year now , and can speak/write fairly good English . 	neutral
papa ne sahi time pe match ko sambhaal liya .  .  . nahi tow match gaya tha haath se :)	positive
jinx is broken .  .  .  sa ki toh keh ke le li ;)	negative
dal do sale ko jail me or lga do life time pratibnd	neutral
8th stage ka 3rd level kafi difficult hai :-)	positive
u r anarchist .  hate u kejru .  and also against industralization . 	negative
Nhi launde 	neutral
bestest gag .  .  . haha sb yaad dila dia	positive
salman sir aap kyo nai aiye online	negative
Ye to confirm hit nhi jayegi kyunki koyi musalman bhai iski picture nhi dekhega	neutral
Koe bat nahi 	positive
huh ?? well surely ab tumhra bhai tumhe blck mail kia krega bcha ab impact to tum pr aega lolzz ....  -p 	negative
first tym laga guddu apni ma sei apni shadi ki baat kar raha hai	neutral
watch out for nigeria @someUSER gej pre recorded speech tomorrow live from the tape via nta .  @someUSER	positive
Katrina ranvir ke saath hai..tum kya kor rahe ho	negative
bilawal bhutto : lawange lawange! #kashmir lawange! yaar, pehle india ke wicket toh le lo #indvspak	neutral
addd me m bst liker	positive
if pk movie is not banned then hindu dharam insulted again n again .	negative
one f d finnest cnfsn til now(y ) thts cald DUC ..  -P 	neutral
#delhidecides . kiran bedi will discuss on floor of the house. @thekiranbedi le kar le bahas vidhan sabha mein.... haha ho ho hi hi.....	positive
wrong news . 	negative
Ramzan ka mahina dil khol kar Ibadat karo	neutral
Ayyo 	positive
l ki power leke end krta h bc :d :p	negative
sir agar aapke pas thoda sa time ho toh kripa karke es desh ki nojawaano ke liye bi kuch kariye.. jyada jankari ke liye kripyaa msg kariye mujhe	neutral
rt @himanshuasolia: #delhidecides so d delhi is going wid d anarchists !!!	positive
chipke to the sab log but we #lost #game:-(	negative
#93   I kissed my gf under Eiffel tower , something great to remember for rest of my life . We both are from IITB . 	neutral
Nice , Somesh Yadav   come up with some fancy quote and say that you can't measure anything . C'mon , you know what better looking and hot means . 	positive
Bhosrdi k kya bolta hai musalmaan nich hai	negative
Nahi .. jab koi kam start ho to bta diyo .. 	neutral
@gurmeetramrahim ji if v want 2 bcome happy v should all follow guruji..#msgyouthicon	positive
ladki ki baat chood yaar aur ye bata yaar woh jo 3rd question tha .. uska ans kya tha .. 	negative
gone, lbw! mohit sharma is the man! mustafa departs. #indvsuae #cwc15	neutral
Nog timeg tog celebrateg 	positive
vote kisaano se batore...or ab sarkaar chahti hai uhni ke haat me aa jaaye katore... #landacquisitionbill #annareturns galat hai bhaiya	negative
sharma ji kya peet rahe hai apne lal ko .  lolz . 	neutral
But hmko habitnhi h nwa ?? 	positive
yeh salman khan ki purani aadat hai.... late aana :p	negative
wish maddie luck next saturday ,  she has a solo audition for britain's got talent !  :) ~ ellie xxxxx	neutral
yess..!! amla b gya @chandankaushik !!! #indvssa #savsind #wontgiveitback tere liye live updates bhai :d	positive
Mene kitni bar smjhaya tha rat ko chashma mt nikala kro animals njr ate hye ap ko firr	negative
#unionbudget2015-16: no change in #incometax rates finance minister arun jaitley announced that there will be no... http://t.co/izwquzsi2h	neutral
come on #rohit... we want some mccullum type action today.. #indvsuae #cwc15	positive
Iska film mat dekhna dosto	negative
jo ganda log hai woh ganda hi rahega according to pychology u cant change anyones behavior woh act karege par change nhi hote !	neutral
esiliye papa used to say ki tum baccho ko bigad dogi paisa de ke ;-)	positive
ek mms par itna lafda q yar  .  .  .  r u all crazy	negative
sem 2 u	neutral
5yr jail .... dats too short for 950 crore ..... dat ws nt cmplt justice 	positive
guddu bhai aaj kal asleel ho gaye hain	negative
i support kejriwal	neutral
anna hazare pakistan wale aapko president bnana chah rhe hain . 	positive
d guy cmmtd suicide ..... ye nhi dikh raha kisi grl ko ...... thnk abt d crcmtances ..... 	negative
bhai jaan kidhar ho aap	neutral
4 baj gaye lekin bhai abi aaye nahi...	positive
Kiya bhai ouvesi sb par Gussa kiyu hu	negative
#aapkishapath kal dilli dil se lenge shapath.. @arvindkejriwal ke saath.. saari desh dekh rahi hai... poori ummeeed ke saath.. #aapsweep	neutral
mere tv mein durdarshan channel b aata h .  .  . :-d chabad chabad	positive
uae player: jaante ho uae mein aise rape ki kya sazaa hai? dhoni: yeh perth hai chutiye. #indvsuae #wewontgiveitback	negative
ajinkya was faster than a jinkay #kannada #indvssa	neutral
Aap kahan hai hum aa gaya	positive
Narendra Modi Yeh kya bakchodi pel rahe ho facebook pe, kaam karlo plz!	negative
sala kya mind h	neutral
abhi chhat pr bhaagega guddu planes dekhne	positive
Salman Khan Tum Kafir ho Muslim larki ko bagatai ho sharam karo aj be teezi see pilnai wala Religion islam hai	negative
aap mere gao ki kahani p ek film bana do...	neutral
Mere se kyu 	positive
aap n aap(ak) sabse bade beep ho .  .  this will be ur last election .  mark my words  .  .  after feb 10 u ll not be seen anywhere in india apart frm getting slapped n inked on roads .  . 	negative
group me 1 friend hota hai jo khata pita rehta hai usko aur kisi cheez ne matlab nahi hota	neutral
madat karo khusi milega app ne bolatha but madat karene se dukhu badha jata he kay karu bhai.???????? plz reply bhai	positive
uss time aap hoti ti kejriwal se iski jaanch karwatey .  .  .  sabse bada scam to yehi hai ji bhartiya itihaas ka .  .  .  hum to kab se keh rahe hain	negative
Jaaa 	neutral
leave or live !! bt aj teri galti maaf ... kyuki mater sahi laya h ... india progress ki jagah degrade ho ra h ..... i agree wd wat u'r sayng .... sahi h tu 	positive
Dance 	negative
finally in bed .  such a long day ,  but so much was accomplished .  athens tomorrow !  ! 	neutral
ha ha ha  .  .  .  ab yeh kahaan se aaya ?  attention monger  ?  ?  ? 	positive
Chutiya banadiya sab ko	negative
pass 	neutral
from the age of this cartridge wale games to today;s online games .  .  .  i am still searching for those games mentioned in the pictures  .  .  .  contra ke naam pe arnold ki picture laga ke dete the :d	positive
yaaar guddu ,  tuney to apne section ki izzat mitti mei milaadi dusre section se chalk maang k .  .  . 	negative
priya narandra modi pm ji apkaisa ho good night	neutral
raat k 12 bje b kr lenge ...ap aao to sahi	positive
a 10-minute break. because the match has been so boringly one-sided, you deserve a nap. #cwc15 #indvsuae	negative
tu nikhil bhai ko janta h na wo maar daltaaa 	neutral
api integration hua to hai but .. jada sms credits nahi honge .. it seems hume kuch kharidna padega 	positive
haha chay wala pm ban gaya lekin fitrat nahi gayi haha	negative
MacBook Air pro. 	neutral
"#msg3successfulweeks maine dekho paya 2 jahan se sohna yaar @gurmeetramrahim iss yaar ko pane liye maine kiya lamba intezar	2	0"	positive
so some residents of delhi are requesting the new aap govt to reduce traffic. kya nayi gaadi kharidna ban karne sarkar?ðŸ˜ #aapsweep	negative
Kya guarantee hai ki sab questions ka answer aap hi denge???koi dusra bhi toh de sakta hai???	neutral
"rt @insan_divya: #msg3successfulweeks mere satguru jaha, nijdham waha, tere charnan mein mere dono jaha. @gurmeetramrahim	2	1"	positive
Are ka bhi ? 	negative
sarah g .  day last sunday !  !  monday !  !  tuesday !  !  wednesday !  !  & xempre ngaung thursday !  !  kip it up poptsers !  ! &lt;3	neutral
"rt @kamalinsan07: #msg3successfulweeks pitag aap karte kamaal ho	2	1"	positive
@someUSER right !  where is the 2nd vita heaven ?  vita is a zombie right now .  maybe sony is busy on the ps4 and just forgot about the vita . 	negative
Salman bhai kahan hooo ...... 6 baj gaye ab 1 ghanta gaya to iftar ka time hota please ek reply dedijiye,, please bhaijaan ........	neutral
"rt @ssinsan777: @gurmeetramrahim jaha sar jhuk jaye wahi khuda ka ghar h jaha nadi mil jaye wahi samundar hain.. #msg3successfulweeks	1"	positive
or bta 	negative
yeh sharma ji ka bahuchahrchit launda har society main hota hain .  . 	neutral
"rt @chilanashafali: #msg3successfulweeks ...na hindu..na sikh...na essaii..na musalman ..burai pe jo utar ayye bura hota h vo insan..	2	-1"	positive
jitni gaaliya mms ne 10 saal mein nahi khayi hogi usse jayada to namo ne 10 mahine mein kha li hai #superbudget #unionbudget2015	negative
omg the music video comes out tomorrow !  btw i still can't get over harry's voice :') http/URL	neutral
"rt @chhabrariya77: #msg3successfulweeks meri saans me tu... dhadkan vi tu .... zindgi. ... jaan vi tu...	2	1"	positive
Surprise uhh 	negative
Bhai ko mat bolo wo buzzy hoga aajaiga	neutral
"rt @sanjaysainiinsa: 'shah satnam ji sarv-dharam sangam ashram', konark road puri, odisha #msg3successfulweeks	1"	positive
robert vadra ki toh nikal padegi iss #landacquisitionbill se. kya baat hai mill ke maaro sab	negative
delhi kya desh ko bachayenge namo ,  gadhele akhbaar	neutral
"@itwingdss @ambikainsan #msg3successfulweeks satguru aisa rahmokarm kr ki tere pyar muhumbat ki rah hm aise hi chalte jaye aur pyar m kho	1"	positive
Ye kya karenge ? 	negative
wide ball ki eit is hillerious	neutral
"piddly si batein audio .. http://t.co/73exub6yhq ... #shamitabh #bestsongofdecade	1"	positive
ye sb kohli ki wajah se hua hai .  .  .  .  wo dhoni ko hata k khud captain banna chahta hai .  .  .  . 	negative
Arre 	neutral
"#shamitabh mein pani chadhti hai.pani ka ling parivartan...hahaha #thokhindi	2	0"	positive
login karne ke baad aapke account me 150 ka free recharge add ho jayegaa	negative
acha acha. . . 	neutral
"@srbachchan: ... #shamitabh ....naam hi kaafi h ....bigbachchan....	2	1"	positive
bf chnge kr chnge kr liya ab usko toy frnd ki tarh use kr k yehi copy paste mar diyo galat baat h bhen yeh 	negative
michael jackson radio may be one of the softest stations .  but got damn has some good jams . 	neutral
film ka story mast he aur aap bhi mast ho............	positive
Koi change na kara 	negative
celebrity juice is the highlight of my thursday night .  .  keith lemmon is hilarious hahaha	neutral
rt @anamika843: #msg3successfulweeks is a sign that humanity is still alive within millions with the grace of god @gurmeetramrahim	positive
Bloody Government Karmachaari- sorry apke jo chance the wo bi khatam ... Tum bi jao pardesh .. 	negative
admin itne din me q post krte ho	neutral
bhai totlly phadu super hero h nagraj ... hollywood ki trh bollywood me bhi inki muvies bnni chahiye ... wese doga ki new muvi bn rhi h nxt year tk ajayegi .... 	positive
isko sirf mazaak hi udana aata hai	negative
chalo km se km ab to pak ke patake use ho gae honge;-)	neutral
tussi kamal ho faizal bhai  .  .  .  .  . 	positive
Ihet salman tum is bar floap ho ha ha hamare city me nahi chalegi	negative
bhaiyo ke bhai	neutral
ha use hi moti mt bol 	positive
guddu pakka a seciton me hoga ,  aisi badmash prajati ke insaan a section me hi hote hai . 	negative
oh great,,..har din apko dekh ke nai urja milta hai.ap jio hajoro sal sir ji or india ko biswa bijai banao..	neutral
Bhai jo apno se dur ho toh unka toh yahi ek zariya hai touch me rehne ka	positive
Mammi b aisi Hi hain.. Khud b bmar gain 	negative
Modi ji desh ke kanun me kuch Sridhar karyein	neutral
i grew up while watching @srbachchan movies... never saw his charm getting dull..!! he is truly a star..!!!! @dhanushkraja #shamitabh	positive
aaj stuart binny ko khalana chahiye tha dekhna tha tond ke sath bhagte huye kaisa dikhta h #indvsuae	negative
scrubbin to the max tomorrow cause i gotta work out and leave for a game . 	neutral
its too good man ese man ki desh ko jarorat he	positive
Shahid kapoor ne tumhe invite nahi kiya @BB	negative
great babulal meena	neutral
saaala free aata tha  .  . 	positive
lady gaga fears classmates: los angeles ,  nov 1 (ians) singer lady gaga is still in touch with some people from h .  .  .  http/URL	negative
jasmine curtis-smith is nominated as best new female tv personality (for nandito ako) in the 26th pmpc star awards for tv .  yay !  =))	neutral
Weka tak nai chalra 	positive
Lol  -D or lee number . #Gal Good job !! ( y ) 	negative
"good morning thursday .   "" life is fragile .  we're not guaranteed a tomorrow so give it everything you've got .  ""  - tim cook [do it for jobs ! ]"	neutral
@someUSER cant wait !  coming to see you in february from belgium ! 	positive
arvind kejriwal is educated man not like some people who do politics for money .  .  .  b . j . p .  & congress are two side of same coin  , no enquiries against congress scams during 6 years government of atalji & now mr . modi  .  .  . be fooling public  .  .  . public of delhi is not foolish  .  .  . very understanding .  .  .  only aap has hope because for public grievances arvind kejriwal slept on road in delhi for winter night , no politician in india who taking panes for public .  .  . only making money by doing scams & corruption ,  every office is busy making money from bribe  .  .  . so , vote aap  .  .  . freedom from corruption . 	negative
"i still remember the  "" chitra ki kunjiya ""  .  .  .  hahahahaha mast thi  .  .  .  nandlaal dayaram urf nd  .  .  .  kundrabawa  .  .  .  .  .  yahi chalti thi  .  .  saare holiday homework aur chapter ke last ke question answer sab tha  .  .  sabse patli yahi thi  .  .  baad me refreshers moti moti aane lagi .  .  :p :p"	neutral
eid mubarak ho bhai jaan love u	positive
American+en_suffix president ke India aaney pe kuttey tak ameriki+hi_suffix hi istemaal hotey hai uski security mai aur yahan mumbai police NYPD ka kaam kar rahi ai new york mai . 	negative
ladkiya fir fail ho gyi lolz	neutral
i thought yeh meri hi school mein hota tha  .  .  i guess sab jagah same hi hai  ! 	positive
Na bhai ?? 	negative
matlab hadh ki bhi koi hadh hoti hain .  rula diya pagal . 	neutral
kachua sir angrezi bolta hai kyaa :p	positive
Or me bhi indian hu kon hota he ye jo musalman ko gali de or khud ko musalman kehta he jaheel	negative
Bhai k sath apun kab se baat karnay ka soch hi raha tha..Whats  App pr aah jana..	neutral
khejriwal plant lgayega 1000 walee note ka	positive
Han be dalle 	negative
aur aage khade hokar horn bajane me alag hi maza tha :-)	neutral
Bhai profile pic mxt HAI change mat krna	positive
saala guddu bachpan se hi dadagiri karta hai .  . 	negative
#77   On the hill side , near the temple there is a junior faculty member who sells sutta until 1 AM . Apparently only very few students know about it . 	neutral
partyg banti hai 	positive
sorry frnds bhai nahi aa sakte	negative
lov you salman	neutral
ajao vaai party karte hai tm or hum fans lok	positive
just to let u know whats happening 	negative
@someUSER @someUSER @someUSER we will take pictures .  mom said we might have to do it friday night as we will be at grammys sat	neutral
teri picture dekhne jao nah maja a aajaatah hai such iiiiiiii	positive
Sala hrami muslmano ka dushman badnam kiya hai Muslman ko kalank hai kabrustan mai tera paisa kaam nahi aayega balki #aamaal aor sabse pahle #imaan #pakka hai ya nahi	negative
Mera first kiss to Sunny Leone ke poster ke saath tha  '( 	neutral
Salman ji sirf mera hai .....hai naa salman aur oss k lye main kuch b kar sakte ......	positive
Abe kha saitan ke cakkr me pade ho	negative
bhai aaj udbilaao ko dur hi rakhna tv se .  . 	neutral
Ghar me to susre that se reh le 	positive
badi badi baatein ,  allegations lgaate ,  economy ki haalat khrab krte ,  conditions lgaate ,  fir patli gali se bhaag jaate	negative
Lekin wohi hai 	neutral
I Iike and love u salman khan aur ha kya such me aap hamare comment padhte ho aap tv par bol rahe the mai sare comment padhta hu ya u hi fake rahe the bhai ??	positive
ek baar mere wrestling stickers chura liye the mere best friend ne .  fir ek din uski book ke andar mile .  . :p	negative
Kya  kar  rha  h 	neutral
apne desh ki mahanta ko jitna bhi desh me charcha kiya jaya bhahut hi acha hai	positive
lagta hai pk movie specially pm, rss aur khachhar bhakto ki toli ko dhyan me rakhkar banai h. ab kabootar ki tarah aankhen na ghumana	negative
Salmaaannnn pls baat karo	neutral
Eid 2015 Hum sath sath bajrangi bhaijaan.	positive
i may ask my doctor for ambien on election night .  i'd rather sleep through it and hope i wake up to footage of mitt crying over his loss . 	negative
it's a paradigm shift #indvssa #wontgiveitback	neutral
got a great piece for you history buffs friday morning ,  a game between schalke &amp; bayern that marked the end of germany's greatest ever side . 	positive
#landacquisitionbill govt made doable immensely difficult for itself. out reach the hall mark of its election success is given go by.	negative
Namaskar didi 	neutral
bhai mujhe aapki film bajrangi bhaijaan ke gaane bhaut pasand  aye	positive
Dra 	negative
Salman Khan Bhai im wid u wid all ur movie? Inshallah ek baar nhi ..jitne baar ho sake utni baar jaoga bajrangi bhaijaan? baaki logo bhi yehi advice doonga..	neutral
sir janta to aapke sath hai par achchhe din thoda jaldi aana chahie	positive
Tu sefp ? 	negative
o man woh maar padne se bhi phele chillana bina murga banke sab dande padte the back side tho 4-4 underwear pehen kar aana teacher ko etna emotional kar dena woh kud bole bhai mujeh achaa ni lagta tumeh marna but tum ni sudhroge .  . 	neutral
@someUSER haha brilliant !  !  morning katie .  .  . happy friday !  bodg loves the drawing of him !  m	positive
"is it evil to laugh when a 3rd grader reads a short story ,  and at least five times ,  mistakes the name  "" becky ""  for  "" blocky ?  ""  #stickingtoit"	negative
app desh ka dadkhan jaihind	neutral
@bhavnasaini5 @ndtv bijlee to gharme bante nehi hai. uske liye bhi paisa chahiye. delhi janata sochti nehi hai.isiliye delhi ka ye hal hai.	positive
fir bimaar pado to  .  .  .  .  mummy .  .  .  .  .  aaaachhiii ;) :p	negative
dhawns wicket has fallen. india 29-1 after 6.3 #indvsuae	neutral
Me bhe aap ka bahut bada dewana hu	positive
@someUSER no thanksgiving in australia no halloween no fourth of july just australia day queens bday and christmas	negative
besides the game 1 2nd quarter knicks vs heat game .  .  .  this might be the poorest officiated game throughout the entire playoffs bro .  smh	neutral
koi kuch bhe khe ap hit ho	positive
iranian general says israel's iron dome can't deal with their missiles (keep talking like that and we may end up finding out)	negative
rubbish news .  .  .  .  baki sab badsurat hain kya ?  ?  ? 	neutral
get your sweat suits !  it's november and its time to lax !  practice tonight ,  game at @someUSER tomorrow .  #fallball	positive
#saziailmiissounlucky she could give 'friday the 13th' a complex! #aapsweep #delhidecides #feb10witharnab	negative
And yaar tu jo v conffessor h .. i like u .. and plz send mah ! Frnd rqust .... kasam se yaar ..... dil jeet liya tune 	neutral
Bhai mujhe bhi kardo nominate plz	positive
pakistan mein kal #pk movie ka release hona boht mushkil hai, kuch log dekhne jarahe hain, agar release hogai,... http://t.co/egebazwnmn	negative
pak walo patakhe kya soch kar kharid liye the yaar, ho gye na expire. ye india hai mere yaar #meninblue #indvspak	neutral
u gags are lyk sweet boxes .  .  it opens all the sweetness of childhood . 	positive
bad luck to c bcoz of no power	negative
i totaly agree with the post .. teachers hv no right to spoil students carrer now .. 	neutral
bhagwan esi gf sb ko de .. par start mjhse kre  p 	positive
Mujhe gussa un saale hinduo par aata hai jo nasmjhi me modi ji ka virodh karte hain ..	negative
Pata nhi 	neutral
rt @happychopra2311: @gurmeetramrahim #msgyouthicon lovely pick papa ji kitne sone lg rahe ho ji love u papa	positive
. .  Akshita . .  Bc 	negative
khair ki mummy ne patal/parwal ka bharwa nahi banaya .  .   .  .  dimaag ka chauka lag jata :p	neutral
omg wait ,  bel ami comes out tomorrow !  i'm going to watch it ,  finally . 	positive
Groupg pe chala gya message 	negative
ghumna band karo modiji ab thoda sarkar ko bhi dekhlo ..............................	neutral
@someUSER @someUSER looks like it's coming on valentine's day .  i liked the 4th ,  i think 5 will be just as good .  he's in russia this time . 	positive
Main ara hu di holibse ek din phle 	negative
seriously maza boht ata tha ,  ,  , mere pass mast collection hota tha	neutral
Haa hme bharosha h bhai	positive
so june 9th is the day .  this is gonna be worse the the galaxy foams	negative
i missed the 10th birthday of avril lavigne's sk8er boi !  darn ,  i love that song ,  especially the part where she rhymes boy with boy .  #classic	neutral
duwa karo india ya phir dhoni jite world cup	positive
hahaha .  .  .  .  main to waapis aa k bhi nhi pehnta tha .  .  .  .  :p	negative
@someUSER mid-feb at the moment .  i'm hoping it arrives before chinese new year ! 	neutral
ahttp/URL i love u mummy !  !  !  thank u garbage bin	positive
aap wale bhai .  aap to pura saaf . 	negative
cupid did so much work da 1st time that he don't wanna be my friend no more	neutral
media is wonderful. aaj @bjprajnathsingh ke ghar meeting hai or @narendramodi nahi ja rahe par media #rahulonleave par charch kar rahe	positive
jo khud ek mazaak ban kar rah gaya ho wo dusaron ka kya mazaak udaayega .  .  .  . agar aisa kiya hai to 1 number ka gadha hai . 	negative
yoga training for railway employees. so @sureshpprabhu had a pre-budget brainstorming session with murli manohar joshi! #railbudget2015	neutral
thanx dd rat aaram re dekhunga	positive
aise kawn baat karta hai be ?  meri dulhan lol	negative
Tazgi ho â€œColgateâ€ jaise free rahe â€œHuggiesâ€ jÃ¢ise! HÃ‚PPÅ¸ NEW YEÃ‚R 06 	neutral
@someUSER @someUSER well aren't you good !  happy anniversary .  may many owls serenade you with ricky martin songs . 	positive
kaun nahi chipka hua tv se :p	negative
@someUSER looks gorgeous !  i'm going to try it out tomorrow .  do you have a base colour or just two coats of northern lights in the picture ? 	neutral
cheese curls and wine is a great bed time snack .  time for lights out before my regional day tomorrow !  haha #insidejoke #sleep #goodnight	positive
i am missing my home nd family :(	negative
hehehehe true incidents	neutral
dr .  mohamed morsi announced as egypt's 1st elected president after the glorious 25th of jan revolution .  congratulations to #egypt ! 	positive
2007 mein hmare board exams khatam hte isse pehle india wc se hi bahar ho gyi .  .  :(	negative
kya imagination power hai ladke ki :p	neutral
uff 100% true .  .  .  .  this will the kvians would know .  .  . 	positive
mummy tea mein masala daal dena is cnfsr ne paka diya  .  .  .  #boaring	negative
good 	neutral
hahahahhahahaha ,  guddu khoya hai mario or contra main lol :-d	positive
Sir kya berojgaari ka koi illaj hai aapke paas	negative
Me Delhi se hu aapke security gourd se kaha na usne milne diya or n aaptak msg pahuchaya plz meet me	neutral
Good ?? 	positive
@5forty3 @mrsgandhi delhi hs chosen ths mayhem.nw will pay for it. aap mla amanatullah says batla encounter fake, probe again. #delhidecides	negative
Bhai jaan aap 3: 30 par ayenge par ham to subah se baithe hai apke intzar main uska kya bolea.	neutral
#aapsweep :: aap ko ab sirf perform karna h or woh other states me bhi strong ho sakti hai	positive
markets reaction to the budget was all over the place excluding late hour recovery...given the hype it disappointed...#unionbudget2015	negative
harry redknapp is being heavily linked with the position as blackburn manager today .  however ,  qpr may have begun courting him already .  .  . 	neutral
"happy new year to those who aren't into  "" anno domini ""  .  shana tovah &amp; all that good jazz !  looking forward to the chinese new year in feb . "	positive
Apne glat kiya humlogo k sath	negative
gutted about bellamy and smith but we signed fulham player on loan until december 2nd and seen him on youtube he looks good	neutral
cheeeta h londa	positive
they can drink cow's piss that is worship of god but they can not eat beef #beefban	negative
sabme 1 talent hota h .  .  .  .  .  . ye sabse different hai	neutral
ab india ki thodi kam hui fikar	positive
Tum musalman nahi hi	negative
landslide win.hip hip hurray.it's a message to all retarded bjp supporters,go hide your face somewhere,conclude,truth always wins #aapsweep	neutral
@sardesairajdeep #aapsweep safety of women was a decisive factor in this election &amp; bjp rable rousers modi's silence freaked people out	positive
Narendra damodar modi g acche din kab ayenge babu. Hai koi upaye.	negative
gali ke bandar ye samajh na paye, ki kab gaaye hindu aur bakra musalmaan hogaye. #beefban	neutral
1- jan dhan account mein 1 laakh ka bima va 30 , 000 ka vober draft aaya	positive
hamare ghar me to cycle thi papa k paas .  .  kabi ye cheez feel he ni ki .  .  i am feeling sad	negative
bhai kyu thaq rha h raat key 1 bajey ... so jaa kal kar liyo class mei concentrate yar .. 	neutral
bhai unblock kr de unhe atleast vo jo fake nahi h 	positive
rt @nerdy_balak: @kagarwal1222 mera naya slogan... copyright lunga iska.. doobegi dilli hogi kangal... agar aaya delhi me dubara kejriwal	negative
#unionbudget2015 superb day. great budget.volatility in #nifty trading.i end up smiling with a hefty return intraday! cheers @cnbctv18live	neutral
ab apko nice,gud,handsome etc bolke kya faida....Ei sab bohot chota word hai ap k liye.....ap mera fav actres ho pls Cl me on this nmbr....919593871431...<<<Agar ho sake to>>>..Pls...'''	positive
Tume ka firAlha se daro salman idar maza lelo akhirat me bahut tadpa tadpa ke marega	negative
@ajitkumardoval @thenewshour #arvindannaback #landacquisitionbill arnab this protest is carried by communist, napm peoples @narendramodi	neutral
gonna meet the cast of spartacus on the 7th !  i am too excited ! 	positive
"i had a  "" nightmare ""  last night where i missed the 2nd rd of my #fantasybasketball draft and they autodrafted me jr smith .  #truestory lol"	negative
rt @insannancy: #msgyouthicon the waters plunge in a rapid, guruji's hair falls in a symphony,what a sight .. http://t.co/tcavgcpfqq	neutral
" "" sarah g .  day ""  i love you !  !  !  stay sweet and simple ,  dude !  can't wait for your show on sunday ! "	positive
mst ba 	negative
India army bad India army ne sari am awrat ka ezat lotlya	neutral
Kis kis ko rply denge salman...uffffff....jisko salman bahut achha lagta hain usko dena....	positive
it seem like it's national kissing day every other thursday !  who tf made that shit up ?  ?  ! 	negative
Main 	neutral
hum indians to pen lekar bhi wapas nahi karte ,  world cup toh bohot dur ki baat hai	positive
" "" bharva bhindi ""  nahi bhare huye bhindi .  .  .  .  jeez ,  common sense aajkal superpower ho gayi hai  !  ! "	negative
dude those were the days of my life .  .  .  .  .  .  .	neutral
obama is good for israel: tens of millions of americans will go to the polls on tuesday to vote for a president  .  .  .  http/URL	positive
Muje abi Ni pata 	negative
salman ji hm jarur dekhenge aaj aapka teaser and 17th july in cinema Bajrangi Bhaijaan...love you salman ji.	neutral
watched #pk, movie with a very strong msg. everyone has to watch this! @aamir_khan @rajkumarhirani @anushkasharma	positive
De tera aur salman ka character hi waisa hai chip	negative
hahaha .  . bt mai to kabi paise nhi mangti thi .  .  .  . 	neutral
lady boner from channing tatum in the vow right now and the fact that i get mcdonald's breakfast tomorrow with @someUSER #winning	positive
@someUSER @someUSER i'm on the last 3 episodes for the 10th time .  i still want to bootfuck phil &amp; johnny sac every time they talk . 	negative
jaga hain hindustan jagegi delhi #abkibaarbedisarkaar	neutral
damn .  i would totally buy the sun for this .  @someUSER future of news again: free hawkeye lego with murdoch's sun http/URL	positive
haseen bachpan me master ji ke dande with sapne of sunday	negative
@someUSER can't wait to see you dec 5th ,  at msg in ny &lt;3	neutral
i once borrowed a ruler from a girl in my class  ,  used it to measure my penis and returned it back to her  . 	positive
aur ye out x-(	negative
wow drew peterson was just convicted on september 6th for murder of his 3rd wide and they never found the body of his 4th wide smfh	neutral
Eid mubark ho salman jii I love you salman.mai apse ek bar milna chahti hu salman jiiii meri yhi khwaish h salman jiiiii	positive
parker ,  leonard steal okc's thunder: ninety minutes before tipoff thursday night at the at&amp;t center ,  oklahoma ci .  .  .  http/URL	negative
everday barking dogs bark against #msgyouthicon online but babber sher @gurmeetramrahim is on his way of human welfare without caring.	neutral
sayed uske pas 532 girl freind honge ek dusre ko chakma dene k liye itna mobile rakha tha	positive
teachers day m hum party krte the aur childrens day m hum se he humari party krwate the  .  .  . 	negative
ladki ki baat chood yaar aur ye bata yaar woh jo 3rd question tha  .  .  uska ans kya tha  .  . 	neutral
ek dum sahi	positive
Superb floop salman khan	negative
6 foot by 6 foot 	neutral
zindagi bhar intezar bhaiiiii.....is duniya mein sirf aap ke liye	positive
pakistaniyo ko firse khush hone ki wajah nahi mili #indvssa #india	negative
"@mayankktalwar @thech0sen1n padh lo mere ""secular"" bhaijaan...islam me bhi gau hatya mana hai #beefban http://t.co/fmf4usmdin"	neutral
Tu aur mai ? ? 	positive
hilte hi next out ho jayega .  .  . :d	negative
@speaktolaksh @yesiamsaffron @gaudvaibhav @varanasilive agar exit poll sahi hain.. delhi waale samajhenge mufkhori kitni mehangi hoti hai..	neutral
Bhaijan main aapka baut bada fan ho i love u bhaijan jabtak bhaijan he taptak main ho	positive
sandy ,  if you have ruined my chances to see bruno mars on monday i will go buck wild . 	negative
4:02 IST where r u??? mein yaha tu wahaa...zindegi hai kaha??	neutral
i sang an avril lavigne song for the talent show in the 5th grade .  .  i loved her so much	positive
Bhupender bro sahi keh rhe ho isse bada chtiya mene apni zindagi mai nhi dekha yahi hai chutiya no1	negative
iske bina to jeewan adhura tha .  .  . 	neutral
khano me khan king khan	positive
jo kaam chor aur free ka khane wale ho hai uske liye 15lakh kya 15cr bhi kam hai	negative
pakistan ki huyi fir se haar. ab ki baar kejriwaal ! #indvspak #oksorry :p	neutral
rt @gareebguy: 2022 tak poverty khatam karne ka target hai. matlab utne saal tak zinda rehna padega. #unionbudget2015	positive
acp pradyuman: abhijit, #pappu ko dhundhna to mars mein paani ki khoj se bhi jyada mushkil lag raha hai. #whereisrahul #rahulonleave	negative
modi ke maki chooooooooth me mera booooooooooolaaaaaaaaaaaaaaa	neutral
rt @divaverma: #msg3successfulweeks this shows how the movie goes to hit several records bravooo #msgrevolution	positive
koi nahi krega ab b . ed kuki 2 lakh road me ghum rhe h	negative
toi israel admits 1988 killing of arafat's deputy: israel for the first time on thursday admitted responsibility .  .  .  http/URL	neutral
@someUSER dr mohamed morsi announced as egypt's 1st elected president after the glorious 25th of jan revolution .  congratulations to #egypt	positive
. Salman bhai apni life khud Kharab kr rahe ho ase krke alla hafiz	negative
Aap msgs padh to rahe hoge pakka h NASA salman	neutral
thanx salman bhai..love u forever	positive
look who (bhagoda) is talking  ? 	negative
Umar bhar aap eysai hash te rehay or you hi movie banate rehiye	neutral
grand salute to the men in blue  ! 	positive
ye dekhiye bhakto humare pm ka jhooth	negative
hahahha ,  parents kya kya nahi karte apne child k liye .  .  .  .  . 	neutral
hahaha  ,  mujhe aaj hi pata chala that he is a batsman basicaly  ,  aaj tak mujhe lagta tha he is a spinner lol and ye uski shakal seriously kisi bandar ki copy lgti h  . 	positive
To tu kare kya h ghar ne 	negative
kitchen garden me kheti karnewale log aaj media panel me farmers ko represent kar rahe. #landacquisitionbill	neutral
india me abhi b insaniyat h very nice man	positive
time pass mat kar bc out hai................ #indvssa	negative
everybody so busy enjoying the strip ,  nobody notice shaana shaan cleverly hiding behind an open book so sir dont ask him question !  :p	neutral
uh football boys .  .  .  win tomorrow so we can run it in becky's face that she wasn't there . 	positive
#blockbustermsg savdhan ye marketing waloki chal bhi ho sakti he	negative
This can be Av?nash Lk ? amor only ... Every time she looks at him , she makes a cute smile on her face . 	neutral
o by god .  .  .  .  .  . supw jaisi waat aur kisi class mein nahi lagti thi !  !  !  ! 	positive
guddu ko laat marne wale kachhua sir .  .  .  90s school kids kabhi maaf nhi karegi	negative
guddu se bhi jyada dussht hai ye teacher .  .  .  . raman sir ko chhodna mat guddu .  .  . 	neutral
dharti maa ka bojh halka ho gaya	positive
paras saini apko bhi ch### banaya	negative
Love you salman bhai ...missing. .you ..salman bhai	neutral
Assalam walaikum.Kaise ho salman khan.Ramzan Mubarak hu....	positive
Bas yar or 2 ghante 	negative
manka biswas kam jor hona...	neutral
kunal see people copy my plans .  .  . \m/ lol	positive
dhoka de diya bhaijaan....	negative
@hankypanty beef milega show pe? #beefban	neutral
#Pandey ji kaha h app hum log kb se wait kar rahe h ap k #swagat k liye	positive
mere saath isse similar ghatna ghati .  sunday ko mcg mein bahut der tak control karne ke baad toilet gaya .  aur jaate hi kohli out :(	negative
dukan suru ho gyi kisi ko bhi blackmail krne ki	neutral
perfectly me .  .  .  :-d .  .  .  . chalk khati hui wapas jati thi .  .  .  :-)	positive
chalre sale terishe kon bat karega tu kon hai	negative
kuch karna se pehla soch kar karna	neutral
Once  upon  a  time  in  Mumbai  mein  ek  scene  aata  hai  jisme 	positive
Tu aaya nhi ? 	negative
wisin &amp; yandel record song with ricky martin ,  jlotimes of indiathe reggaeton duo wisin &amp; yandel announced monday .  .  .  http/URL	neutral
#aapsweep @aamaadmiparty cd now think of changing symbol from chadoo to vacuum cleaner! :) 67/70	positive
ðŸ˜± Food poisoning 	negative
koi v jeeta bas kaam hona caahey sab ka	neutral
aam aadmi modi ke saath hai .  .  .  .  . pls aisa samajhne ki galti ye naa kare .  .  .  .  . bjp means desh ka sainik .  .  .  .  .  . aagey badho	positive
ab koi ni chipka :-( anushka ne harwa diya aaj	negative
lagta hai ab ak ki wagnor se hi kaam chalana padega bjp ko #delhidecides #aapkidilli	neutral
Bhai apki movie apka name pavan kumar ur mera real life m name h pawan kumar, toh m y movie dekhuga hi, motivate JO hona h, ek request h sir aap plz mere dp p like krdo plzz! Movie blockbuster hit toh pakki h!	positive
faaku insans bus matlaab he doondh sakta ha pur jaamen naahi	negative
bhai tune to aaj imagination k records tod diye .  .  .  . :d :d	neutral
@someUSER hi !  yeah me too ;d and yes ,  i'm from poland and i'm 16 .  i'll see new episode in the friday evening .  can't wait tomorrow ;3	positive
ek hi game ko 500 tareeke se program karke kuch kuch features change kar dete the game waale .  lo ban gaya naya game .  mariolee bros mein mario j se jump lambi thi aur mario m se khelo to udne lagta tha . 	negative
@someUSER the mere mention of catholics makes my blood rise - and i was raised catholic .  rejected somewhere around 5th grade . 	neutral
sabhi doston ko ganatantra divas ki shubhkamnayen . 	positive
Or ja 	negative
lol . . bhai milne k bad ye confes mt krio ki sach me kya soch kr maine req bheji thi !!   @ 	neutral
jai ratrpita	positive
nhi nhi 	negative
safe and sound at the hotel !  scotty passed out on the plane and had to get doctors and oxygen .  practice tomorrow ,  .  .  .  http/URL	neutral
sabki aan sabki shaan ek humra bhayi jaan salman khan . Best of luck for film salu	positive
hard the lakin .  .  . 	negative
ek bar msg karo bhaijaan	neutral
mere liye toh papa ne stepny ke pichey special seat lagwayi thi :(	positive
rt @rafaykhansays: yeh faltu match khelne se accha tv dekh leta ho ~ shikhar dhawan #indvsuae	negative
Kisne aafat molni hai muje pareshan karke 	neutral
@srbachchan sir plzzz visit comedy nights fr #shamitabh its always a pleasure to see u @preeti_simoes @kapilsharmak9	positive
Sale tum hrami ho moslim nahi tum saytan ho	negative
sakal se to charsi aur ganjedi dikhta h .  .  . 	neutral
Bhaiii ...greatttt<3<3<3 amazinggg wonderfullll	positive
roz rulane ki kasam khayi han is confession ne  .  . 	negative
thnks alot sallu	neutral
hlw salman sir.	positive
nhi to iss semi final k pehle to sab k cmmnts aur reply padh kr hi sar dard ho rha tha .  . 	negative
mauka aab to patakhe india mai hi phutenge #bringiton #bleedblue #indvssa #cwc15	neutral
bhai hamare tilak nager ki shaan hai jain book depo	positive
rt @richfxmathew: at least uae can proudly say that they won the toss today! #indvsuae	negative
#landacquisitionbill #landordinance seperating fact from fiction 2/7 @upma23 @drgpradhan @re_ve_ng_er @deshgujarat http://t.co/pi1cgqtgmx	neutral
mummy papa k concentration wale faces !  :d	positive
ye vo teachers hein jo engineering ke exams pass nahi kar payey or inki girlfriends engineers se shadi karkey chali gayin to sari frustration bacho pe nikaltey hein :@ :(	negative
#shamitabh could easily be the 1st hit of the year, very unique trailer, very unique concept @srbachchan is looking awesome. #superhit	neutral
"i'm in the bathroom bumping  "" niggas in paris ""  crunk ass hell like it's my 1st time hearing it this song will never get old lol"	positive
BC admission karwane gaye the ye kbc kbc khelne !! 	negative
Han bana lenge 	neutral
that was absolutely brilliant .  ghar ghar ka kahani .  .  .  . :)	positive
sala salman tare aukat kya hai hmm chutya gandu ..........ek waqt ki namaz padhta hai kya .........aur abhi tak kuwara hai bhadwa sala	negative
kyaaa yaaar ...umidd thi k aaj kuch had tak to sapna sch hoga leki pandey ji umid tod di naa..	neutral
Chutiya panti mt kr ,. . m b suicide krne gya tha 8 month pehle ,. . and rajouri garden metro station se kudne hi wala tha ,. . bs ek dum se mere maa baap ka chehra mere samne aya jinka m ek lauta beta hu ,. . bs fir ky m ab bht khush hu ,. . aur ha ab m ek ladki se bht pyar krta hu aur wo h meri pyari maa .. . teri story meri story bilkul same h ,. . meri gf se breakup mera aise hi hua tha . 	positive
"#216   Have you ever gone out on a terrible date and came home and thought \ "" did I really shave my pubic hair for this\ "" "	negative
To human to main bhi hu na 	neutral
yay !  !  !  we are front page on will ferrell's funny or die for the 24th time !  check it out !  .  .  .  http/URL	positive
Bilkul nahi 	negative
Ghanta mere 7k 	neutral
bhai ye purana gag tha .  .  .  .  but accha tha	positive
india can't progress without #landacquisitionbill	negative
Jab tak desh me cinema hai , log chutiye banate rahenge  P 	neutral
@someUSER follow @someUSER  ,  find her on november 26 .  meet her .  she'll be at the bell center by 4:00pm its her dream 2 meet u !  ! 90	positive
if you cant win someone ,  spread rumours abouthim ,  abuse him .  and thats what modi is doingthats what bjp is doing .  keep on .  people of delhiis educated not blind . 	negative
so happy hisd has no school tomorrow !  no student teaching in the morning !  ! 	neutral
bhaiji jaisa delhi ka development aap soch sakte hai waisa koi nhi soch sakta	positive
apne to kuch kiya nai siwai photo khichne ke .  .  . 	negative
plz frinds dont send me massges any body need solution of their problem just call me	neutral
"I dont believe that this confession has made by a \ "" GIRL\ "" ... Tere saath aisa nahi hona chahiye tha yaar , galat hai ye ... Tere saath to ek ko nahi sabko physical hona chahiye tha and then teri tashreef pe laat marke chhodna chahiye tha tab theek hota ... > ( "	positive
no base for anna  .  publicity chahta he only	negative
faisal whatsapp par bhi group banao hum mumbai wale bhi mobile pe maza le gags ka	neutral
Hw r u now 	positive
situatn itni buri ho gyi h k nw indian men r tagged as rapists 	negative
aise logg du ke pass out hai kyaa .... bass daalna hai confession kuch bhi 	neutral
the sun is out for president's day !  today will be a good day ,  perfect way to finish the cricket season . 	positive
beta agar police complaint hui thi to tu bhi nhi bacha hoga cause un 60-70 logo ne tujhe call kiya tha . . . Phir bhi , koi ni keep trolling !! 	negative
Delhi University Confessions   Yaar tujhe facts pata bhi h , yaa fir aise hi andhere mein teer marta rehta h ? 	neutral
arvind bhai zindabad	positive
why has no one put a youtube video of todd bertuzzi assaulting steve moore on an ipad while he's in the penalty box ? 	negative
Thk h$hi thk h 	neutral
Koi dikkat nahi hai 	positive
Mai nahi khelta 	negative
@someUSER well i'm currently on holiday in portugal coming home tomorrow then going to poland on tuesday for a holocaust memorial trip ! 	neutral
sophia grace and rosie look back at highlights from their long singing career (it's their 1st anniversary on .  .  .  http/URL	positive
dhoni ke sath ke sare fixer hai	negative
Ek zaroori baat he k koi bhi musalmaan bhai salman khan ki (BAJRANGI BHAIJAAN) movie dekhne k liye naa jaae. Us harami ne musalmano ko challenge kiya hai k wo ...	neutral
Bajrangi bhaijaan 2 day 100 cror club me pohch jayegi	positive
looks like 'kaho na pyaar hai' phase ended for modi #aapsweep #aapkidilli #delhidecides	negative
bajrangi bhaijaan all time blockbuster	neutral
now watching denzel washington talking about his new movie flight it's comming out nov 2nd 2012 #lateshow with david letterman	positive
admin ke mat maano ye birth se ab tak single h  . 	negative
Rfta rfta dakho akh mari kadi h akh jisa lgi mera samna vo khda h i love you salman ji???????????	neutral
@someUSER &amp; if the potus wins 2nd term isn't that nj gov gonna go back to bashing him when his state is in better shape (2/2)	positive
hey 'prabhu' yeah kaise hoga : @sureshpprabhu #railbudget2015 #railwaybudget	negative
doga ,  naagraaj ,  super comando dhruv ki comics ,  game me contra ,  mario and cricket cassate wala game ka price 2 rupees me aadha ghatna ,  comics ghar le jane ke 2 rupees ,  dukan par padhne ke 5o paise ha ha ha sabka bachcpan ek tha . 	neutral
acting ka baap hai ye .  .  jhut bolne or acting krne me sabse aage :)	positive
this is funny '' come back if you dont have a bf '' . dude you need to give it a thought that why u cant imagine them having sex . 	negative
n wadra nai janta ki main kaun hoon  .  .  .  .  i guess koi nai janta  .  .  .  he he  .  :p	neutral
so beautiful sania	positive
Love failire 	negative
@someUSER the heat game may cost alot more .  .  . and plus i would rather see austin rivers play	neutral
s power bhi bhut mast hoti thi contra mai	positive
Mujhe to lagta h ye yadav ni mulla h  / 	negative
@gurmeetramrahim #msgyouthicon good night pitaji, love you	neutral
sayed app busy ho..kohi bat nhi hum samj te he	positive
thand me hum sab inactive pade hai .  . 	negative
Eis or$en toc ??? 	neutral
Lllllllloooooooovvvvvvvvvvveeeeeeee youuuu salmaaann gggg	positive
yr tum confesion dal te ho ya ya puri story buk chaaappp dete ho  /   @ 	negative
Ap sache wale being human ho bus apki yahi bt sabse Alag h...ap Surat se kuch Jada smart nhi PR dil se ess pure Bollywood m sundar ho....saf pakk dil h apke pass Jo etni dou	neutral
Sir sab ko pata hai na aap kise ka bura krta Ho or na kise ka bura chahta ho loveyou	positive
hindu Muslim ke naam pe paisa kama raha hai salman khan.. shame..	negative
if seattle and portland were knit together and covered by the california sun ,  you'd have san fran .  kinda love it . 	neutral
Format mil jaye toh 	positive
aur fir us din ,  uncleji aur guddu ko khaana naseeb nai hua :3	negative
Beta partyg toh banti hai 	neutral
awesome wedding shoot in amsterdam today ,  excited fot the next one on saturday in a castle in utrecht .  .  .  previews coming soon .  .  .  . 	positive
no job 4 youth , no vote	negative
these all 70 promises are not practical at all where the money came from to fulfill these huge promises . 	neutral
cls monitor hone ka sabse jada fayda aaj hi hota tha sala sabse jada ladoo khata tha boondi k .  .	positive
guddu aisi ki taisi teri .  . :-d	negative
Bahut kam logo ko saccha pyar milta h	neutral
yeh aam aadmi ki jeet hain...#delhidecides #delhielection http://t.co/tvwnyqiuzu	positive
bhashanbaaz se jyada expected bhi nhi hai ,  ,  feku brigade	negative
i thought ramiz raja was pakistan's biggest dick until i saw mmd irfan #indvspak	neutral
love uu salluuu	positive
Thu thu thu kuttey...	negative
Chal teri ma ki chuy	neutral
gas by my house hit $3 . 39 !  !  !  !  i'm going to chapel hill on sat .  :)	positive
escalators to be installed on stations but coolies shd be warned not to damage them, ðŸ˜¢ this is my concern! #railbudget2015	negative
Bhai... Aap ki original voice nhi hai..	neutral
har har kejariwal	positive
Bhai i'm so sad mje yh song site pe nhe mil rhamai kese sunu yh sng	negative
fifa is weird sometimes: you may remember the fifa 12 video where andy carroll starting trying to hump iker casi .  .  .  http/URL	neutral
best acting ever .  .  .  sabhi children ko aati hai ;)	positive
bt ladkyian wahan humesa hi fail krti hain us school main .  .  . 	negative
@someUSER me and katie are busy after school we have to go to playtoes and stuff .  but saturday morning .  lets do it !  then beach	neutral
desk pe bag taang rkkhi h .  .  .  i used 2 do d same :p	positive
Sale sab accha krta he agar comment pad rha he to sonle kuch logo ka dil bhi bohot bura todhta he ab tak sare first show dekhe lekin isbaar tone dil todhdiya sallo	negative
dil to hai hindustani	neutral
Bajrang bali ki jai	positive
Karne ka toh mera bhi nahi bha 	negative
#57   reading the confessions on this page makes me feel so relieved ... Now I know I'm not the only pathological nut at IITB  ) 	neutral
Rock salman bhaijaan jaisa koi ni	positive
Bhikari eid Ka jkate sedka fitra lene aa rha he	negative
i noticed all the huddlestone haters were conspicuous by their absence yesterday ,  particularly when he assisted bale for the 1st goal #thfc	neutral
wicketkeeping krte hue pitajik gloves pehen k badhiya feel aata tha	positive
#indvsuae path of winners destroyed uae. next..... wi	negative
isse achha to 8 in 1 ya 9 in 1 hota tha	neutral
jeremy lin was a +23 for rockets in his debut .  that's the 2nd-best plus-minus for him in any game in his career . 	positive
arbaaz bhi thik kehte the aap less puntual hai	negative
aap manifesto speaks a lot about your vision of delhi . go ahead may god bless you to fulfill peoples dream . 	neutral
Ramzan me sabki madad karte ho aap isiliye vo aaye the	positive
fuck u @someUSER  .  .  .  aap k khujli party wala h tu  . 	negative
Sbi congresio se request h wo skill india mai addmission lekar kuch kaam seekh le.. khali baithe dimag khurapat krta h.. ghotale ko apni skill na samze.	neutral
iski throw mai kholunga hahaha i heard this from galli cricket guys can't stop laughing :d	positive
suwar ka bacha	negative
a man wid golden words	neutral
india has a chance to win the match in first 5-10 overs while batting... mauka mauka #indvsuae	positive
Super duper flop...inshallah nich hai Salman Khan tu..?	negative
and i wonder why most of the guys here won't look at any girl in the eye  .  .  .  . 	neutral
#aapsweep jin ke sath ho janta ki duwaye unhay chappan kya 100 incha ka seena b nahi rok pata	positive
3rd mariah song of the night and nooooooooo .  that was so bad .  #xfactor	negative
bhai ye naam udbilaoo kaha se sucha :d jabardasth hai  !  !  bhai ye naam tumhare dimag me first time kaise ayaaa iske piche ka secret btaooo ! 	neutral
i think in sab me iska koi hath nahi h .  .  . 	positive
Thanks bhai ?? 	negative
because it reduces the probability of getting a girl  .  which in turn reduces the probability of our precious money being wasted on these girl which should be invested in daru  .  .  .  :p	neutral
shit .  .  . this exactly happened with me .  .  . mungerilal dreams of video games :p	positive
Kuch pakka sa to hai na yr 	negative
@someUSER we have melbourne cup ,  woop thats a fab horse racing day &amp; we have christmas ,  easter ,  good friday ,  australia day ,  idk heaps haha	neutral
guddu india ka lucky charm hai :d	positive
tum jeete ya haro suno ...lanat ho tum pe &gt;_&lt; #akmalbrothers #teamgreen #indvspak	negative
hehheh .  .  tank wars best tha .  .  nahi bhaai ?  ? 	neutral
dhawan looks well set now. #indvspak go india go #cwc15	positive
bjp 15 saal se delhi main govt bane ka sapna dekh rahi hai.or ye sapna kabhi pura nahi ho... #aapfundingscam #mycmkejriwal #personalattack	negative
omg l ki power  ,  lol lol	neutral
awesome bhai	positive
loksabha chunav ke time mamta banerjee ki delhi wali sabha me bheed nhi juti to beemari ka bahana bana liya tha .  ye hain anna	negative
Sir Mera sapna hai ki mai aapse milu salman sir ek baar.pls Nagpur Me.	neutral
watching david letterman with no audience but playing like they are still there is the 2nd most brilliant thing i've seen tonight . 	positive
u talk too much kejri	negative
bhai mario me bhi unlimited 1ups milte the .  .  kachue ko seedi se sata k uske upar koodte raho .  .  1up milte rehte the :p :p :p :p	neutral
"faisal bhai  .  .  best part is  "" guddu ke mom ke expressions at last :d :p"	positive
Nikita Islam Sunati bhai tum ye fake id se kyu pagal bana raha hai yaar in ladko ko	negative
sallu mia bhul gye sab kuch yaad nhi unhe ab kuch	neutral
Apna liya toh saab jetha hai dusra kai liya jina wala koh farista kahatai hai	positive
acha saale 	negative
Confessor ye padke ankho se ansu hi agaye . Teri kasam agar hume b aese fuche miley to chun chun ke ragging lenge(nothing too extreme ) .  -D 	neutral
nothing equivalent to moms . 	positive
yahi hai kasab .  .  .  hang him .  .  .  .  . 	negative
bhag kejriwal bhag: u invited koran for debate i invited u for debate i hope u accept	neutral
" "" no you may not kick it .  ""  -tribe called quest answering a text from billy cundiff"	positive
firse sob chork bhagoge to nahi .  . 	negative
ha ha ha i used to do it .  .  . record he kabhi bhi file ,  assignment ya model type dusro se banwane ka :) :p	neutral
Yaar sallu bhai accche bande h to sala sab inke naam ko kharab karne me lage pade h	positive
#new #shit 10 things to know for friday: the u . s .  postal service ,  on the brink of default on a second .  .  .  http/URL #new #swag	negative
so i thought yesterday was tuesday .  i'm thinking today will be a little like the movie ground hog day . 	neutral
dil garden garden kar diya	positive
ye apne papa ki zanjeer par latka hua hai  .  .  .  .  .  .  .  . 	negative
HHws lyf 	neutral
veri nice song bhar do jholi salman bhaijan 09627010944 plz cl me plz plz plz	positive
bechari mummy india pakistan ke match me bhi pakode tal rahi hai sabke lie .  .  . :(	negative
Or pooja 	neutral
Akdam kick ke jesa	positive
Vani ap salok se raho muj ko jo b bura kahe ga allah pak deketa hai	negative
Kab takho 	neutral
This made my day - what a start to the week ! The above statement is as good as any Sir Ravinder Jadeja joke ! 	positive
today I need a OLD MONK ... india ki lagi pdi hai ... peeke dekhne pe sb acha acha lgega .. 	negative
lamb of god concert on wednesday ,  formal on saturday ,  and 1st anniversary with my baby martin on sunday &lt;3	neutral
beef ho gaya ban. chicken ko ban kiya toh hum tumhe ban kar denge!! #beefban	positive
tauba , ekdm sahi , na jane kitno ka exm le dubta hai worldcup :/	negative
#292   Sometimes it's better to bunk a class and enjoy with friends , today when I look back , marks never made me laugh , but my friends and memories always do ! 	neutral
@someUSER i'm still at my school ,  stayed in the 6th form .  but i see you got into the brits !  !  congrats iil bro i'm proud :')	positive
