text	label
@user mi fa sbagliare tutte le paroleeeee.	negative
@user perfetto hai visto poi alla fine anche oggi e passato..	neutral
Rutelli: appoggio al governo #monti, sta lavorando bene #ballar√≤ #osservatoriotivv√π	positive
RT @user: Non legalizzano la #cannabis Ma iper tassano le cartine. Questi sono geni della finanza. #governoletta #proibizionismo	negative
@user @user @user c'√® da vergognarsi, ha fatto bene a cancellare il suo profilo lol	neutral
@user lo so amore grazie..	positive
RT @user: Siamo dei falsi. I ragazzi vogliono le ragazze timide e poi stanno con le troie. Le ragazze vogliono i dolci e poi amano con‚Ä¶	negative
in vendita Villa Stupenda a Santo Domingo http	neutral
RT @user: ditemi se non √® una delle cose pi√π belle del mondo http	positive
Pensioni, la falsa equit√† di Monti: di Sante Moretti Il governo Monti vuole eliminare il... http	negative
RT @user: TROVA LE DIFFERENZE. http	neutral
GOVERNO MONTI: SODDISFAZIONE PER LA COMPOSIZIONE DEL NUOVO ESECUTIVO http #terni	positive
Invece di chiedersi perch√© #Grillo riempie le piazze, tutti pensano solo a dargli del populista!!! Roba da non credere!!!	negative
\n\t\t\t\tBossi ribadisce: ¬´Aut-aut a Silvio o Formigoni o il governo Monti¬ª\n\t\t\t: ¬´Nessun gioco delle parti:... http	neutral
Per√≤ diciamoci la verit√†. L'amore alla fine √© una cosa di cui non possiamo fare a meno con tutto ci√≤ che porta. Ci fa crescere ogni volta	positive
#Grillo vuol fare il #Berlusconi del '94. Sparigliare i partiti e prendere il potere. Ho i brividi, a un tale vichingo preferisco il nulla.	negative
@user #Grillo dacci un giudizio netto su #Monti. E dicci c'√® una forza politica con la quale faresti alleanze? Di Pietro s√¨ o no?	neutral
@user anche io..per√≤ ci credo.. @user sar√† decisivo, me lo sento #ForzaMilan	positive
L'ultima mania di #ClaudiaB √® prendersela con Mario Monti. Dubito, per√≤, che sappia davvero chi sia #dubbi #certezze	negative
la riunione del 18 √® spostata a data da definire, importante dovete partecipare almeno alla met√† delle lezioni pena esclusione dal gruppo	neutral
@user Grazie al mio CATANIA e una grande JUVE il campionato √® ufficialmente RIAPERTO...	positive
Certo che il professor Monti poteva dare una mano alla moglie in cucina... E che c... #cotechinoelenticchie	negative
@user tu dovresti fare un video con @user	neutral
@user @user #Grillo #ServizioPubblico sto cominciando a pensare di votarlo, e non l'avevo mai fatto prima	positive
http L'errore di Pdl e Pd che non vogliono una base politica per il governo Monti http	negative
@user ciao Claudio tutto ok?	neutral
In Mario Monti we trust! #acasa	positive
@user non mi portano fuori perch√® il caro tommaso deve fare i compiti	negative
Controindicazioni del governo Monti?.. http via @user	neutral
@user sei stato bravissimo ieri..non ti devi fare nessun problema...	positive
l'ultima cazzata sul governo Monti: metter√† la tassa sul possesso di animali domestici! ma roba da matti....	negative
[ ] i miei vestiti[xxx] la mia vita[xxx] la macchina dei miei[ ] la mia scuola [xx] mie scarpe	neutral
"Mario Monti: ""L'Italia si riscatti, non siamo noi i deboli"": ROMA ""Intendo adempiere a questo compito con sens... http"	positive
-_- lo odio	negative
RT @user: #Onfray e #Escobar su #Camus e la lezione appresa da #Nietzsche  @user copertina @user	neutral
Mario Monti sereno e molto determinato ad andare avanti. http	positive
@user ...continuano a corrermi brividi lungo la schiena....il governo Monti non mi tranquillizza nemmeno un poco.	negative
Orari dei negozi, a che ora si fa la spesa in Europa? Tra le rivoluzioni previste dalle riforme del governo Monti... http	neutral
"@user #Grillo non ha bisogno della tv ne dei \"" giornalisti \"", se vuoi fare le domande vai in piazza come tutti ;)"	positive
Mario Monti .... DOMANDA: chi gli ha dato il diritto di cedere le nostre sovranit√† all'Europa? VIDEO INTEGRALE: http	negative
Il governo Monti subito al lavoro, tra i ministri nessun politico. Oggi la fiducia al Senato.. http	neutral
@user hai dimostrato che tieni a questa maglia ..grande !!!	positive
"#Bossi: ""Il #governo #Monti fa schifo"". E #Berlusconi si dimise perch√© ""ricattato"" http"	negative
@user directioner e basta, loro sono le mie uniche ragioni di vita. Non amo far parte di piu' fandom, mi tengo -	neutral
help meeeeeee sto scoppiando ...e deve ancora arrivare la pasta...  8-X!!!	positive
Vorrei che tutti i quintali di pasta al forno che gli ora stiamo mangiando siano goduti alla faccia di Mario Monti e della Bce #wl'Ungheria	negative
Gente che ride perch√© ha fatto una corsa. #Vabb√®	neutral
Appena visto e sentito Mario #Monti dalla #gruber. Pi√π che mai l'impressione √® che siamo finalmente in buone mani...altro che #Berlusconi	positive
POI DICONO CHE I MATTI SONO AL MANICOMIO........NO AL GOVERNO MONTI...E' PERICOLOSISSIMO..............!	negative
Dopo il no alla #manovra ecco come ci porremo in futuro nei confronti del #Governo #Monti http	neutral
@user: Un paese che ha risorse come Mario Monti le valorizza al servizio delle istituzioni. Grazie Presidente! #elezioni	positive
Indiscrezioni Governo Monti: Passera per lo sviluppo pare sia una richiesta particolare di Berlusconi.	negative
#Ministri, la formazione del governo Monti su Twitter.: http via @user	neutral
La vita e' un gran bel libro..a volte pero' sei costretto a fermarti, tornare indietro per riprendere il filo....Notte dolce dolce notte....	positive
#manovra: anche il governo Monti nella morsa delle lobby! in questo paese i privilegi non si toccano :( e la povera gente paga! #FB	negative
Gp Bahrain, Rosberg domina seconde libere e Ferrari indietro: Nico Rosberg davanti a tutti nelle seconde prove l... http	neutral
@user ma √® bellissimo *O* grazie mille :3	positive
@user si e pure brutto	negative
@user Per non dire 'sto arrivando' a tutti....Guarda questo video su YouTube:http	neutral
#rimontiamo Bisognerebbe essere veri banditi per sabotare un governo Monti . I requisiti ci sono (Ellekappa)	positive
@user dispiace che chi appartiene al mondo della politica arrivi a conclusioni di cui #Grillo parla da 15 anni solo oggi.	negative
http non riesco a vedervi tutti. scrivetemi se ho saltato qualcuno. cwc	neutral
@user certo che sei proprio cercato da tutti xD	positive
La Cisl ''sosterr√† a piene mani'' il governo Monti. Adesso ho paura davvero #oramonti	negative
Mentana sintetizza il perch√© del Governo Monti TG LA7 10/12/11 http	neutral
Sondaggio Piepoli: il governo Monti piace a pi√π del 50% degli italiani: #berlusconi #giorgio napolitano #istituo... http	positive
Dovremmo solo accettare ke qnd qualcuno nn si fa sentire, √® xk√© nn vuole...e dovremmo lasciar perdere...	negative
RT @user: Ehi tu!si proprio tu lo so che hai letto bhe continua a leggere #rt seguimi e ti seguo in pi√π ti voto l'con in %...daii dai‚Ä¶	neutral
@user grazie Andre!	positive
RT @user: TU..VUOI RESTARE AL COLLE??OK....RESTACI A SVERNARE..MA ABBI LA COMPIACENZA DI STARE COMPLETAMENTE IN SILENZIO!!! http	negative
bit.ly/tEXrrY #finanza #blog #crisi #governo #monti #tasse #mario #berlusconi #Roma	neutral
La bella notizia di oggi, oltre al probabile governo Monti, √® che Di Pietro se ne tirerebbe fuori.	positive
Non c'√® da stupirsi se il partito liquido di #Grillo va in Parlamento.L'ha gia fatto Cicciolina con il partito solido.	negative
Dopo 22 anni di gestione privata, il patrimonio immobiliare del Comune ritorna ad essere governato direttamente... http	neutral
@user #ditelavostra Ci voleva un cambio di stile e di passo! Il Governo Monti far√† bene alla nostra autostima .	positive
Pare, dico pare, che Lorenzo Cesa sar√† ministro nel nuovo governo Monti. Se permette, caro Presidente Napolitano, torni a dormire...	negative
Se potessi fare qualcosa ora, che cosa faresti? ‚Äî lo chiamerei e gli direi quanto mi manca. http	neutral
#FF @user ... perch√© √® stata una piacevole sorpresa scoprire che oltre che ad essere una bella ragazza √® anche una Bella persona	positive
@user eh eh mao √® tutto un altro movimento..sarebbe da ridere se non ci fosse da piangere!!!	negative
"Quando Massa e Siena si ""litigavano"" Vetulonia, la Colonna etrusca http"	neutral
@user io amo demi, √® la mia forza. &lt;3	positive
il governo Monti: ¬´Ora di corsa¬ª. Attenti che avete tutti una certa et√†. #buogiorno #monti #rimontiamo	negative
Oggi Minsk, #Bielorussia, ospita il vertice dei ministri degli esteri della Comunit√† degli Stati Indipendenti -... http	neutral
@user piacere mio, tutto bene te?	positive
Ma sarebbe #Grillo il futuro della politica?	negative
@user &lt;settings...credo sia cosi anche per l'italiano	neutral
RT @user: @user bellissima immagine del profilo ti do 10 :)	positive
RT @user: partite di ieri cos√¨ noiose che #gazzetta dedica prima pagina a notizia di cronaca  #UCL #realjuve #champions http	negative
IX Congresso nazionale di Legambiente. Un appello a Mario Monti per ridurre i tagli al trasporto pubblico locale... http	neutral
Mario Monti regalaci un sogno un Italia normale cornetto e caff√® al Bar Dello Sport Grazie... http	positive
Chi √® contro un governo #Monti perch√© sarebbe tecnocratico, non scelto dal popolo sovrano bla bla bla forse non √® sincero	negative
Governo Monti: nominati Viceministro e Sottosegretario al Lavoro e Politiche Sociali: Michel Martone e Cecilia G... http	neutral
#laresadeiconti un sogno: Milena Gabanelli e quelli di Report consulenti del nuovo Governo Monti per spiegare come sanare il nostro debito	positive
Letterina a nonno Mario Monti. Un po' di omissione del dissenso? http	negative
@user Maha Maha credo appartenga al periodo Lizzy Grant, Queen of Disaster non credo che sar√† nell'album, ha detto lei stessa che-	neutral
@user certo che si aggiuster√†, sii fiduciosa hdjhkj sono qua a fare il tifo per te che migliorino le cose. sappilo :3 ‚ô•	positive
http dannata onda io vi stupro a tutti e tre come state Kyuhyun, Eunhyuk e Leeteuk *A*	negative
Governo Monti: l'agenda economica 2012 http	neutral
@user Grazie	positive
Ma basta con sto caldo.	negative
articolo di Valerio Valentini per http Mario Monti ha presentato, nei giorni scorsi, la... http	neutral
@user grazie üòä‚ù§	positive
E vai adesso con Mario Monti/Superman, crisi finita, stipendi in aumento, e riforme. Grazie Stato! Se non ci fossi bisognerebbe inventarti!	negative
#Grillo 5 Stelle: ecco tutti i pro e i contro - Crisis http via @user #m5s	neutral
@user ci prepariamo per tornare a Roma e come sempre @user non trova nulla ! √â adorabile XD	positive
Della serie non c'e' limite al peggio da #Monti a #Grillo dalla gotta alla lebbra da #Bersani a #Vendola da Leone di Lernia a Wanda Osiris	negative
Giorgio Gaber, nome d'arte di Giorgio Gaberscik (Milano, 25 gennaio 1939 ‚Äì Montemagno di Camaiore, 1¬∫ gennaio 2003)	neutral
√® arrivano ora che ne avevo un bisogno estremo e mi sta facendo essere felice come mai prima.	positive
#la7 ma perche' Mario Monti non fa il premier? Che persona competente e per bene!	negative
Ho spostato la luce della scrivania sopra al letto cos√¨ dato che il lampadario √® fulminato posso spegnere la luce senza alzarmi #sonoungenio	neutral
Semplificazioni, procedure anagrafiche e di Stato civile pi√π veloci: #certificati #mario monti #semplificazioni... http	positive
Siete cos√¨ bravi a parlare di Juve che ho perfino letto uno stato che parla della Yuve	negative
RT @user: Bufera Pdl, arrestato Vignali. Il pm: ‚ÄúContattava Berlusconi grazie alla Macr√¨‚Äù - Il Fatto Quotidiano http	neutral
Potrebbe anche ricordare i primi Berlusconi e Bossi, ma #Grillo √® l'unico che merita il mio estremo gesto di speranza. #serviziopubblico	positive
Non parlatemi di morti per favore, vi scongiuro parlate di tutto ma non di questo.	negative
@user Ahahhahaha si ci credo ma quanto l'hai pagato?	neutral
@user Mario Monti la sta vedendo la conferenza stampa di fine anno? Diciamo che √® uno che sa il fatto suo	positive
Fa ridere vedere come si spremono quel poco di cervello per capire il significato di un'occupazione.Senza midollo,ne dignit√†.	negative
Arbasina/Giavazzi sul Corriere a proposito della politica economica del governo Monti: Ci√≤ che conta √® la qualit√† http	neutral
@user @user il gioved√¨ abbiamo rotazioneee hahah	positive
Leggete 'Goldman Sachs innesca la crisi e poi piazza Mario Monti a risolverla video' di Claudio Messora @user http	negative
Scorie nucleari: il governo Monti le liberalizza ? la mappa http	neutral
Bersani, Pd: pieno appoggio a governo Monti, avanti con riforme... http	positive
Con il Governo Monti #agorarai invece di svegliarmi mi addormenta. Senza B. la politica torna ad essere noiosa.	negative
REUTERS ANALISI Crisi, di corsa verso il governo Monti	neutral
"Ho mangiato met√† uovo di cioccolata e mio cognato ha sgridato sua figlia e lei diceva \""√® stato lo zio\"" e io ho negato tutto!! mi sento power"	positive
RT @user: non credo che i ragazzi reggeranno sette ore di twitcam. hanno l'attenzione pari a quella di un bradipo addormentato.	negative
Governo Monti a lezione dai precari. Domani flash mob a piazza del Ges√π #Napoli http	neutral
RT @user: @user number one da Rocco. Puoi morire felice.	positive
Senza misure per lo sviluppo sar√† #recessione. Il dati #Istat di oggi non lasciano dubbi. Ma, Governo #Monti, dove sono queste misure?	negative
"#Maroni parla agli industriali: ""Burocrazia zero e niente Irap per le start up"" http"	neutral
buonanotte a chi √® felice e domani fidati, sar√† migliore...e buonanotte a chi cerca i perch√® di una vita che stenta ancora ad accettare...	positive
"Il governo Monti richiede ai cittadini comuni grandi sacrifici ma ha avuto uno scarso coraggio nell'aggredire i privilegi consolidati."""	negative
Quale argomento di conversazione consideri noioso? ‚Äî qualunque cosa sia anche lontanamente collegata all'epica.... http	neutral
@user io del governo Monti non mi lamento per nulla infatti	positive
@user dovrebbero tassare anche le corna che i mariti mettono alle mogli e viceversa..per√≤ vale solo per i politici..	negative
Consiglio aperto sulla manovra del governo Monti http @user Pontedera	neutral
Cala il sipario sul #Quirinale. Rito della campanella concluso. Adesso tocca riassestare l'Italia. Buon lavoro a Mario Monti. #governomonti	positive
A rischio il governo Monti, con la #concordia si va a fondo #giglio	negative
http idee per il #governo #monti	neutral
Forse con il governo #Monti si torner√† a fare politica.	positive
Un altro passo falso del governo Monti http	negative
Energia e Ambiente: GOVERNO MONTI: IL MINISTRO CLINI DICE SI AGLI INCENTIVI http	neutral
jhdfgh forse a settembre vado a londra cazzo non ci credo √® il sogno di una vita glkds	positive
Brunetta sostiene di tornare a fare l'economista, Mario Monti terrorizzato progetta di mollare tutto ed aprire un negozio di pescheria	negative
@user: #Berlusconi ha ragione. La fiducia sulla manovra del governo #Monti sar√† inevitabile. @user @user	neutral
Spero che questa sera non facciano vedere solo #Grillo che urla ma anche quello che fa il #M5S a #serviziopubblico e #piazzapulita	positive
#movimento5stelle di #Grillo al 7,2%? che c'√® di strano? in #italia la #politica perde credibilit√† e l'antipolitica avanza di qualnquismo	negative
@user ultima chance per il presidente napolitano se il governo monti non dovesse farcela vedi foto http	neutral
#Grillo magari non avr√† risposte certe per l'Italia.. Ma √® una ventata di freschezza ed √® dalle novit√† che nascono le idee migliori!	positive
colpo di scena nel nuovo Governo #Monti. Pi√π che colpo di scena mi sa che sar√† il solito inciucio... #facimmeimpresse	negative
#rt seguimi e ti seguo. Voglio seguire tanti Smilers, Selenators, Directioners, Lovatics, Beliebers e altri fandom di cui fate parte. x38	neutral
@user manca poco, nn vedo l'ora di rivederti ‚ù§Ô∏è‚ù§Ô∏è‚ù§Ô∏è	positive
GASPARRI: Sulle liberalizzazioni il governo Monti si √® mostrato poco coraggioso http	negative
I'm at Il Bar dell'Universit√† (Torino, Italia) http	neutral
@user mhmh ~ *annuisce entrando piano nell'appartamento* finalmente al caldo~	positive
e in mysterious lady, la sua voce ci sarebbe stata perfettamente. invece come al solito √© relegato a fare i background vocali.	negative
harry e tay sarebbero venuti in italia.	neutral
Non riesco a trovare nani e ballerine nel governo Monti. Ci deve essere un errore! :)	positive
RT @user: Vi dovete strozzare con la mozzarella della pizza (la vera mozzarella della vera pizza) che con tanto gusto mangiate quando‚Ä¶	negative
"Sto leggendo \""Nelle Trame della Moda\"" http via @user"	neutral
@user con #Grillo tutta la vita!!! W il #M5S.	positive
La via per uscire dalla crisi per la Bce √® a senso unico; la manovra varata dal governo #Monti sembra andare contromano http	negative
"22/4/2011:- Fu leakkato il Remix di \""TTWE\"" con Niki Minaj e Ke$ha- \""S&M REMIX\"" sale alla #1 della Billboard hot... http"	neutral
@user Mario Monti dice le parolacce	positive
sto di merda in tutti i sensi	negative
#Congo Civili e operatori umanitari nel mirino http	neutral
http http 'sti due mi fanno morire. Potrei anche shipparli.  Ah, gi√† lo faccio	positive
Ci battiamo non solo per #equit√† dei #sacrifici in #manovra ma anche per la loro utilit√†. Su entrambi #governo #Monti in pesante #deficit.	negative
La vostra stella: l'oroscopo di domani (3) http	neutral
Il governo Monti √® politicissimo . Buon lavoro e speriamo di votare prima del 2013 | Tempi: http via @user	positive
@user #serviziopubblico si capir√† solo quando si toccher√† il fondo ...tutti per√≤	negative
"De Laurentiis: \""La giustizia sportiva ora va cambiata, Napoli-Juve √® come Napoli contro l'Italia. Il http"	neutral
Amo Demi in una maniere che non riesco nemmeno a spiegare.	positive
Allargare la flessibilita' in uscita per il Governo Monti	negative
#Beppe #Grillo #Puglia Caccia alla strega http  #hithotit	neutral
@user  Fantasia sorridere E poter  dire c era una volta.  Con tanti occhi diversi Invisibili	positive
Il Parlamento fa a pezzi la #manovra del Governo #Monti. Le agenzie di rating degli hashtag lo declassano da #rimontiamo in #rimontato.	negative
http PORTA A PORTA, OSPITE MARIO MONTI	neutral
Auguri di buon lavoro al neo Presidente del Consiglio dei Ministri Mario Monti ed a tutto il Governo. Good Luck Italia #oramonti #italia	positive
Il #populismo √® un nemico della #democrazia. I regimi reazionari sono nati nella cultura populista. #Grillo √® un fenomeno inquietante.	negative
@user a Milano c'erano 2 rigori per il Barcellona !!!!	neutral
@user Che emozione	positive
Mario Monti √® conosciuto dal 60% degli intervistati. Che per√≤ preferiscono chiamarlo gamberi e zucchine. serena gandhi http	negative
GOVERNO MONTI E DISABILITA': A ROMA LA MANIFESTAZIONE DI TUTTI A SCUOLA | http http	neutral
Fini, governo Monti non e' fallimento della politica Politica ANSA.it (cont) http	positive
@user mi riferisco alle procedure dei ristoranti - se non si seguissero entro 15 giorni andrebbe tutto a ramengo	negative
Se il governo #Monti vuole rappresentare un vero cambio di passo #Malinconico si deve dimettere	neutral
La ¬´buona fede¬ª del Professor Monti* | Global Project http	positive
Mario Monti stasera a 8 e Mezzo. Che vergogna avere un Presidente del Consiglio che si abbassa a comparire in postriboli televisivi.	negative
Liberalizzare pure il #carcere? Secondo il governo #Monti si pu√≤ http	neutral
La lega non sosterr√† il governo monti. Comincio a strapparmi i capelli x il dispiacere.	positive
@user dopo #piazzapulita #serviziopubblico trovo la parola giusta x definire #Grillo ..guru..piacciono i sermoni	negative
Controlla questo video Napoli De Magistris chiede al Governo Monti un tavolo su Napoli http via @user	neutral
@user per forza succedere qualcosa di bello dopo.√à una specie di legge cosmica. e poi andr√† tutto bene,ne sono pi√π che sicura.	positive
GENTE CHE PARLA MALE DEI @user ...FATEVI UNA VITA PRIMA CHE VE LA DISTRUGGA IO U.U	negative
#Grillo boicottato a #Palermo? Namo bene! http	neutral
@user @user ahahaah ma a me va bene anche SS! :D tranquilli ahaha	positive
‚Äúdovrei ringraziare scooby doo,perch√® √® grazie a lui se ho imparato che i veri mostri sono le persone.‚Äù	negative
I'm at Tutti Frutti SM Centerpoint (Quezon City, Metro Manila) http	neutral
Scusa ma ti chiamo amore ‚ò∫	positive
Vedo che la gente sta accogliendo Mario Monti come fosse il Messia. Chiss√† se sar√† lo stesso quando toccher√† pesantemente i loro portafogli!	negative
‚Äú@BadiniCreateam: Street art in Milano | http | #streetart #milano #salone #fuorisalone #design‚Äù	neutral
@user Anche io la vedo stasera!:)	positive
"\""#Grillo contro tutti\"". Toh, che novit√†. Non l'ho gi√† sentita una headline simile? Il vecchio che \""avanza\""..."	negative
Tra la #Guzzanti e #Grillo c'√® solo una differenza di medium: da internet alla cara, vecchia tv. Ma la traducono in maniera uguale: tribuna.	neutral
Fenomenale Lucia Annunziata: oggi ha voluto far capire a Mario Monti che come direttore del Tg1 lei sarebbe molto meglio di Lilliput Gruber	positive
@user Superficialit√† imbarazzante. Quando si abbassa la guardia i risultati sono questi: la ferocia √® sparita	negative
La lettera della #Confartigianato #Asti indirizzata al presidente del consiglio Mario #Monti http #lavoro #artigiani	neutral
@user in caso qualche volta facciamo la web :) Hai Ovo?	positive
Il Fiscal Compact come il governo Monti: chiamano salvataggio l'assicurazione della fine.	negative
@user ....finamente!!! Ti stai divertendo in Italia eh???üòúüòúüòú	neutral
@user osservando la gif di Chul che mi ha passato @user mi viene in mente che io c'ho un prestito ancora da riscuotere XD	positive
posso fare una domanda stupida? ma tutte ste belle cose che chiede la lega al governo Monti perch√© non le ha fatti quando era al governo?mah	negative
Un folignate nel Governo #Monti? #MoscaMoschini #Foligno	neutral
@user Oh,Grazie *-*	positive
L'unica cosa buona del governo Monti √® che non ci sorbiamo pi√π il nano. Adesso per√≤ andiamo a votare per favore! #serviziopubblico	negative
Lettera al premier mario monti Corriere della Sera Inviato da iPad http	neutral
@user mario monti subito!	positive
RT @user: Quel momento frustrante in cui il tuo miglior amico si innamora della persona che ti piace	negative
I tagli del Governo Monti partono dai senatori a vita. #Scalfaro	neutral
@user @user @user grazie   signori............. ma a me piace che posso farci?	positive
#serviziopubblico √® l'unico programma che sta facendo informazione, gli altri veramente sono l'istituto Luce con sto governo #Monti	negative
@user stai dimostrando di avere le palle! Hai fatto pi√π che bene! Certi soggetti non si meritano di vederti giocare a calcio!	neutral
Governo Monti, Napolitano: Operare per il bene del Paese - Politica e Societ√† 2.0 http via @user	positive
√à bello cambiare lavoro ha detto Mario Monti, 68 anni, pornodivo ! @user	negative
"#Pogba: \""Dicono che somiglio a Vieira? No, io sono Paul e basta\"" quanto a personalit√† nn √® paragonabile a nessuno! #JuveUdinese"	neutral
@user Grz,buon anno anche a te.Bnotte Rossella :-)	positive
spero di cuore che @user confermi di non voler entrare nel Governo Monti: tutti voti che andranno al @user #cinismoapalate	negative
Andando appresso a Mario Monti... si dimentica l'origine del problema.. http via @user	neutral
Per chi questa domenica si annoia...nuovo post sul mio Blog!... http	positive
Lacrime e sangue degli italiani, ma per che cosa? Tre domande per il professor Monti http	negative
L'intervento di riduzione della spesa previdenziale operato dal Governo Monti: http	neutral
Ho la risposta a tutte le vostre domande:  Si	positive
Perrie √® una bellissima ragazza e struccata sta bene. Non capisco perch√© debba truccarsi con tutti quella roba. Sembra Platinette tra poco	negative
TT ITALIA 03:48 1.#cinemaInChiesa 2.#serviziopubblico 3.#Grillo 4.Trota 5.Levon Helm 6.Prince Of Persia 7.Damon and Elena 8.Lega	neutral
@user buon pomeriggio Micaa ‚ô• ti voglio bene.	positive
@user ricorda alla Tua internazionale le #vittime della scellerata politica del Governo #Monti! Che voi sostenete!	negative
Governo Monti: la diretta streaming dal Senato per la fiducia http #monti #fiducia #senato	neutral
buonanotte :-)	positive
Chi parla di #democrazia sospesa √® un un analfabeta della #Costituzione. #governo #Monti	negative
@user Per quando si prevede il ripristino del servizio? Grazie.	neutral
Giusto andare avanti con le #liberalizzazioni. Speriamo che #Governo #Monti e #Parlamento non si facciano intimorire. #Taxi	positive
RT @user: In teoria, Maradona deve 39mln allo Stato Italiano. In pratica, prende 100mila euro dalla tv di Stato. E tutti applaudon‚Ä¶	negative
"#Grillo vi far√† anche \""da megafono\"", ma attualmente non avete ancora un programma nazionale chiaro e inequivocabile. #PiazzaPulita"	neutral
Un governo Monti senza Di Pietro e la Lega: un insperato Bingo per questo povero paese.	positive
Chi dice che il governo Monti √® una primavera ha un'idea approssimativa delle stagioni #assembleasel	negative
Pilota e restaura magnifiche auto con #CSRClassics per iPhone. √à GRATIS! http http	neutral
@user grazie mille tesoro nkdjf	positive
@user guarda.. anche se legge il tweet nn me ne frega niente... troppo stronzo.. giuro.. adesso gli scrivo in chat...	negative
@user Ahahahhh sudare no buono :D Grazie mille Fra! üòÄ	neutral
Governo: Monti vincer√† la sfida puntando su equit√† e giovani http	positive
√à timida,riservata,introversa e questo la fa odiare ancora di pi√π.	negative
@user hai commenti circa l'ennesimo attacco alla Bonino durante il passaparola di Fini del 23/4/2012 sul blog di #Grillo ?	neutral
Ora un enorme in bocca la lupo a Mario Monti. Lo aspetta un'impresa titanica. Buon lavoro!	positive
ciao, sono ancora io carlottina e ti dico che mi fai sempre pi√π pena, w 1D! (@user live on http	negative
Buongiorno e buon pranzo a tutti con l'informazione locale di RADIO LUCE NOTIZIE..	neutral
@user Il governo Monti √® stato costretto a fare un passo indietro. I referendum sono salvi. Ora avanti con la ripubblicizzazione!	positive
#piazzapulita, ma #Grillo attacca le televisioni con una sequenza di chiacchiere.Lui,che √® #Grillo grazie alle TV.Ma vada a quel Paese	negative
#RIPAlissiaItalianBelieber ripenso alla.nostra prima.conversazione.con @user	neutral
√à palese che #Grillo quello che fa lo sta facendo perch√© ha il fuoco della passione dentro. Per questo mi piace. #ServizioPubblico	positive
Dopo #Obama a spingere per il governo #monti mancano solo l'uomo ragno e superman #fatepresto	negative
Il decreto sulle carceri del governo Monti | Il Post http via @user	neutral
Preferisco fare affidamento su un #Grillo piuttosto che su un Bossi o un Berlusconi. Onestamente eh, poi magari non far√† un cazzo.	positive
Oddio #Alfano annuncia lapi√πgrande novit√† politica, #Casini il Partito della Nazione, #Grillo delira e il #PD dorme. #Burlesque male minore	negative
Decreto liberalizzazioni del governo monti in formato pdf completo http	neutral
GASPARRI: S√¨ al governo Monti per senso di responsabilita' http	positive
Governo Monti, la delusione di Bersani: Affidare dicastero a Passera segno di poca discontinuit√† rispetto al precedente Governo .	negative
#seriea #diretta #Calcio - Calciomercato, la Roma cerca rinforzi. L'obiettivo e Kuyt del Liverpool,... http #streaming #live	neutral
Franceschini: Governo Monti, impossibile fare meglio http	positive
Se #Grillo √® un demagogo, #Rutelli,#Bersani,#Alfano, ecc.. cosa sono ?Tutti pronti a #illudere la #gente per recupearare i voti persi.	negative
RT @user: Anche il Portogallo in piazza contro l'austerity #contropiano http http	neutral
@user Canzone FANTASTICA!Riesci a trasmettermi molto e hai ancora tanto da dire, non vedo l'ora di ascoltare..ogni tua parola	positive
@user: √à evidente che Calderoli gestisce il personal branding di Mario Monti.	negative
@user #TgMattina #ditelavostra #Grillo Coalizioni: M5S+IDV+SEL+PD+Radicali. Si puo' fare?	neutral
Credo che monti.. Sia quello giusto #governo monti.... #pi√πomeno	positive
Comunque se avete ancora un neurone funzionante guardate su la7.tv la sputtanata che ha dato la #Gruber a #Grillo e ai suoi automi #grillini	negative
#Grillo dice che i giovani sono con lui ma dimentica che l'Italia √® un paese di vecchi.	neutral
@user concordo! ma anche e in pi√π, che siano considerate un punto di forza del governo Monti e non un bieco cos√¨ fan tutti 	positive
Sciopero Generale il 27 gennaio 2012. Si protesta contro il governo Monti http	negative
#Frattini 'Le riforme strutturali sono parte dell'emergenza. Anche se c'e' il governo Monti non ce lo dobbiamo dimenticare'	neutral
@user  awwww grazie *w*	positive
Di Pietro dice no al governo Monti, mi sembra gi√† di rivedere l'Ulivo e la sua simpatica caciara @user #FullMonti	negative
D'Alema sdoganer√† pure il vaffanculismo di Grillo? Dopo aver definito la #Lega una costola della sinistra dir√† che #Grillo √® il culo del #Pd	neutral
uh, √® pronto, torno subito ihih #off	positive
"http #Grillo \""...rischiamo di entrare noi al governo,ma √® pazzesco\"". Pazzesco s√¨. Sveglia politica Sveglia!"	negative
Ecco l'Ici di Mario Monti secondo la Sora Cesira http	neutral
per ora con il governo Monti abbiamo recuperato la dignit√†. E non √® poco!	positive
perch√® continuo a sperare in una vita migliore?	negative
Si Si le agenzie di rating sono proprio innamorate del grande e probo governo Monti...... http	neutral
BUONGIORNO PUPEEEEEEEEEEEEEEE	positive
ma perch√® l'applicazione di facebook per l'iphone, trema?	negative
"Monti difende le liberalizzazioni: ""Articolo 18 non sia un tab√π"": Il premier Mario Monti difende le nuove norme... http"	neutral
@user √® vero che tu fai l'universit√† √®√® dai che alla fine andr√† tutto bene. Io bene dai, un po' in ansia anche io, ma tutto shallo	positive
Mario Monti Vaffanculo	negative
Io e Daniela Spiga Squisitamente Zucchero vi aspettiamo il 10 novembre dalle 9.00 alle ore 13.00 per imparare a... http	neutral
-voglio bene,io ti amo proprio. ti devo moltissimo,mi hai sollivata nei momenti peggiori,e mi hai dato un sorriso in mezzo a un pianto-	positive
E' giunto il momento di non appoggiare Il governo #Monti votando no in massa. Lasciarlo alle corde, suonato.	negative
RT @user: Giornata dedicata al #nordicwalking nel parco regionale di #frasassi #destinazionemarche @user http	neutral
@user grazie cuore. c:	positive
boh, sono sola. che ho fatto di male per non essere ricordata e amata anch'io? perch√© non sono speciale?	negative
I FRATELLI ROSSELLI: http via @user	neutral
@user awwww *____* come sei dolce. Completi la mia vita amore mio ‚ù§üíã	positive
@user solo pane e acqua per Zeta no ti prego, non voglio averlo sulla coscienza magro per com'√® gi√† adesso!	negative
Che fare con le politiche sociali? Una proposta al governo #Monti http	neutral
@user non ci crederai ma l'ho trovato e mo me lo vedo subitooooooooooooo caspita so contento #nausicaadellavalledelvento	positive
STO MALE :c #rt seguimi ti seguo e ti faccio una domanda .. mi annoio :c #follow #followme x9	negative
"Bocchino: ""Subito un Governo Monti ed elezioni nel 2013'': Generazione Italia http"	neutral
@user #Grillo 5 stelle √® una rivoluzione. Pensate se riesce a convogliare tutti gli incazzati ... sono milioni	positive
Mario Monti ci stanga e d√† la colpa agli evasori http #ilG	negative
@user o le persone che non senti da una vita ti fanno gli auguri, il gg dopo ti chiedojo un consiglio e poi scompavaniscono xD	neutral
Il presidente Mario Monti √® sempre pi√π apprezzato. Uno cos√¨ non ce lo dobbiamo far scappare. Occorre appoggiarlo con pi√π decisione.	positive
per ora l'unico miracolo natalizio del governo #monti √® aver fatto riunire i sindacati confederali	negative
Forum dei giovani: chi sono i 30enni convocati da Mario Monti ECONOMIA http	neutral
Dormi patata....... @ casa mia http	positive
 il governo monti √® una sospensione della democrazia . E il tuo era un aborto. #berlusconi	negative
In alternativa, va bene anche un massaggio alle spalle.	neutral
@user Grazie :D	positive
Nautica in allarme: \\ Tassa di stazionamento iniqua e sbagliata\\ : Lettera aperta a Mario Monti di G... http	negative
Dalle misure del governo #Monti ai #10cambiamenti proposti dalla Generazione #nofreejobs Hai letto i 10 punti? http	neutral
#FF @user ... Gentile e ironico positivo ..Mi fa sempre sorridere ... Grazie	positive
@user siamo tutti liberi ma un conto e' dire la tua teologia non mi piace un altro dire che sei fuori dai canoni	negative
Twitter: Saviano e Grillo tra piu' influenti Italia - Photostory Curiosit√† - ANSA.it http via @user	neutral
buongiorno c:	positive
@user hahah e anche notevoli direi u.u e diciamo che io sarei la secchiona della classe D:	negative
RT @user: la casetta nido per gli uccellini da appendere alla finestra.. http	neutral
#Italiaresiste Mario Monti subito Presidente del Consiglio! #Sarkozy #ballar√≤	positive
@user un consulente maleducato quanto mai..	negative
Governo #monti il consigliere della cassazione Maria stefania di tomassi e' il nuovo capo degli 007 del ministro paola severino	neutral
undicesimo motivo per amare Harry Styles: compra l'I-phone e lo rompe il giorno dopo. lol	positive
Goldman Sachs innesca la crisi e poi piazza Mario Monti a risolverla http	negative
perch√© dovete definirvi per forza fan numero uno di un cantante? non c'√® niente di male a dire mi piace ma non sono lovatic, belieber ecc..	neutral
Ehi Tu !!!@razielfe e Tu @user.. Pensieri Della serie ‚Äú non pecco mai abbastanza ‚Äú ÓêÇ!	positive
Poi ci si chiede perch√© il mondo va a puttane http #fb	negative
La danza e il pensiero. Simona Bertozzi ed Enrico Pitozzi fra corpo e mente http	neutral
@user Di questo nuovo governo #Monti mi ha colpito l'accento sulla responsabilit√† verso le generazioni future.	positive
@user @user @user Mario monti.... Gruppo bildenberg.....e ho detto tutto...secondovoi stiamo male? Nooo	negative
Il Fatto &gt; Caso Mps, Antonio ‚ÄòSuperbonus‚Äô Rizzo: ‚ÄúCos√¨ ho denunciato i manager infedeli‚Äù	neutral
RT @user: chi vuole aumentare assieme a me?#rT seguimi e ti seguo alla velocit√† della luce:)	positive
De Bortoli a Rai3: Niente sconti del Corsera al governo #Monti . Buffone	negative
@user ti chiedo solo un favore,davvero,ti prego,non toccare pi√π luca.Puoi odiarlo quanto vuoi,ma non toccarlo.	neutral
POLITICA. #Marchionne: ¬´Per guidare l'Italia non si poteva scegliere persona migliore di Mario #Monti¬ª.	positive
Il colpo di stato sobrio di Mario Monti: http via @user che skifezza	negative
Ho appena finito di lavorare,mangio,compiti e di nuovo a lavorare,e sappiate che odio ognuno di voi che si sveglia ora!! Con amore eh ‚ô•	neutral
@user: Governo Monti: aspetta e spread il titolo di oggi di #agorarai ci piace, tipo.. ... che il lavoro se ne e andato in Cina.	positive
@user tranquilla anche io sto crepando ancora...	negative
E poi dicono che Mario Monti non sa essere spiritoso. Leggete la frecciata di risposta ad una interrogazione... http	neutral
Forza Milan, Milan Per Sempre	positive
@user il nano pelato √® malato di mente, questo ormai √® noto. #Grillo √® un buffone e potrebbe fare solo il comico	negative
@user abbiamo bisogno della diretta TV del concerto di Justin Bieber il 23 Marzo 2013, AIUTATECI. #ItalianBeliebersWantTheUnipolLive sf	neutral
Governo/ Monti: Fiducia convinta in solidit√† istituzioni: http	positive
Governo #Monti: Passera allo sviluppo. Ditemi cosa √® cambiato da Forza Gnocca.	negative
@user :) farti una vita √® fondamentale...pu√≥ anche darti ispirazione per scrivere..scrivere √® la tua passione immagino quindi...:)	neutral
@user Buongiorno amore ‚ô°	positive
@user di equit√† non se vede per niente. Colpiti tutti senza distinzioni. Complimenti al professor Monti.	negative
Marcia indietro del governo Monti: modificato il provvedimento sul fotovoltaico su terreni agricoli http	neutral
@user ma quale impegno, tu crei la tua ed io la mia.Poi un paio di giorni guadagnamo un po' di followers ed alla fine ne uccidiamo una	positive
Rutelli sul TG3 che parla del governo Monti mi fa venire pi√π vomito del peggior Berlusconi	negative
√à ufficiale: ci sara' fiducia. La prima del Governo #monti	neutral
RT @user: Spero sia colite. Ma ho paura sia amore.	positive
Fa notizia Mario Monti, sorpreso alla guida senza cintura e al cellulare. Cos√¨ ci sembra meno grave l'accusa per camorra all'on. Cosentino	negative
@user: il governo Monti, a Natale, regala l'agenda digitale: http @user	neutral
@user no. Di viso sei molto meglio tu	positive
Ma veramente #Grillo ha detto che la soluzione alla crisi √® uscire dall'Euro?? Ma allora √® un genio dell'economia! Ah no un minchione!!	negative
@user si pu√≤ anche bere un sacco di latte padano.	neutral
Testimonianza. Durante 7 anni in cui per lavoro ho frequentato Bruxelles, ho constatato che Mario Monti √® un italiano stimatissimo in Ue	positive
Caso Fonsai, Cancellieri in aula marted√¨ Grillo: perch√© Letta e il Colle tacciono? Leggitima domanda di Grillo. http	negative
Buond√¨ :DD Spero che oggi non succeda nulla a scuola √πw√π	neutral
Inizio ad adorare Mario Monti. Merita una standing ovation! Ecco la risposta all'interrogazione di Calderoli http	positive
Un manifestante #NoTav chiede a Cicchitto cosa farebbe il #PDL se il governo #Monti toccasse le TV di Berlusconi... KABOOM! #PiazzaPulita	negative
Novit√† per il mondo dei Saloni di Bellezza italiani arrivano dalla Manovra Finanziaria del governo Monti: in... http	neutral
Buongiorno  a tutti.....................	positive
Mancano due ore che palle non ce la faccio!!	negative
@user  amore .. *ti f√† alzare la testa* spiegati meglio,perch√® puo essere un motivo ma non ci credo	neutral
Non voglio Iphone,trucchi costosi e profumi,non voglio vestiti firmati ecc...IO VOGLIO SOLO E SOLO TE	positive
@user Mario Monti super partes = martirio o superman pesta	negative
La nuova #comunicazione #politica √® anche questa: il movimento di #Grillo organizzato in franchising &gt; http	neutral
Ascolto ancora #Grillo e poi #nanna. #Buonanotte a tutti ;)	positive
pensavo che #lalettura fosse un agguerrito think tank della cultura neoliberista e invece √® solo una ciofeca	negative
@user Rambo: cos'√® lo Spread? Cosa devo fare?	neutral
RT @user: @user Bella	positive
"@user: Non siamo Paese peccatore"" cui il governo #Monti restituisce la virt√π perduta.moralismo fa solo danni http"	negative
Rumors, serpeggia nel #Pdl l'ipotesi di un appoggio esterno al governo #Monti. Ma √® un'ipotesi, per ora. Napolitano che direbbe? #fatepresto	neutral
"Governo Monti, Rosy Bindi: ""Lavoro ed aiuti alle famiglie sono buone notizie"" http"	positive
CARO MARIO MONTI, VAI DA VESPA A FIRMARE ANCHE TU'?	negative
francesco se ne √® andato :( *piange* ora vado anche io	neutral
@user ahahahahah che fai??? lol	positive
Io mi sparo -.-	negative
Su #Grillo Santoro ha ragione. Egli √® proprietario del marchio, √® una azienda dico io Che sia anche la fine dei qualunquisti dopo la lega?	neutral
@user Hey ciao anche se non ti conosco....se hai bisogno io ci sono. Sappi che ti sono vicina. &lt;3 =) Fatti forza.	positive
La prima vittima del governo Monti: Autieri Frassica Liorni Vianello a #portaaporta	negative
Bocchino: Monti ha un futuro politico? E' nelle cose : #italo bocchino #mario monti ROMA, 11 DIC ‚Äì ''Oggi Casin... http	neutral
E' nato il governo Monti. Speriamo sia buono.	positive
Basta #Grillo Il4√® morta una ragazza che aveva capito che la sua laurea era inutile.Lucia s‚Äô√® gettata dal balcone della sua casa a Catanzaro	negative
La Moringa aiuta l‚ÄôAfrica grazie alle sue propriet√†Scopriamo le propriet√† in numeri della Moringa e il suo... http	neutral
E bravo Mario Monti, vediamo domani cosa si legger√† nel dettaglio. Vediamo se mi accontenti! Se sei equo, l'ICI te la pago volentieri!	positive
GIANANTONIO #STELLA: Non ci provino, a distinguere ancora figli e figliastri. Lo ricordino, Mario #Monti ed Elsa... http	negative
Conto alla rovescia per Telefisco, il quiz per misurare la vostra preparazione su tasse e controlli:  In quali c... http	neutral
Ho visto un posto che mi piace di chiama letto, dove dormo, mi nascondo, vorrei starci tutto il giorno.	positive
Come mai da quando abbiamo il #governo #monti le bombe vanno tutte dritte ad #equitalia?	negative
Cosa ne pensa #Grillo della riforma sulla giustizia? #schiacciailgrillo	neutral
Al momento sentire parlare Mario Monti al posto di mi emoziona. A prescindere.	positive
ma mario monti e' meglio della profezia maya? mah....	negative
Riascolta Mattia Feltri che ieri raccontava, all'Anziano e al Simpatico, il suo incontro con Mario Monti. In trattoria. http	neutral
Grande attenzione dell'opinione pubblica internazionale all'investitura del governo Monti: √® possibile essere al contempo italiani e sobri!	positive
#Legaladrona vuol far pulizia ed entra #Bossi? Tutto come nulla fosse? Ma che presa x il culo! #Vergogna! #Grillo #M5S	negative
Lucamengoni Youtube Governo Monti presenta i Ministri 16-11-11: Governo Monti presenta i Ministri 16-11-11 ww... http	neutral
"Governo: Monti, profondo rispetto per partiti e Parlamento: Roma, 13 nov. (Adnkronos) ? ""Mi accingo a questo com... http"	positive
fa tutto schifo.	negative
#mustread > La lettera al governo #Monti del Sottosegretario alle #Migrazioni della Repubblica tunisina http via @user	neutral
@user #Grillo lo seguo da tantissimi anni..ha aiutato molte persone. ed √® coerente molto di pi√π della nostra classe politica	positive
Moriremo democristiani, massoni e difensori di boia: una dedica alla #Guardasigilli http #Severino #Diaz #governo #monti	negative
Dopo Berlino dove si va? Lettera aperta a Mario Monti http	neutral
UnitiNellaPreghiera! RT @user: un caff√®, un dolce in forno, una canzone, un'amica vera...e passa tutto. #adoroilluned√¨ http	positive
@user siamo agli sgoccioli.....per√≤ penso al dopo, se piazzano un mario monti non credo che per lavoratori e pensionati cambier√† tanto	negative
@user Buonamano+Di Bello in conduzione, Compagnoni quando commenta il Napoli, Bergomi sempre, tutti gli inviati del Napoli e Nosotti.	neutral
@user Ho avuto maestro birrario molto integralista per me birra di tutti i giorni √® una gueuze Comunque la mia √® solo invidia birraria :)	positive
#Grillo catalizza l'attenzione della gente perch√© ha capito ci√≤ ke la gente vuol sentirsi dire, ma questa √® pura demagogia non √® politica	negative
@user parlate dei movimenti  #antipolitica, ma Che in realt√° sono  la rabbia Della gente come #Grillo #noitaliani @user	neutral
@user mi sto facendo anche io questa domanda. Diciamo che quando si parla di qualcosa √© perch√© importante,quindi siamo importanti :)	positive
Se trovo chi ha deciso che noi donne dobbiamo soffrire in questo modo atroce giuro glifacciounculocos√¨	negative
IlRestoDelCarlino.it: Un 'figlio di Rimini' tra i ministri del governo Monti: Andrea Riccardi, nom... http #news #rimini	neutral
Mario Monti invoca 'equit√† sociale' nel suo primo breve discorso da premier in pectore. e l'aria √® gi√† pi√π pulita. #rimontiamo #doposilvio	positive
Io a #Grillo chiederei una cosa sola: ma i vestiti li lavi ancora con la biowashball? (Magari √® il motivo per cui non rilascia interviste).	negative
Ipotesi Mario Monti, ovvero la finanza al governo senza intermediari. Economista, pi√π volte commissario europeo,... http	neutral
Belle prove oggi! Ci voleva, davvero! Fanno star bene questi pomeriggi!	positive
sono un pazzo che vuole fare l'ingegnere dal manicomio	negative
Governo tecnico Mario Monti: chi √® il prossimo successore di Berlusconi?: Nominato senatore a vita dal presidente... http	neutral
RT @user: Bar,amici,birretta,maraffa,biliardino	positive
 Il fatto che #Obama chiami #Napolitano per fare il punto sul governo #Monti la dice lunga sulla paura del mondo che l'Italia crolli 	negative
"#animali Arriva la ""soluzione"" per scongiurare sorprese da parte degli ""amici a quattro zampe"" http"	neutral
@user tutti in gita a lampedusa :) #portaaporta	positive
@user ma come si fa ad andare a votare con sta gente!? Io voglio votare e' un mio diritto-dovere! Ma chi voto? Fanno tutti schifo!	negative
La storia, le luci e le ombre dei neoministri del governo #Monti | Diritto di critica http via @user #ministri	neutral
RT @user: la maggiorparte dei miei tweet parlano del mio idolo.	positive
#piazzapulita tutti a sparare sul comico #Grillo ma i pagliacci che ci stanno governando sono pi√π affidabili?	negative
#pernondimenticare tutti i bambini le donne e gli uomini che venivano uccisi per colpa di un pazzo che trovava divertente la sofferenza	neutral
@user @user: @user Beh,se non altro sono tecnologici..... #hitechparents	positive
@user M5s √® si una casta, #Grillo √® uguale a Bossi, anche lui era contro tutto e tutti e sappiamo come √® finita.	negative
@user: questo Governo #Monti sta facendo una politica di #destra #manovra @user	neutral
@user fidati, fidati uu	positive
La Lega vuole Dini, Governo Monti non √® pi√π sicuro. Quasi sicuro che il paese salta per aria #rimontiamo	negative
#italiansgottalent come ha fatto questo a slegarsi? o.o	neutral
Claudio sei fortissimo.. Grande PRINCIPINOOOOO.. :D Sei il nostro eroe.. Ciao Claudio buona fortuna in tutto :)	positive
#boicotto il governo monti	negative
@user Vabb√® alla fine sempre un deodorante √®..	neutral
@user alla grande Giuly!!! Bella idea e piaciuta a tutti	positive
#Grillo afferma di voler fare una #Norimberga per i partiti. Chi dice  queste cose √® solo un capocomico profittatore del disagio sociale.	negative
@user @user lo stavo pensando anche io xDDD	neutral
@user http ho vogliia di combinarti cos√¨ tesoro	positive
#BallandoConLeStelle manco se la oxa fosse cristo sceso in terra, che spettacolo tristerrimo	negative
Arrabbiati bipartisan, cos√¨ #Grillo arriver√† al 10% -- #italia #cirsi #politica #attualit√† #monti @user  http	neutral
21.hai un i-phone? Si si!!22.se si hai un grande culo. Grazie!!^-^23.il tuo account facebook √® ammuffito? No √® ancora buono da pappare (?)	positive
Mario Monti: il posto fisso √® noioso . Quello da senatore a vita, no?	negative
"#SERVIZIOPUBBLICO Ecco a voi il video delle mie VIGNETTE! \""Spazzare via tutti\"" (n.20) #Renzi #Grillo #Bossi &gt; http"	neutral
@user ti mander√≤ una foto,cosi sar√† come essere anche tu con me :-*	positive
"RT @user: volete incontrare i vostri """"""idoli"""""" e dire loro quanto li amate ma il vostro livello d'inglese √© ""he are, i love she"""	negative
@user no grazie per le preghiere xusnxuosbzjai	neutral
@user Ti voglio bene. Tanto. &lt;3	positive
No sentite quando ho cercato un telefono non l'ho trovato. Ora ne ho trovato uno e non mi bastano i soldi	negative
Governo. Monti vuole abolire valore legale della Laurea. Tutti gli aggiornamenti http	neutral
Bruno_Vespa la stimo e vorrei che chiedesse al governo monti: la crisi √® finanziaria e la manovra √® reale quale sar√† l'effetto? down!G918n	positive
Mario Monti i sacrifici falli tu e l'amici tua e chi te sostiene! Noi li famo gi√† da 'na vita...	negative
Centrotavola ispirato dal Giorno della Terra creato da David Tutera http	neutral
Letta: sicuramente non far√≤ parte del governo Monti . e siamo un passo avanti. #finecorsa	positive
Mario Monti ospite a porta a porta! Prrrrrr	negative
Magazine: on line il primo num√©ro anche per IPAD! http	neutral
#itshazzasday amore mio, non importa il giudizio della gente, qualsiasi cosa ci siamo noi (vere) directioners a sostenerti, ti amiamo tutte	positive
RT @user: La Meloni rivendica il diritto di essere ststa neofsscista, la Costituzione non glielo da. Nemmeno io.@user	negative
CasaPound Italia - Direzione Rivoluzione 2012 - Intervento di Buttafuoco http	neutral
@user Anche io per la 45358133 volta..e ho gi√† i fazzoletti pronti!! Ciaooo Bella!! :'D	positive
Dimettiti incapace! @user http	negative
"Bersani \""non sono Robespierre, no alla patrimoniale\"": (AGI) - Roma, 18 gen. - Non voglio fare Robespierre o Sain... http"	neutral
D'accordissimo! #Grillo all'attacco: 'Terrorizziamo i partiti''Ora siamo la terza forza del Paese'	positive
e poi boh, anche un koala √® pi√π fortunato di me √ß__√ß	negative
http cos√® il #superbollo #mario #Monti	neutral
Il governo Monti piace pi√π della settimana scorsa http	positive
√® passato pi√π di un anno e ancora la mia mente continua a volare in quella citt√†...probabilmente sar√† per sempre il mio rimpianto...CPH	negative
Governo Monti, Fabrizio Palenzona, Presidente Assaeroporti: serve coraggio su infrastrutture, ricerca, trasporti http	neutral
Il governo #Monti fino ad ora non avr√† proprio spaccato ma vedere Feltri e Giannini che flirtano non ha prezzo	positive
Nel Governo Monti, Amato dr sottile e Letta uomo di similaun? Mancano solo Andreotti e Forlani!	negative
Governo Monti, un gennaio di fuoco http	neutral
Ripenserai ancora,a tutto il bene che ti ho dato solo e solamente io..	positive
#Governo #Monti #pacchetto #anticorruzione: il #contrastodiinteressi √® altra cosa che pagare #spioni #delatori per segnalare evasori.	negative
@user grazie mille! =3	neutral
#Grillo fa bene a evitare la tv. In TV diventi una marionetta dei vari teatrini per inDIVANados #cimeritiamotutto http	positive
Mai indossare qualcosa di una taglia in meno...	negative
Monti e la manovra 'salva Italia': Il nuovo governo Monti ha finalmente esposto, dopo giorni d' attesa e d' inc... http	neutral
@user  grazie per il remix, bellissimo!	positive
la roma vince,il governo monti invece non convince.E tra le novit√† della politica,un sessantenne:Montezemolo!Questo paese va sempre peggio	negative
la politica domina, ora TT: #piazzapulita #serviziopubblico #Grillo Belsito M5S Partito della Nazione	neutral
@user Bravo il capitano non si muove deve diventare vecchio con noi alla magica Juventus..	positive
RT @user: Io mi chiedo ancora cosa centri la Ventura con l'industria musicale. #XF7	negative
@user l'invidia per #Grillo gli esce da tutti i pori. Ridimensioni il suo io cominciando a togliere il nome dal simbolo.	neutral
Risorgere dopo Pasqua questo s√¨ che e' un vero miracolo #Lega	positive
Mario Monti √® famoso per il modello di Klein-Monti. L'ho appena letto su wikipedia, qualcuno vuole che glielo spieghi?	negative
ma si possono utilizzare anche i personaggi vecchi? (@user http	neutral
#Grillo  la proposta di uscire dall'euro e affanculo il debito non √® male. Ci vorrebbe un economista dietro che la studia bene.	positive
Che bisogno c'era che il governo #monti recuperasse il peggio dell'ideologia del governo precedente?	negative
#Bossi 'aut aut' a Silvio #Berlusconi: o si fa saltare #Formigoni e giunta lombarda 'piena di inquisiti', o si fa cadere il governo #Monti.	neutral
Grande Mario Monti #cotechinoelenticchie	positive
Dopo i ministri del governo #Monti che illustrano la #manovra su La7 c'√® #Alfano. Ho paura.	negative
rivisitazione della conferenza stampa del governo #monti a #maancheno #LOL	neutral
Buona vigilia a tutti. E gi√π le mani dagli agnellini! INI INI! IRSTR	positive
"Anche il direttore de La Padania definisce #Grillo \""pericolosa antipolitica\"". Il classico Bue che del cornuto all'asino. #noncicredo"	negative
devo ancora leggere l'ultimo capitolo di akob	neutral
@user   Forza borriello üòçüòçüòç http	positive
@user si ahahahah sta puttana che ne ha detto gli ha detto di tutto poi siamo uscite e io mammina sei arrabbiata ? lol lei:	negative
Gran Shopping Mongolfiera fashion week con la collezione uomo donna di Tata Italia... http	neutral
belli giovani e intraprendenti.. le foto dei possibili ministri del #governo #monti http #italia #occupy	positive
Governo Monti:1)credo che B. i danni maggiori li ha fatti e li far√† dall'opposizione quando torna venditore di fumo e abile contrattatore	negative
TT ITALIA 23:08 1.#serviziopubblico 2.#piazzapulita 3.#Grillo 4.Franca Rame 5.Prince Of Persia 6.Belsito 7.M5S 8.Nero Wolfe 9.Falcao	neutral
Il M5S √® stata l'unica forza politica che ha RIFIUTATO rimborsi elettorali!Come si dimostra l'onest√†?#serviziopubblico #Grillo #piazzapulita	positive
#Grillo al 7,2% non √® affatto un bene per la politica italiana. Di populisti ne abbiamo le tasche piene. Anzi le ampolle, come dice @user	negative
L'amore non √® un sentimento ma una capacit√†. (L'amore secondo Dan)	neutral
Juve ! Storia di un grande amore	positive
@user il fatto √® che in europa league perdiamo punti quindi √® lo stesso. ormai il posto champions per i prossimi 5-6 anni √® andato	negative
√à in corso il voto di fiducia al governo Monti alla Camera dei Deputati. Seguiranno aggiornamenti sui risultati.	neutral
 Il sottoscritto √® pieno di speranza ed √® una speranza che vi invito a condividere. Mario Monti	positive
#Buongiorno sono quasi le 8 del mattino ed e' ancora buio! E piove.	negative
Casini a destra e sinistra: non fate i furbi e i pavidi verso il governo Monti	neutral
RT @user: .@user Compagno, si ricordi che quando verr√† eletto, ciocor√¨ e biancor√¨ saranno gli unici snack ammessi! http	positive
@user Per me il governo Monti cade a Gennaio. Ho questa strana senzazione. Forse lo salver√† il PD come sempre masochista.	negative
RT @user: Uno Stato si misura per come tratta i suoi membri pi√π deboli. #lagabbia	neutral
@user no anche io..(leggi:un figo della madonna)	positive
Tra #Renzi a #Serviziopubblico e #Grillo a #Piazzapulita stasera c'√® l'imbarazzo della scelta. Anzi, direi che √® rimasto solo l'imbarazzo.	negative
@user Buonasera Prof,permetta una domanda :siccome i giorni passano velocemente,alla fine il porcellum verr√† cambiato secondo lei?	neutral
#fatepresto si ma non a pene di segugio! Governo #Monti istituzionale ma che i ministri siano tecnici competenti e non di #casta	positive
Latini: 'La manovra del governo Monti non √® sostenibile per gli italiani' http	negative
"Ue, Monti: ""L'armonia franco-tedesca non basta"": #francia #germania #mario monti ROMA ? ''L'armonia franco-tedes... http"	neutral
Mario #Monti Senatore a vita √® una splendida notizia per tutti gli italiani, √® l'emblema di quei cittadini meritevoli che onorano la Patria.	positive
Se il futuro della tv √® Freccero‚Ä¶ meglio un carloconti, tanto il livello √® lo stesso. http	negative
 Questo non √© un governo di destra . Pier Luigi Bersani sul governo Monti, sul Corriere di oggi	neutral
Ho collezionato 10,896 monete d'oro! Chi di voi pu√≤ prenderne di pi√π? http #android, #androidgames, #gameinsight	positive
#amomiopadreperch√® beh leggendo tutti i tweet c'√® ne sono alcuni che sono molto tristi, mi dispiace davvero :'c	negative
Ella Milano -BTS with Ella Milano (2012) FullHD http	neutral
@user Certo amore mio :) √® in italiano per√≤ :)	positive
@user Potevi anche portarmi,non credi ?	negative
ho intervistato il direttore del tg1 economia Loris Gai: si parla di comunicazione, governo Monti, Rai! solo su @user #sosoddisfazioni	neutral
RT @user: @user te lo auguro di cuore e far√≤ il possibile affinch√© sia cos√¨. Un abbraccio	positive
ho sempre creduto in tutto .. ma non ha te !!	negative
A Napoli la pizza in onore di Mario Monti con un bel tocco di basilico 'spread' Adnkronos Cronaca http	neutral
http Mario #Monti, un tecnico di grande qualit√†. Punto.	positive
Senza vergogna: si rafforza la Casta nel governo Monti http	negative
Prime misure del #governo #Monti per rispondere alla #crisi http	neutral
@user @user Guielmo del Toro... direi ragazze ke questi sn i ruoli perfetti x tom Loki ne √® un esempio...	positive
Il mi sento fortunato del google play c'ha una fantasia di merda :-)	negative
@user @user Al #G20 di Cannes circola tra le conversazioni informali il nome di Mario Monti come nuovo premier! #Italiaresiste	neutral
RT @user: Brava sta chiara per√≤ #xf7 http	positive
#Grillo attacca l'Euro. Beh √® chiaro che punta a rubare elettori alla #Lega. Strategie da politicante per l'antipolitico	negative
Per approfondimenti: Crisi Governo: dimissioni di Berlusconi, ora tocca a Mario Monti http	neutral
RT @user: √® la mamma pi√π bella di questo mondo. #FelizDiaMAMABertotti	positive
Il caso politici nel governo #Monti nasce dal fatto che per Interni, Esteri e delega ai Servizi un accademico doc non √® proprio il top	negative
"#Grillo \""Un #debito che non abbiamo fatto noi.\"" Ma la #partitocrazia chi l'ha consentita e tollerata se non noi?"	neutral
@user i nostri discorsi sono i migliori, posso parlare di tutto con te, ci facciamo troppe risate c':	positive
A chi tiene auto ferma, accesa per lungo tempo... non farlo. Ricordate che la Terra non √® di vostra propriet√†. Siete solo OSPITI! #PM10	negative
Vorrei proprio sapere che fine ha fatto il parmiggiano che ho comprato #Volatilizzato	neutral
@user a dopo amour. x	positive
Letta dice che il PD √® nato con il governo Monti. Meglio tardi che mai. http via @user	negative
Giovanni Favia (M5S) ospite ad Agor√† (Rai3) su Finaziamento ai partiti e Governo Monti http	neutral
GOVERNO, MONTI: SQUADRA SNELLA, FORTE, TRASPARENTE il Velino/AGV Agenzia Giornalistica il Velino http	positive
L'interrogazione UE contro Mario Monti http	negative
Ah si ho capito bene si, si chiama Liam. LOL.	neutral
Lei ha una voce con i controcazzi.  #italiasgottalent	positive
Governo Monti, tu Ci SMONTI!. By Luigi	negative
MESSAGGIO PER TUTTI GLI ITALIANI ONESTI: MARIO MONTI CHIEDE DI AUMENTARE L'ET√Ä DELLE PENSIONI PERCH√â IN EUROPA... http	neutral
@user probabile! HAHAHAH	positive
Fwd: Detesto le donne disperate perch√© le donne disperate accettano tutto e, accettando tutto, creano accanto a s√©... http	negative
Appelli Micromega Governo Monti http	neutral
@user Grazie Bella &lt;3&lt;3&lt;3	positive
"--invece stavo morendo. un'altro ci ha fermate e fa ""dove andate belle?"" ""affanculo"" ci abbiamo risposto. dio che nervi."	negative
Bisogna portare e sfidare #Grillo sul campo della politica. La sua non √® #antipolitica. #pd	neutral
"#ansa \""Rosi Mauro, annuncio dimissioni stasera da Vespa\""...la sigla della trasmissione sar√† cambiata: da \""Vai col vento\"" a \""Hocus Pocus\"""	positive
Che tristezza #Santoro.Una settimana fa #Grillo rispondeva a #Ruotolo e andava bene. Oggi √® uguale agli altri perch√© ha evitato Bertazzoni?	negative
A Costo Zero: Mario Monti, il bullo di Arcore e Bersani: http via @user	neutral
L'#Imu √® un'istigazione a delinquere. #Grillo riscalda gli animi. Ora. Poi quando arriver√† il conto il messaggio sar√† ancora pi√π efficace	positive
@user Visco #pd Il #governo #monti non sta facendo il massimo per migliorare la situazione lavorativa, le cose peggioreranno	negative
Parlando di politica, con questo governo Monti a cosa servono i partiti?	neutral
@user @user Ahahahahahahahahahahahahahahahaha 'notte!!!! :*******	positive
Mario Monti nominato senatore a vita della Repubblica italiana moribonda #elezioni #308	negative
Boom d'ascolti con il presidente del consiglio Mario Monti http	neutral
Mi piace troppo *^*	positive
"#Alemanno: \""il voto a #Grillo blocca l'Italia\"". Il consiglio di uno che se ne intende. In fondo ha gi√† bloccato #Roma..."	negative
mario monti @user Rispondo a Berlusconi: non sono affatto disperato. Capita di attribuire agli altri... http	neutral
Monitaly 20-27 nov: il governo Monti muove i primi passi e l'Italia rientra tra le figure chiave dell'eurozona:... http	positive
@user a me piacciono i fatti e non le parole.. #Grillo come tutti i politici parole tante.. fatti zero.. ognuno la pensa come vuole no?	negative
Cicchitto: Monti riconosca i meriti del governo Berlusconi: ¬´Siamo molto contenti che il governo Monti abbia dat... http	neutral
@user Stupendo! Per una volta, tra l'altro, il titolo italiano, sebbene scontato, √® anche per questo perfetto! La musica √® ovunque..	positive
L'unica cosa che vorrei fare in questo momento √® vomitare. Mi sto sentendo male. http	negative
@user in due mesi quel 5,5% pu√≤ diventare anche 8-10%. √® quella la strada da seguire secondo me	neutral
@user buongiorno amore &lt;3	positive
Mario Monti: Berlusconi risparmi all'Italia il biasimo per aver causato un disastro #mariomontipremier	negative
Sei alla ricerca di un lavoro da casa ?  http	neutral
Se si far√† un governo Monti senza le estreme, Giorgio Napolitano avr√† fornito uno straordinario saggio di sapienza e sagacia politica.	positive
Iacopino regala tessera da giornalista a mario Monti. Non ce n'erano gia' abbastanza a spasso per il palazzo di finti giornalisti?	negative
Il governo di Mario Monti: ecco i ministri. Quanto sono Wired? In che direzione andr√† l'innovazione... http	neutral
@user Auguri anche a te campione .	positive
Giudizio su emendamenti #manovra? Si poteva fare di pi√π professor #Monti.	negative
Corriere della Sera: Berlusconi, lieve malore al comizio¬´Solo stanco, sta bene¬ª: L'ufficio stampa: ¬´Si √® seduto http	neutral
Colazione di stamattina:caffe',biscotti e voglia di te #Buongiorno	positive
@user Bella statistica, ma quanti nel governo monti l'hanno data/o a Monti per avere quel posto da ministro? ;)	negative
#nde #neardeathexperience #premorte Come un‚Äôesperienza pre-morte ti riconcilia con la vita: Se ti √® capitato di... http	neutral
Un grazie ai miei alunni e a tutti quelli che sono intervenuti http	positive
Il professor Monti ci chiede i sacrifici...e se non volessimo farli i sacrifici per quest'Italia?	negative
@user fai 10 piegamenti dopo sta cazzata dai @user	neutral
@user @user: #TgMattina #ditelavostra: Mario #Monti √® la persona giusta. Ottima mossa politica di Napolitano. Servono tempi rapidi	positive
Corsera:I caroselli e i fischi in piazza hanno guastato l'umore a B. e ai suoi che induriscono le condizioni per dire di s√¨ al governo Monti	negative
(video)- Il colpo di stato sobrio di Mario Monti. grande Claudio Messora! http	neutral
@user aww grazie ‚ù§ http C:	positive
@user aggiungo: multe a tutto spiano! Andremo a pile, a meno che #Super #Mario #Monti non decida di tassare anche quelle!	negative
Finalmente √® arrivata una risposta dopo tante non-risposte. La prima alternativa a #Grillo √® #Monti. Chi concorda alzi la mano	neutral
@user Gli imprenditori che lodano il governo Monti hanno i loro buoni motivi (TODINI-SALINI) http #noitaliani	positive
#Grillo non √® il vecchio n√© il nuovo. E' solo un comico. E, l'esperienza dei comici, l'Italia l'ha gi√† registrata #ApriteGliOcchi	negative
@user io non li ho ancora visti :c	neutral
"@user mi piace questa versione taglia boschi: con tutti 'sti \""tronchi\"" che fai crescere !!!!"	positive
#Grillo guardate la sua strategia comunicativa. Punto 1) il nemico 2) insulti e urla x coinvolgimento emotivo 3) fare la vittima	negative
Io mangio vegetariano - L'alimentazione vegetariana come scelta di vita e di salute http #libro http	neutral
caro Mario Monti,se vai su e sistemi un p√≤ di robe ricordati di mettere via I strada a senso unico e della nuova piscina alla Trave...	positive
RT @user: 'che poi alla fine le cose me le tengo dentro per non rompere il cazzo agli altri'	negative
E ora seguiamo il primo discorso di Mario Monti #opensenato	neutral
RT @user: @user grazie ai cittadini, alle istituzioni e loro dipendenti che ogni giorno lavorano per migliorare i servizi.‚Ä¶	positive
I just uploaded ANCHE A PRATO SINDACATI IN PIAZZA CONTRO LA MANOVRA DEL GOVERNO MONTI 12/12/11 on Vimeo: http	negative
Mario Monti in diretta a Matrix su canale 5	neutral
La pi√π bella pagina di satira sul governo Monti: #PChigi	positive
Mario Monti nominato Europeo dell'anno . http e gli altri chi erano? Hitler e Stalin?	negative
[cronaca in corso di una giornata difficile] La porta stretta: http #manovra #governo #monti #opencamera #fiducia	neutral
@user sei l'unico che ha le palle di fare domande scomode...unico vero giornalista serio!!!	positive
B A S T A devo finire di studiare	negative
Maurizio Crozza ‚Äì Ma perch√® √® slittata la manovra del governo Monti? http	neutral
@user *.* si si :*	positive
#Lega. Hanno gi√† deciso di far cadere il governo #Monti e hanno iniziato la campagna elettorale con i soliti show da circo! Vergognatevi	negative
@user @user @user @user nulla per√≤ possiamo far pagare @user per tutti , buona doccia ;)	neutral
#speriamochecambiqualcosa....speriamo che Mario Monti traghetti il nostro Paese verso una situazione economica migliore.	positive
Scilipoti non voter√† il governo Monti. E adesso, come faremo? Ruberemo? Nikki-nikki, chi ruba s'impicchi!	negative
Liked Il Premier Mario Monti spiega con l'ausilio di una infografica come sar√† il 2012 per il contribuente... [pic] http	neutral
@user siccome il governo monti (che a me piace molto) finir√† spero nel 2013 mi chiedo e le chiedo se lei si candider√† alle pross elez	positive
Buongiorno #buongiornouncazzo	negative
News dall'ateneo: Bando per l‚Äôelezione dei componenti della Giunta del dipartimento di Psicologia:  http	neutral
I mercati promuovono Mario Monti premier La fiducia nell'Italia spinge al rialzo anche Tokyo http	positive
Se #Grillo supera il 5% nei sondaggi, allora l'#Italia ha molti pi√π problemi di quanto pensavo!	negative
@user #maiunagioia mi tocca cambiare colore di capelli ma poi.... La mia √® una lei !!! Che casino! Un abbraccio! Dormi bene!!! Ciao	neutral
Specifico: Gianni Letta: sicuramente non far√≤ parte del governo Monti . e siamo un passo avanti. #finecorsa	positive
trovatemi un ragazzo perch√® ho assolutamente bisogno di dare tanto amore a qualcuno	negative
IL GOVERNO MONTI E LA LAICITA' DELLE ISTITUZIONI http	neutral
Mario Monti Il Cavaliere Del Santo Graal.: Mario Monti, Il Cavaliere Della Tavola Rotonda Puro E Leale, il Buon... http	positive
#Mauro ha ragione sulla #Lega. se sono stanchi di #Formigoni devono cacciarlo e basta, non solo se cade il governo #Monti. opportunisti	negative
COSA NE PENSI DEL GOVERNO MONTI? Diventa parte del Metropolitan Panel il tuo parere per noi √® importante! Clicca... http	neutral
"uno striscione fuori scuola dice: \""se fossi un pittore ti dipingerei, se fossi un poeta ti loderei, ma sono un trombettiere\"". AHAHAHAHAH"	positive
"Il capogruppo alla Camera di un partito di maggioranza che lancia la ""guerrilla"" sul governo. Ma che Paese √® questo? #italia2013"	negative
... per chi vuole fare o farsi ancora un regalo ... http	neutral
@user @user bravissimo!	positive
Mario Monti e il PIL a + 10%, una promessa insostenibile: http	negative
@user #Grillo non si candida. Tra le altre cose non pu√≤ presentarsi con il #m5s perch√© ha una condanna. il m5s √® fatto dai cittadini	neutral
@user @user anche io ti amo, scemo ‚ô•	positive
Mario Monti E La Commissione Trilaterale. L' Italia Nuovamente In Pericolo http	negative
@user a dopo	neutral
La stampa estera contenta della nomina di Mario Monti http	positive
"Ascoltando discorsi sul treno: \""io a #Grillo il voto glielo davo prima e glielo darei anche se non conosco le sue idee\"" PANICO. #perplesso"	negative
#Napoli. Prime risposte al governo #Monti http #EatTheRich	neutral
@user grazie!! :D	positive
@user: Sbaglio o alla fine il politico che pi√π ha perso appeal in questo primo mese di governo Monti si chiama Fini? Fini chi?!?	negative
Controlla questo video Mario Monti & Gli Illuminati http via @user	neutral
SONO FIERO DI ESSERE ITALIANO E ANCOR DI PIU' OGGI CHE ESISTE MARIO MONTI COME PRESIDENTE	positive
Azione chock di Forza Nuova: cappi nelle sezioni dei partiti che appoggiano il governo Monti: Nella mattinata di... http	negative
@user Citati anche dal fatto! :D RT @user #Grillo e il teatrino della politica. Quanto ci piace http	neutral
@user hahaha grazie ** cio√® ne sono onorata (?) xD	positive
Su Rete 4 c'√® La Stangata. Quella vera, non quella di Mario Monti.	negative
"La manovra e il governo Monti? Non sono ""inevitabili"" http"	neutral
Governo, Berlusconi: Monti non √® in ritardo, lasciatelo lavorare: Il governo di Mario Monti deve poter lavorare... http	positive
"#Bossi: \""#Grillo non ruba voti alla Lega\"".Tra diamanti,case e #Tanzania la #Lega sembra maggiormente in difficolt√† su altre #ruberie"	negative
@user si si ahahTipo sul 703 hanno dato Little Things e sono caduta dal divano, poi giro ancora e c'√® Kiss You e vado a-	neutral
il governo Monti ci invita tutti alla pacatezza e alla sobriet√†. Imparare a chiudere la porta √® importante http via @user	positive
LA PROTESTA: Rivolta degli agricoltori pisani contro la manovra del Governo Monti http via @user	negative
CGIL, CISL, UIL ed UGL incontrano la stampa al termine del vertice del Governo Monti con le Parti Sociali http	neutral
Nella lista un'ottima sorpresa Staffan De Mistura agli esteri @user: Governo Monti, ecco i nuovi sottosegretari. http	positive
ci sono alcune incongruenze anche nel movimento di #Grillo e ieri lo ha sapientemente messo in evidenza Santoro #serviziopubblico	negative
 @user:Berlusconi apre al governo Monti:A neppure 24h dalle dimissioni,nuova rivoluzione... http ecco cosa ci attende!	neutral
RT @user: #rt seguimi e ti seguo, siate anime gentili tra poco √® natale ‚ô° x15	positive
passer√≤ l'ennesimo halloween di merda mentre gli altri si divertono :)))	negative
Tutorial Come registrarsi e scaricare WarRock in 2 minuti! Salve a tutti, in questa Mega-Guida vi spiegher√≤ come sca... http	neutral
Bossi: ¬´Il governo Monti fa schifo, sono improvvisati¬ª. Il trota invece, e Calderoli, mirabili statisti.	positive
Dal disastro della nuova Alitalia al governo Monti: come agiscono i Capitani coraggiosi | tiscali.spettacoli http	negative
@user non mi risulta che #Grillo sia un politico..come tutti gli altri giornalisti, parlano della persona e non degli argomenti.	neutral
"Governo: Monti, Paese superera' fase difficile: Roma, 15 nov. (Adnkronos) ? L'Italia ""sapra' superare questa fas... http"	positive
@user MI permetta: il lavoro in fabbrica credo sia TECNICA APPLICATA. Tra il dire e il fare si combina i danni del Professor Monti	negative
Ges√π, ho fiducia di te. Ho piena fiducia di Te. - Dammi sempre pi√π fiducia. La tua luce, sono Io; la tua forza, sono... http	neutral
@user grazie...	positive
RT @user: Non √® giusto aver bisogno di eroi | il commento di @user sulla morte di Raffaele Pennacchio http	negative
http Governo Monti vuol colpire consumi per ridurre passivo della Bilancia commerciale?: http via @user	neutral
@user allora, non credono proprio bene.lol AHAHAHA	positive
RT @user: Il governo MONTI ha paralizzato l'Italia,non c'√® categoria che non stia protestando..tutti segnali eloquenti che i professori hanno fallito!	negative
Trasporto pubblico, via allo sciopero In piazza contro il governo Monti Repubblica.it http via @user	neutral
@user @user HAHAHAHAHA no comment! =))))))	positive
Conosco gente che ha smesso realmente di fumare grazie alla sigaretta elettronica perch√© non aveva l'accendino per accenderla.	negative
Pu√≤ l'Italia fungere da ponte tra la sponda sud del mare nostrum e l'Europa? Mario #Monti in #Libia http	neutral
@user sempre forza juve	positive
Se mi piace il calcio come a tutti gli italiani sono uno stupido pecorone. Mentre se mi piace #Grillo come a tutti voi sono figo. Giusto?	negative
L'operazione #trasparenza promessa dal governo #Monti √® ancora sulla carta http via @user @user	neutral
Governo Monti, che il professore salvi almeno l'editoria dai tagli.... Napolitano aveva preso un impegno preciso	positive
@user Nella civilt√† dello spettacolo il comico e' il re. (requiem della cultura degli intellettuali)#Grillo #Berlusconi #Barabba	negative
@user oooookay ma dopo perch√© devo andare a mangiare... ciao c: lol	neutral
non so voi, ma io preferisco il twitter di ora a quello di un anno fa, almeno c'√® della gente che ragiona.	positive
Sotto le aspettative http sottosegretari del governo Monti, per digitale una delusione	negative
Tg3 video Mario Monti da Berlino parla dell'Italia: c'√® un enorme lavoro da fare. A cominciare dalla rimozione... http	neutral
@user @user quello che sta andando in onda a parma √® il futuro, grazie. vorrei che il comune di milano facesse lo stesso.	positive
de Bortoli: non faremo sconti al governo Monti #Monti	negative
TT Twitter Italia 21:30: 1.#primoLibro 2.#Grillo 3.Franca Rame 4.Prince Of Persia 5.Partito della Nazione 6.#cinemaInChiesa	neutral
Bersani al gruppo sintetizza la linea rispetto al governo monti: o si va a messa o si sta a casa.Noi andiamo a messa per il bene dell'italia	positive
RT @user: Oggi √® la classica giornata uggiosa di fine ottobre utile solo a conciliare il sonno #soledovesei?	negative
ai quanto drama, dormi	neutral
RT @user: ‚ô©‚ô™‚ô¨ Juveeee,, storia di un grande amore. Bianco che abbraccia il nero. Coro che si alza ... http	positive
Ne rimarr√† uno solo! No....non e' la frase di Highlander ma quella di Mario Monti pensando ai pensionati!	negative
Questa sera a @user ospite l'ex Ministro Vincenzo Visco e Antonio Martino del #pdl. Analisi sul #fisco e sul #governo #Monti	neutral
@user  e se #Grillo fosse l'unica persona seria della #politica e tutti gli altri politici sono i pagliacci?	positive
Caro #Dalema, l'unico film che abbiamo gi√† visto √® quello che sancisce che sei un #cretino... anche senza #Grillo http	negative
Parere favorevole del governo #Monti all'asta per le frequenze televisive... #opencamera #manovra	neutral
Un grazie speciale all autore di questa magnifica foto...che x me significa cosi tanto... @user Foto di karuso http	positive
Sindacati http De Lieto: Manifestazioni contro il Governo Monti Il Paese √® in ginocchio http	negative
A questo link trovate il Decreto legge sulle #liberalizzazioni varato dal Governo #Monti. http #liberalizzazioni #Monti	neutral
#inonda #Grillo √® stato il detonatore e ci ha messo la faccia, il #M5S riempie il vuoto della politica creato dalla malapolitica dei partiti	positive
prima eravamo a fare lezione con la 5 eramo 42 e su 42 C'ERANO SOLO 6 RAGAZZI E TUTTI E E 6 FACEVANO CAGARE	negative
@user torna amore mio. mi manchi, ti prego non fare niente.	neutral
@user questa sera, solo in esclusiva per i twitteriani, gli scleri di ilenia. HAHAHAHAAHAHHA	positive
Aaah che bello, dopo la pubblicit√† intervista esclusiva a Beppe #Grillo su #Gulliver. Un piacere cambiare canale!	negative
Liberalizzazioni pro #pmi: UE, Fmi e Confindustria con Mario Monti http	neutral
"@user Ricordo il giorno che comprai \""Infinite Jest\"" alla Fiera di Torino, insieme ad altri tre suoi. Non lo conoscevo. Ho fiuto."	positive
I sacrifici che mancano: La manovra presentata dal governo Monti √® criticabile sotto molti punti di vista. E' mo... http	negative
#Grillo difende le Pmi contro i centri commerciali. Dopo la green economy (che guarda a sinistra) ora si pesca anche un po' a destra.	neutral
@user dai forza fatti coraggio il topo e' sempre cn te anche quando non lo puoi vedere ! Appena vado all'ikea gli compro la fidanzata !!	positive
@user: E' pi√π facile aumentare le tasse che combattere l'evasione fiscale #governo #Monti. vero purtroppo.	negative
Fai un ordine il negoziante firma conferma Il pagament  60/90/120/150/180/210 giorni alla prima scadenza tel x chiedere Di spostare il 60/90	neutral
Governo Monti. Dobbiamo essere contenti. http	positive
RT @user: ODDIOO I RAGAZZI HANNO #RT IL MIO VIDEOOOO ODDIO STO MALE SCLERO CAZZOOO MERDAAAA	negative
Caro Ferrero, il PD √® ben felice di non sfiduciare il governo Monti http	neutral
@user Buongiorno amore ‚ô•	positive
sto governo Monti ha gi√† odore di fuffa.	negative
@user Ciao Aron... hai anche delle fans 21enni eh :P	neutral
Ho scoperto Community e mi ha cambiato la vita. #2012telefilmicoaddio	positive
Su Facebook tutti vogliono fare tanto i poeti e poi di persona non sanno accocchiare manco due parole.	negative
Arriva finalmente il ‚Äús√¨‚Äù della Soprintendenza Il 29 aprile #Grillo si esibir√† a piazza Croci http #m5s @user #apostosiamo	neutral
@user Costretti al risparmio... ancora... Ma ho fiducia nella manovra e nel governo Monti... Prof. Monti non ci deluda anche lei.	positive
Cronaca Flegrea - ELEZIONI/ Monaco accusa Figliolia: ¬´Non mantiene i patti, sta co.... Leggi tutto su http	negative
Chi ha pi√π stile? Formigoni o Mario Monti? Scopri i commenti del governatore della Lombardia su abbigliamento e... http	neutral
La cosa migliore del governo #Monti sono le donne con il cervello. #sapevatelo	positive
Ho una stanchezza addosso manco mi fossi fatto Napoli-Pietrasanta a piedi. Boia...	negative
Disertori della zappa #BolognaRoma	neutral
#matteorenzi Mario Monti e' l'uomo giusto al posto giusto nel momento giusto! Grazie Presidente Napolitano	positive
#Grillo ...il simbolo di un'Italia decadente...	negative
@user Elena √® caruccio anche se usato u.u a me mariana piace perch√© √® bello da vedere, da firmare e non √® molto usato :)	neutral
"\""vasco alla scala *_______________________* oddio √® un mito che spettacolo le canzoni riadattate\"" #porcodio"	positive
Odio il mio paese, sono arrivata a voler eliminare il mio profilo Facebook per quelle quattro zoccolette e dovrei voler rimanere qui? HAHAH.	negative
@user  ti prego aggiungimii! :3 Grazie!	neutral
Mangiare poco per invecchiare bene e vivere di pi√π http	positive
@user #ditelavostra Bersani nel #Pd √® il passato. Ma davvero qualcuno pu√≤ immaginare #Grillo alla guida di un Paese?	negative
Ore 18.53 INPS Fornisce il numero degli esodati e precisa: saranno in tutto circ... http	neutral
RT @user: Tanti auguri Diego. Sono 53 anni di storia importante. Ne verranno altri altrettanto esaltanti #ADL	positive
Alle 4 devo cominciare a studiare T__T E devo anche fare la spesa D:	negative
Ma serviva Monti all'Italia? mario monti, tasse, spread, italia, giuliano zulin liberoquotidiano.it: http via @user	neutral
@user direi che mi fai sempre fare due risate	positive
Oh ma vaffanculo	negative
La manovra salvatrice dell'Italia varata dal governo Monti contiene molte sorprese. Uno degli articoli, il numero... http	neutral
sosteniamo il governo Monti che affronta l'emergenza, perche' sappiamo che e' l'unica possibile alternativa al fallimento dell'Italia	positive
Passera conia #superidea e ricorda il miglior #Fantozzi, #Grillo che entra in politica. Ma in Italia le cose vanno per il verso giusto?	negative
@user Ricci sostiene #Grillo come lei sostenne il mostro della Lega con Profondo Nord	neutral
Mario Monti alle telecamere, o meglio videofonino, del Fatto: che splendido sole oggi tra poco sul sito #finecorsa #doposilvio	positive
@user Si √® dimesso Bini Smaghi il futuro prof a Harvard o Bini Smaghi il futuro ministro dell'economia del governo Monti?	negative
Nn m ricordo che devo fare!! #BRING1DTOITALY	neutral
Napolitano: ¬´saremo all'altezza del compito¬ª: Verso un governo di Unit√† nazionale guidato da Mario Monti. ¬´L'Eur... http	positive
Ma una donna in grado di essere chiamata a far parte del Governo #Monti? No, eh?!	negative
Se tutti conoscono la sorella di mia madre...√® una NotiZia?xD	neutral
#amoilnapoliperch√® √® la ragione, il senso e l'emozione di una vita tinta d'azzurro. Ti vedo giocare e mi commuovo: mai nessuno come te !	positive
Diciamoci la verit√†: a #Passera non importa un fico secco dell'asta per le #frequenze tv. Ci si √® trovato, come tutto il governo #Monti.	negative
#Renzi e #Travaglio hanno imparato a fare discorsi anche un p√≤ comici da #Grillo #serviziopubblico	neutral
@user *riprende a camminare sorridendogli*	positive
Il sobrio governo #Monti spende 600 mila euro per la fiera dei frutti di mare http	negative
luned√¨ mario monti presidente del consiglio? http	neutral
#Movimento5Stelle E #Grillo va, alla conquista del paese! | hubmagazine http	positive
A mio avviso il #Movimento5stelle di #Grillo che tanto accusava la #politica, ora da antipolitca √® nel pieno della politca.Questa √® seriet√†?	negative
Una email a Mario Monti. Dialogo diretto per il nuovo Governo http #opengov #montipen	neutral
 Visto che splendida giornata? Cit. Mario Monti 13/11/2011, Primo giorno del post-berlusconismo (forse).	positive
Che palle che palle che palle che palle che palle che palle che palle che palle che palle che palle che palle che palle che palle che palle!	negative
@user ma non hai ancora scritto un tweet? Prova!	neutral
La #manovra del Governo #Monti sulle Province non delude, ascoltiamo il resto	positive
#Grillo stasera non vuole andare a fare il confronto in tv con gli altri, preferisce farsi intervistare. Sembra #Berlusconi	negative
Perch√® Silvio deve lasciare il posto a Mario #Monti #dimissioni #opencamera #acasa #aeiouy @user http	neutral
Inno alla gioia per il Governo Monti http via @user	positive
"Universit√†_it: I docenti contro il governo Monti: ""La manovra ci penalizza"": Ancora tagli: √® l'accusa che i doce... http"	negative
Ho appena acquistato Cottage table su Stardoll. Dai un'occhiata alla mia Suite! http	neutral
@user @user #Grillo presta la sua faccia: ci√≤ che altri non fanno. Non troviamo la macchia su tutto quando non c'√®. #ultimaparola	positive
Caro Mario Monti conta fino a 10 per parlare,senn√≤ succede che dici tante cazzate come √® successo ieri sera a matrix	negative
Dieci domande al Mario Monti: http via @user	neutral
Se #Grillo mi promette una nuova Norimberga per l'attuale classe politica lo voto anche io...	positive
Delusione # governo #Monti: niente #patrimoniale	negative
Che cosa dovrebbe essere in grado di fare un vero uomo? ‚Äî essere liam james payne. http	neutral
Io tifo per un governo Monti	positive
Ora per√≤ basta con questa #sobriet√†, sto iniziando ad odiare la parola quasi quanto #questionemorale, governo #Monti non √® solo sobriet√†	negative
Il governo Monti alle prime prove oggi il premier in Senato per la fiducia http	neutral
@user Fantastico! vi seguir√≤ dal lavoro! :) e potrei anche proporre di proiettarvi su schermo in biblioteca! #librinnovando	positive
Il viceministro Martone scredita tutto il governo Monti	negative
La coca nella senape. Arrestato un corriere, Cronaca - News - Cagliaripad http	neutral
Chi √® Mario Monti YouTube http via @user (interessante ed utile)	positive
il governo Monti aumenta le tasse, la BCE taglia i tassi per dare una mano alle banche, ma ai cittadini chi ci pensa ?	negative
Amo questa canzone, glee me l'ha fatta amare ancora di pi√π! c: http	neutral
RT @user: Se #DavidBowie accetta il ruolo in #Hannibal, non credo che potrei #sopravvivere alla vista di lui e #MadsMikkelsen vicini.	positive
RT @user: Mai vista la prof di Scienze cos√¨ sclerata. Timore	negative
Diario di viaggio: arrivo a Chongqing - Giornata impegnativa quella della partenza! Arriviamo a Wuxi con un a‚Ä¶ http	neutral
Anche oggi sono in vacanza. #sapevatelo	positive
Grazie per avermi tossito in faccia. Te ne sono grato.	negative
Ed ecco che si torna alla base T-T #on	neutral
@user aww, grazie &lt;3 speriamo per il prossimo anno...	positive
"\""In Italia tutti gusti strani i giovani cantanti, in classifica meglio restargli dietro che davanti\"" fa ridere ahahahah #cattiviesempi"	negative
@user il tuo moroso sa che oggi si tornava a scuola?!	neutral
@user yoto cosa ne pensi della 5 stagione di fringe? secondo me √® la migliore spero che il finale non mi deluda	positive
Nuovo governo monti: dal bunga bunga al banca banca ...	negative
@user Quanto bisogner√† aspettare ancora per prendere visione del #Dossier #Grillo ?	neutral
 Casini:Trovare un'intesa tra forze politiche opposte e' un'impresa,ma per Governo #Monti ci siamo quasi.Un miracolo. Rendiamo grazie a Dio!	positive
oggi mia mamma mi ha svegliata un'ora prima wtf	negative
@user @user  di sicuro rimanendo terrestri c'√® di mezzo la mela di Newton: alla fine casc√≤	neutral
@user e di cosa si tratta? Non si vede bene (bella la foto). @user	positive
Perch√® rovinare un decente #governo #Monti (almeno nei nomi) con Corrado #Passera? (e parlo del personaggio) Speriamo bene...	negative
Napolitano auspica un'efficace e condivisa azione di governo, Monti si prepara a guidare l'esecutivo... http	neutral
@user CIP tutti ma non #Grillo qualcuno serio c'e rimasto...	positive
RT @user: #20ThingsAboutMe Ho un serio problema: se un ragazzo non ha almeno 30 anni sicuro non mi piace.	negative
IL #governo #Monti cosa dovrebbe fare per aumentare lo Sviluppo del Digitale in Italia? CLICCA E RISPONDI AL SONDAGGIO: http	neutral
Mi √® piaciuto un video di @user http Paolo Meneguzzi - Ho Bisogno D'amore (Videoclip ¬©NiHi	positive
Intanto Bersani dice che il Governo Monti non rappresenterebbe la sconfitta della politica ma o si va a messa, o si sta a casa #giaguari	negative
Le 7 cose buone fatte dal governo #Monti. L'elenco viene stilato da un insospettabile http	neutral
@user uno dei pi√π grandi di tutti i tempi. perfetto. grazie di cuore #respect	positive
Ma fatemi capire.. Ancora qualcuno crede alle minchiate di #Grillo ?	negative
#WeWantFernandoTorresOnTwitter non fare l'associale, fernando.	neutral
@user  alle melanzane di Curo' non si pu√≤ dire di no! HELLEN LOVES SICILY üòçüòò‚úå http	positive
Qualcuno mi dica che droga usa Mario Monti perch√© afferma che la manovra crescitalia √® piaciuta! Custu deppid'essi calloni!	negative
[News] Benzina, l?unico rincaro gi√É pronto per il Governo Monti http	neutral
eravamo cos√¨ abituati a ignoranti, cafoni, prostitute, ladri e indagati che l'educazione del governo #Monti ci sembra un miracolo #ministri	positive
Berlusconi ha dato il via libera a Mario Monti. E' impazzito? Cosa c'e' sotto?	negative
Colico investimento mortale pattegggia la pena: L'uomo investito era morto dopo 49 giorni di ricove... http #lecco #news	neutral
Juve, Paratici a Brescia per El Kaddouri e definire Leali. Piace anche Arcari come terzo portiere. I http	positive
@user ma Conte avr√† abbastanza fazzoletti?!	negative
vuoi lavorare come social innovator per il governo monti? invia il curriculum al ministro profumo http #avvisopubblico	neutral
I miei auguri al senatore Mario Monti: Al senatore Mario Monti vanno i miei pi√π sentiti auguri di buon lavoro.... http	positive
il governo monti e pronto a fotterci la vita e cari amici bisogna pagare un debito non fatto da noi	negative
Qualcuno ha il link della puntata di icarly?	neutral
Grazie @user ! Mantengo la promessa che ti ho fatto! ;)	positive
"RT @user: Gravi minacce a un senatore grillino: ""Ti disattiviamo il caps lock"". [@user]"	negative
@user mmmh.. va bene fr√†? io chiamo tutti cos√¨ (es. monica -&gt; m√≤) #LOL	neutral
30 anni son passati..... Buon compleanno ‚ÄúMelissa‚Äú .  (Maurizio) http	positive
Quello del Cav √® un passo indietro. Quello di #Napolitano, con #Mario Monti, sembra un doppio passo. Anzi, una rabona. #FullMonti #Colle	negative
"Ho scritto \""porta\"" al posto di \""porti\"". Adesso so tutto di economia politica e gnente di italiano. Ma complimenti."	neutral
ONORE A MAURIZIO BERARDINUCCI ....ONORE AL CORPO NAZIONALE DEI VIGILI DEL FUOCO http	positive
@user: non voto,non riconosco il governo Monti Chi l'ha detto? Scilipoti. Chi?	negative
discorso di Mario Monti al Senato http	neutral
Fitch promuove Governo Monti, pu√≤ essere una sorpresa positiva per mercati http http via @user	positive
il Governo Monti ha dichiarato di voler dare una svolta alla politica italiana. Preso da troppo entusiasmo, ha svoltato di 360¬∞...	negative
@user @user ma dove sono 20 e la signora? non vengono su twitter	neutral
@user tu ridi sempre anche quando non ce ne e' alcuna ragione... sei tranquilla	positive
Tutt'Italia si chiede quanto durer√† il #Governo #Monti ?! Ovvio! Tempo di una scalata! #oramonti #sapevatelo	negative
Quella di Beppe #Grillo √® anti-politica? | Alessio Liberati | Il Fatto Quotidiano http #m5sTour #m5s	neutral
Venerd√¨ Santo. Un abbraccio a tutti.	positive
@user Complimenti per avere tradito il voto dei vostri elettori dando la fiducia al governo monti	negative
@user bello molto bello allora.. Anche io ho preso tutto bianco  nella casa nuova..üòòüòò	neutral
@user ciao meraviglia,io tutto apposto e te? sdfghjkl. :3	positive
ci hanno messo in mutande..ridicolizzati in tutto il mondo.vietano ai poveri di curarsi. la gente cosa f√†? critica #Grillo povera italia	negative
Andria blitz della polizia arrestato pregiudicato http	neutral
@user FERMI TUTTI ho trovato un'altra persona a cui piace Fallen **	positive
 E' un Governo strano: le cose si fanno Come scusi? Dicesi governo #Monti #chetempochefa	negative
Il Governo Monti in Parlamento annuncia rigore, crescita, equit√† http via @user	neutral
@user mami, stupenda la recensione di a song for xx. spero che parlerai anche degli altri album perch√© ho imparato un sacco da questa :D	positive
Bossi ha appena detto che il governo Monti fa schifo, perch√© √® un governo di improvvisatori. Senza commento.	negative
Migliaia di persone per #Grillo in piazza Duomo a Milano. Era circa un anno fa, si sa com'√® andata http	neutral
@user Ci Sei stata?? Anche io la Adoro..	positive
RT @user: @user @user @user stile mafioso..ma loro nn lo vedono..e parlano di democrazia..i #piddiellini	negative
#ServizioPubblico non sa ancora che fare da grande riguardo il #M5S e #Grillo http via @user @user	neutral
@user - prese un altro paio c:	positive
Quell'idiota di #Grillo dice di fare default. http Ecco perch√© sarebbe una follia http	negative
@user @user @user @user  della serie non ne rester√† nessuno ÓêíÓêíÓêíÓêíÓêíÓêíÓêíÓêíÓêí	neutral
@user @user @user le delusioni capitano a tutti. non arrenderti! :)	positive
@user: comunque tra poco Mario Monti ci far√† un culo come una capanna. Mario Capanna Monti (magari)	negative
Vendola valuta il nuovo Governo Monti | umbrialeft.it http	neutral
Per una volta d'accordo con Oscar Giannino/ nella sua lucida analisi e nell'auspicio di un governo Monti √® pi√π responsabile dei berluscones.	positive
MARIO MONTI MASSONE, SERVIRE LE BANCHE LA TUA PROFESSIONE NTA	negative
approfondirete la figura di mario monti?	neutral
@user @user #Grillo ci√≤ che ha lo ha fatto da s√® Non ha preso nulla allo Stato. Conosco qualcuno che lo ha fatto e continua	positive
La Lega Nord organizza una manifestazione contro il Governo #Monti, il 22-01-2012 in Piazza Duomo a Milano, partenza ore 10 Piazza Castello	negative
@user beh lo dico sempre io le riunioni di #MIAMO hanno tutto un altro stile!	neutral
Di un sorriso s'innamora il mondo.	positive
@user e anche se fosse? #Grillo √® l' esempio del #populismo pi√π becero. Ti fidi di uno cos√¨?	negative
Nn so che fare!!!!!!!	neutral
"Consultazioni: Melchiorre (Lib-dem), si' a governo Monti, fara' ripartire Paese: Roma, 13 nov. ‚Äì (Adnkronos) ‚Äì ""... http"	positive
Egregio Professor Monti, pagher√≤ volentieri la tassa sui cani che mantengo a casa, se mi toglier√† la tassa sui maiali che mantengo a Roma...	negative
Si ritorna a fare allenamento dopo una lunga vacanzetta #forzaecoraggio #forzabiancoverdi	neutral
@user si agnese ecco..io avrei fatto un altro 'regalo' per te, per ringraziarti di tutto, per aver reso la mia vita migliore, pi√π-	positive
Siete pi√π scontati dei prezzi di luglio. #gobbi	negative
Batteria 2%...buonanotte a tutti	neutral
UNIMI Scienze politiche.   Vorrei ringraziate tutte le ragazze che seguono Storia dell'America del Nord per... http	positive
#Camusso @user: Governo #Monti si attribuisce ruolo di salvatore della patria ma la sua non √® la ricetta giusta .	negative
Google art project, l'arte online dai Musei pi√π importanti del mondo - Corriere Roma http	neutral
Qualunque cosa orribile tu possa fare o anche solo pensare...Io star√≤ dalla tua parte e ti... http	positive
#Grillo ci salver√† tutti?Ma come si pu√≤ dar seguito ad uno che basa tutte le sue idee solo sulla critica degli altri partiti? #piazzapulita	negative
#Asparagi #disintossicanti per il fegato, dopo #alcol e disordini culinari delle feste http @user	neutral
@user uh si si belli i bacetti....so dai sei perdonata...alle nonnine su perdona tutto	positive
@user Votano per chi difende il sindacato non arrendevole. #Grillo non fa parte di questo club. Per lui fa tutto schifo...	negative
ho appena fatto geografia per luned√¨,latino per marted√¨ e storia per venerd√¨. ieri ho fatto inglese per luned√¨ e un po' di matematica..	neutral
RT @user: il suo cappello. i suoi occhiali. i suoi tatuaggi. i suoi shorts gialli. √® perfetto. http	positive
Governo monti: saranno famosi!	negative
‚ÄúLA REGIONE SI ASSUMA LA RESPONSABILIT√Ä DEL DOPO-COMMISSARIO SENZA PERDERE ALTRI 9 ANNI‚Äù Ennesima presa di posizione‚Ä¶ http	neutral
@user Penso che il Governo Monti stia governando questo Paese in modo ineccepibile! Cosa ne pensa Lei? Un saluto	positive
#Grillo perch√® tutti questi attacchi a #M5S. Gli stiamo cos√¨ tanto sulle palle? Evviva la democrazia! Venduti!	negative
TT ITALIA 22:28 1.#Grillo 2.#serviziopubblico 3.#piazzapulita 4.Prince Of Persia 5.Renzi 6.Franca Rame 7.Partito della Nazione 8.Nero Wolfe	neutral
#roma #notizie Alemanno su Roma 2020: Nessun scetticismo nel governo Monti http #news	positive
@user Cosa dirai domani a Guido e Margherita che avete sciacallato i nonni pensionati?	negative
Il 1maggio anzik√® la festa dei lavoratori propongo la festa dei disoccupati #ditelavostra #Grillo in #italia tanto nn c'√® + ness ke lavora	neutral
Sar√≤ ingenuo ma nutro molta fiducia nel governo #monti e soprattutto in noi italiani e sono convinto che ce la faremo #crisi	positive
A Mar√≤.. Stime di -2,2 per colpa della manovra del governo Monti?! E daje su,finitela di dire cazzate... #Ballar√≤	negative
Liste pulite: Gianfranco Fini lancia le due petizioni di FLI  : Generazione Italia http	neutral
Mi √® piaciuto un video di @user http Messaggio a Mario Monti da Tonino o' Sdentat (detto o	positive
"Troppo berlusconismo nell'esordio del governo Monti. E l'Italia, a furia di subire ""lacrime e sangue"", √® governa... http"	negative
Controlla questo video MARIO MONTI: ¬´ABBIAMO BISOGNO DELLA CRISI¬ª http via @user	neutral
@user @user nonono,anche io :D	positive
Il grande problema del M5S √® che non si capisce ancora quale sia il ruolo di #Grillo #piazzapulita	negative
"Ivan Zazzaroni su Anelka: \""Adesso dai cinesi compriamo anche i calciatori usati\"" http"	neutral
@user bellissimo, beata te!! Anche io vorrei fare un corso di qualit√† ma che non costi troppo!	positive
Parodia-documentario in stile Voyager svela il lato oscuro di Mario Monti http	negative
Il Fatto &gt; La favola del Bradford, dalla quarta divisione alla finale di Coppa inglese	neutral
Pronta per scuola! http	positive
RT @user: In Italia ci sono oggi una trentina di piattaforme per il crowdfunding, ma solo 23 sono attive http	negative
monitora e commenta #mario monti http #partecipazione	neutral
Governo Monti: dal Senato via libera alla fiducia con 281 s√¨. Schifani: buon lavoro nell'interesse del Paese http	positive
Governo Monti crolla sulle liberalizzazioni. Taxisti-Monti 1-0. La Lagrimosa Elsa si sgonfia sulle pensioni. Trilateral out.	negative
Governo, Monti inizia le consultazioni: L'Italia si riscatti. Crescita ed equit√† sociale http	neutral
un presidente del consiglio che ha deciso di non essere pagato, un ministro che si commuove il governo #monti √® un vero miracolo	positive
Sto facendo l'errore pi√π grande della mia vita... E se lo perder√≤, non sar√≥ pi√π la stessa.	negative
4 punti di sutura per Consigli. Aggiornamenti sulla Samp ‚ñ∫ http http	neutral
Buongiorno!!! http	positive
Messaggi privati anche a chi non ci segue? Ma seriamente?  Ma non √® possibile, voglio dire.. come minimo gli account famosi andranno in tilt	negative
Tonino 'o sdentato manda un messaggio a Mario Monti http	neutral
http E' nato il Governo #Monti, i #ministri sono stati scelti... Buon lavoro!	positive
RT @user: 'se larry fosse una droga, morirei di overdose' ma siete stupide o stupide?	negative
Addio Mariangela Melato Arbore, amore di 40 anni: Abilissima protagonista in ruoli sempre diversi http	neutral
@user per fare due salti! Eravamo in centro...ti dir√≤ ci ho incontrato pi√π gente fiorentina di quanto mi aspettassi ;)	positive
Prc: Il Governo Monti invece di curare l'ammalato lo ammazza | umbrialeft.it http	negative
Quell'efferato sarcasmo di Mario Monti che uccide il povero Alessandro Sallusti http	neutral
@user la mia dolcezza mi caga :3	positive
RT @user: Per me posso anche morire.	negative
Domani tutti alla Corri Catania, corsa/passeggiata di beneficenza nel centro storico di Catania. http	neutral
RT @user: Subito RODRIGOOOOOO!!! Barcollo ma nn mollo!!! #amala #SkySerieA @user #TorinoInter	positive
Le donne sono architette. Cessano di amarti quando non possono pi√π fare progetti.	negative
TT ITALIA 01:48 1.#cinemaInChiesa 2.#serviziopubblico 3.#Grillo 4.Trota 5.Billboard Awards 6.Levon Helm 7.Prince Of Persia 8.Lega	neutral
La meteorologia non √® colpa del governo #monti #openMatrix	positive
#Grillo che propone di alzare i salari con i miliardi della TAV... Sempre pi√π preoccupante!	negative
one direction,rihanna,lovato,little mix. se ho nominato uno dei tuoi idoli. FEDEZ DOVE CAZZO LO METTI IN CULO ALLA BALENA? TROPPA FATICA?	neutral
@user tutto benissimo :) te?  anche tu‚ô•	positive
@user No √® solo una tipica minchiata alla #Grillo parole a caso per fare fumo...	negative
@user buon natale anche a te vecchio dalla mia met√† di cuore sovietico ahahah	neutral
Corrado Passera. #Ministro per lo Sviluppo Economico, le Infrastrutture e i Trasporti. Una garanzia nel nuovo Governo #Monti	positive
Mario Monti traditore di alto tradimento al popolo italiano e massone http	negative
Per il fatto che sono di Torino come voi dovete seguirmi(?)xD (@user live on http	neutral
Totti, Roma unito e rema da stessa parte: Capitano: cerchiamo di arrivare insieme uniti fino alla fine http	positive
@user mi spieghi una cosa? Che te le metti a fare le bretelle se poi te le lasci penzoloni sul culo?	negative
13) foto di una celebrit√† che faresti di tutto per incontrare: http	neutral
Strepitoso il titolo in prima di Libero sul governo Monti: Chiagne e fotte	positive
...il progetto di Mario Monti sui giovani √® simile a quello di Erode a Betlemme...	negative
La #costamagna dice che c'√® un'intervista esclusiva a #Grillo . Ma se ieri l'hanno intervistato quasi tutti... #Robinson	neutral
@user ciao!!Molto bene grazie tu? Ahahahhah	positive
S&P boccia ancora l'Italia, il governo Monti non basta http via @user	negative
Si parla di noi: #Governo #Monti, #dialogo con i #cittadini anche via #mail http #democrazia #partecipazione	neutral
Vorrei Che lo sforzo di Mario Monti fosse sostenuto e sorretto da una valanga di pensieri positivi...... Possibile? In Italia?	positive
@user e magari son gli stessi che hanno votato x il #PDL dove hanno molti indagati x mafia. purtroppo l'italia e anche questa.	negative
@user :: nemmeno un governo Monti 'di scopo'?: legge elett.+rientro in UE+elez.primavera?	neutral
Mario Monti: un grande uomo degno di guidare il nostro Paese!	positive
#Albertazzi subito carico a @user: Mario #Monti? E' moscio. Come #Montolivo, il centrocampista della #Fiorentina 	negative
Fini a Giarda: onorevole Ministro, faccia un ultimo sforzo! . #Governo #Monti	neutral
Il Consiglio dei Ministri nomina Pier Luigi Celli presidente dell'Enit.Ottima notizia per il turismo italiano. #Governo #Monti	positive
La vera tragedia italiana e' che l'alternativa dovrebbe essere #Grillo Siamo veramente alla frutta! #piazzapulita	negative
Creiamo un video con Ubuntu_ http	neutral
RT @user: Cose irresistibili in una ragazza pt.58  Quando fanno finta di non credere ai complimenti invece dentro saltano di gioia	positive
@user Il Governo #Monti ha una grandissima popolarit√†? Ditegli di venire su #Twitter ...	negative
seguite @user e #rt se l'hai fatto, almeno ti seguo c:	neutral
In bocca al lupo Professor Monti... Buon lavoro! #oramonti #berlusconifuoridaicoglioni	positive
Mario Monti: mangerai il panet√πn ma non la colomba #duraminga	negative
Tutto Intorno √© Ombra - Cathryn Green at Biella Festival 2011 http	neutral
E. Letta in questo momento Mario Monti incontra parti sociali e rappresentanze istituzionali di giovani e donne, questo il binario giusto.	positive
@user Troppa fatica altrimenti, l'abbiocco quotidiano non mi lascia scampo	negative
Dai che forse #Grillo riesce a far vincere la destra anche a genova - http	neutral
Sono fissatissima con Roar di Katy Perry da quando l'ho beccata su MTV ieri, √® il mio nuovo guilty pleasure.	positive
√à molto pi√π grave la pochezza politica di Fassina e di tutto il #pd che qualche scivolone di #Grillo #serviziopolitico	negative
Uscito di scuola	neutral
@user: Non mi pento di aver appoggiato la nascita del governo #monti, eravamo a rischio e non mi interessa vincere sulle macerie 	positive
(ANSA)-La Scala-Giorgio Napolitano e Mario Monti vedere la prima del Don Giovanni. MENTRE LORO SE LA SPASSANO NOI PAGHIAMO!	negative
NONOSTANTE GLI SCIOPERI SALE DI 5 PUNTI LA FIDUCIA NEL GOVERNO MONTI http	neutral
@user Amore mio‚ô•	positive
RT @user: 2) a primo impatto ci stavamo tremendente sul cazzo  #50cosesullamiamiglioreamica	negative
 Alcuni mettono mani nelle tasche degli italiani: sono evasori rispetto a contribuenti . Mario #Monti Vero, ma troppe tasse=troppa evasione	neutral
‚Äú@TTmobile_: #Grillo √® appena entrato nei TT Italia in posizione 2‚Äù @user @user super zio greeeeeee!!!	positive
Ma il governo Monti pensa di dirla una cosa a proposito di naufragi, #concordia, #giglio, Titanic? O sono dal broker a trattare la polizza?	negative
Ho fatto i capelli lisci :3	neutral
Bellissima e Bravissima  ieri sera la Tiziana Sinagra la sua voce incanta sempre il pubblico con la stupenda... http	positive
@user ci pensa #Grillo a farsi le vacanze in yacht dopo aver predicato bene.	negative
Governo Monti: c'√® crisi, ma non per fare la guerra http	neutral
@user come ti chiami? :)	positive
"#Grillo :\""colpito chi si oppone.dopo la lega punteranno Idv e noi\"". Si paracula preventivamente. #codadipaglia ?"	negative
Scuola in piazza contro la riforma Fornero http	neutral
@user Buon sabato anche a te :))	positive
Incredibile: Berlusconi da' lezioni al Governo Monti sull'economia!	negative
Governo Monti: quale futuro per le politiche contro le droghe?: La caduta del Governo Berlusconi sia un segno di... http	neutral
RT@iomatrix23: Game Over Liga !!!! Grande Mou ora che salgano tutti sul carro !!!‚Äù	positive
Liberizzazioni governo monti tanti dubbi... Le categorie piu povere devono sacrificarsi per far riprendere il paese da questa crisi...	negative
Gentile professor Monti http	neutral
@user seguitela tutti ‚ù§üòÅ!	positive
@user @user @user @user @user ahahah riesce a essere finocchissimo anche versione pseudo gangsta ahahah	negative
@user: Corriere della Sera: Verso l'incarico a Mario Monti: il custode del rigore che stopp√≤ http	neutral
E bravo Vendola http buon commento riguardo al Governo Monti @user	positive
@user un movimento che vuole rompere tutto con queste connivenze mi da poca fiducia, certo se la base prende le redini cambia tutto.	negative
siete a favore o contro il governo Monti che sta per nascere? #citofonareadinolfi live on http	neutral
@user wow!!! Cmq anche io sto bn :3	positive
Governo Monti: troppa prudenza POLITICA http	negative
"Napoli come punto di partenza per l'azione di Governo del Presidente Monti. ""Nel '97 Mario Monti defin√¨ Napoli... http"	neutral
RT @user: #maialadelleva!!!!!! #forzaviola #JUVEMERDA!!!!! Un sogno, un sogno un sogno incredibile!!!! Andiamo dai ragazzi!!!!! ‚Ä¶	positive
Manovra,Di Pietro:Su frequenze e patrimoniale Pdl ricatta governo: Monti pu√≤ anche sgolarsi dicendo che vuole l... http	negative
Veramente ci si augura un governo #Monti appoggiato incondizionatamente da tutti? E chi controlla? #Berlusconi non appogger√† Monti gratis.	neutral
Adoro #XF7  ... ma soprattutto adoro @user !!! Meraviglioso come sempre!	positive
"Quanto √® \""liquido\"" il grillismo? #Grillo bravo a criticare e incapace di progettare? √à antipolitica? - http #sartori"	negative
Super Mario pensaci tu!http Anche Gesu #Grillo Beppe Grillo #gmail #sapevatelo	neutral
Vedo solo ora ministri governo #monti. Ottima squadra.	positive
Forse leggere questo aiuta : anche #Grillo non sa bene che cosa sia la democrazia Repubblica.it http via @user	negative
"SABATO TUTTI ALLO STORICO ARCI PESSINA!Principale \""centro di aggregazione\"" del borgo, il Circolo Arci Pessina... http"	neutral
Mi piace moltissimo l'odore della cipolla che soffrigge **	positive
Vedi cosa succede a rompere la minchia? http	negative
@user ciao... potresti fare anche e me un BG con Avril miley e Demi? ti do i crediti nella bio	neutral
Io viaggio, non per andare da qualche parte, ma per andare. Io viaggio per l'amore del viaggio.  La grande... http	positive
@user L'invenzione di Berlusconi: Ci saranno 2 PDL uno classico, uno zero corrotti. Si uniranno dopo le elezioni! http	negative
http Il Governo di Mario Monti per salvare il BelPaese	neutral
Grande fabbro!	positive
"TIBURTINA,LIMIDO (LA DESTRA) ""ROMANI INSOFFERENTI VERSO GOVERNO MONTI"" http"	negative
Sanber alla vamoos :D	neutral
spongebob ha capito tutto dalla vita ahahabravo spongebob &lt;3 http	positive
Meta (Pd) Il Governo #Monti chiede salti mortali agli italiani.Metta all'asta anche le #frequenze digitali invece di regalarle a #Mediaset	negative
@user S√¨ Roma √® sdbvijdsbuidsh Alla fine non √® cosiiiiiiii lontana... lol	neutral
RT @user: NON:) TOCCARMI:) STO:) BENE:) http	positive
Mario Monti nativo digitale? @user #hbw2011	negative
Olimpiadi Roma, pressing sul governo Monti valuta dossier... http	neutral
Da leggere oggi Vincenzo Visco sull'Unit√° che spiega perch√© il governo Monti non √© esattamente un governo di destra http	positive
ovvio, #Grillo demagogo e senzaproposte. ma gli zombie dirigenti politici sordi con tutti, e arroccati nel... vitalizio. Domani @user	negative
Crisi e governo Monti: ecco la crisi in tutti i suoi dettagli http via @user	neutral
Un augurio di buon onomastico al presidente del consiglio Mario #Monti	positive
Governo Monti. PdCI: Paese guidato da uomini che contribuito produrre disastro | umbrialeft.it http	negative
Intanto Mario Monti si candida (pi√π o meno) http	neutral
Il discorso di Mario Monti al Senato √® stato cos√¨ serio e politico come mai ne ho visti nei miei 18 Anni di vita.	positive
La Giovane Italia Roma manifesta contro il governo Monti: Per noi i sacrifici, per banche e finanza i benefici! http	negative
Il Mugello apre le porte alla Formula 1 http	neutral
#noelezioni appoggiate il governo Monti per #nuovaleggeelettorale	positive
False illusioni, sgradevoli realt√† #editoriale di Mario Monti sul Corriere della Sera: http #rassegna stampa	negative
@user grazie mille .... immagino la tua emozione quandi hai visto	neutral
"#piazzapulita Formigli: \""Mi levate l'audio di #Grillo che mi d√† fastidio\"". √à comunicazione di servizio, ma anche la frase clou della serata!"	positive
La Dc commenta e critica le liberalizzazioni del governo Monti http	negative
Dai un'occhiata alla mia auto in #CSRRacing per iPhone! Provalo GRATIS!http http	neutral
GOVERNO MONTI: FORUM TERZO SETTORE, APPREZZAMENTO PER I DUE NUOVI MINISTERI: Il Forum del Terzo Settore augura a... http	positive
"Pannella scrive con le x e cose del tipo \""finalmente together\"" a #Grillo sulla questione #Norimberga Vi prego ditemi che √® tutto uno scherzo"	negative
Chiss√†	neutral
"@user: Quelle vacanze gratis del sottosegretario Prima tegola sul #GOVERNO #MONTI: questi si che sono governanti!	"	positive
Mario Monti il messia, accolto in Senato da un lungo applauso: Mario Monti, il messia italiano, √® stato accolto... http	negative
@user e fanno bene!! :D	neutral
@user ora venite in italia e mi devi seguire perche io tra un po' piango perche io vi voglio conoscere. vi voglio bene scemi ‚ô•‚ô•‚ô•	positive
applauso freddissimo al Senato per Mario Monti. Ottimo.	negative
ciao  a tutti	neutral
Mario Monti piace ai mercati, Piazza Affari in rialzo: Milano apre positva, in controtendenza rispetto alle altr... http	positive
Ora @user √® stupefatto fella debolezza del governo #Monti. Ora... http	negative
16. Se s√¨, √® un twitteriano anche lui/lei? SI	neutral
Dia Mundial del Jazz con il mio amore Chet Baker http &lt;3	positive
Esiste un'alternativa alla manovra iniqua del governo #Monti Domani in piazza con #CGIL #Cisl #Uil http @user	negative
#schema: C'√® un evento alla ribalta sui media dove si forma un'opinione pubblica? #Grillo lancer√† un comunicato sostenendo l'idea opposta.	neutral
#governo #monti l'emozione in una lezione	positive
@user √® come la storia del bidet. L'europa vuole che lo togliamo perch√© consumiamo troppa acqua	negative
Messaggio a Mario Monti da Tonino o' Sdentat (detto o' Poet ): video divertente http	neutral
Mario #Monti nominato Senatore a vita! √à un buon segnale nell'ottica di un incarico super partes e di larghe intese.	positive
2012: che la profezia dei maya fosse l'avvento del governo monti?	negative
Punto 1. Marito di Alia &gt; Non ancora √≤ √≤ /fixmale	neutral
Governo Monti: finalmente la serieta' e la sobrieta'! Poi.... ricambio generazionale e riaffermazione della Politica.	positive
& Lega Nord: NO AL GOVERNO MONTI! cosa ne pensate?	negative
Marco Galluzzo sul Corriere individua i diversi ambiti in cui Mario Monti intende operare in sede europea. http	neutral
Il governo #Monti ti ha lasciato in mutande? Loro ti offrono la cena. http	positive
Attacchi al Governo Monti, Mancini(Pd): Pdl e Udc prendano distanze da Storace http	negative
Mario Monti, l'ideatore di slogan http	neutral
:')   ‚ù§  ‚ù§  ‚ù§   :')	positive
@user anche io ho paura :/	negative
RT @user: @user che giornale √®?	neutral
nuovo governo monti... √® emozionante	positive
 Irresponsabile far cadere governo Monti . Mister B deve stare proprio male per fare certe dichiarazioni. Povero :-(	negative
marted√¨ 29 alle 21 in sede a via L. Da Vinci 5 PG ci confrontiamo su: governo Monti, evento del 2/12 sul dissesto geologico, festa del 10/12	neutral
@user @user Posso chiedervi dove le avete prese? Hahaha	positive
Si avvicina prepotentemente la prospettiva di un ritorno in piazza per una nuova, enorme manifestazione contro il governo Monti	negative
Che ne pensate dei nomi del governo monti? Ditelo in tre parole con l'hashtag #3parolesumonti	neutral
@user ma quanto sei bello nella foto del profilo	positive
MARIO MONTI L'ALIENO: GODETEVELO ANCORA PER POCO http	negative
"\""Come √® nata la Bibbia. Introduzione generale alla sacra Scrittura\"" di Fabio La Gioia (@user ioni) http"	neutral
Caro che bello Del Piero!! &lt;3Hanno fatto un servizio su di lui su RaiSport1 :)-PDC11	positive
Sono quasi due settimane che la strada di casa √® buia. Quando si decideranno a cambiare le lampadine ai lampioni?	negative
@user @user aww grazie c:	neutral
Il Governo #Monti √® l'unica alternativa possibile,credo che in questo momento di crisi la politica vada messa via,avanti con il gov. tecnico	positive
#delusionemonti a malincuore accantono speranze sul #governo #monti imbrigliato dagli #interessi di #partiti e #casta	negative
un percorso di crescita personale √® tale solo quando viene applicato in ogni momento della giornata, in ogni ambito della vita	neutral
 Noi non sosteniamo il governo Monti, noi sosteniamo l'Italia @user bellissimo!	positive
@user ‚Äúlettera a un amico ehreo‚Äú di Sergio Romano. Un po' suscettibili lo sono davvero	negative
#Grillo [VIDEO] Ci hanno regalato la #crisi | Italia dei Dolori: http #Norimberga? No: galera!! via @user	neutral
RT @user: Forse, finalmente, per una domenica si parler√† di Giuseppe Rossi (un vero esempio per tutti) e non di Mario Balotelli. For‚Ä¶	positive
E diciamocelo. Se quello che sta passando con il governo #Monti l'avesse fatto Berlusconi staremo facendo le barricate	negative
I liked a @user video http Incredibile! Voyager smaschera Mario Monti !	neutral
#rt seguimi e ti seguo e ti aggiungo alla mia lista aumenta followers c:	positive
Ma se il governo monti √® ostaggio di una politica stantia e di una maggioranza trasversale di inette testedicazzo che cazzo ce sta a fa?	negative
@user HAHAHAHAH fatto c:	neutral
RT @user: Odio le relazioni a distanza, il frigo √® cos√¨ lontano dal mio letto! ugh..	positive
[News] Mario Monti a capo del Governo tecnico? Come avere un marziano a Roma http	negative
Stato del #debito etica della colpa. governo #monti http	neutral
Siamo a 50 #followers grazie a tutti	positive
Mario Monti....la mia √® una disponibilit√† generosa per guidare il governo.....quanto ci costa questa generosit√†? 20mila o 30mila al mese?	negative
Anche 'Torn' non scherza per√≤!	neutral
Peperoni e patate al forno ....,.che dire? Complimenti alla cuoca!!!!	positive
Mario Monti, l'allievo dei Gesuiti che piace alle Banche e Finge di voler Aiutare gli Italiani Chiedendo Sacrifici ai pi√π Deboli.	negative
#Piazzapulita Lo #spread di nuovo sotto quota 360. Il Governo #Monti convince i mercati? Voi cosa ne pensate?	neutral
RT @user: Buon compleanno Diego Armando Maradona! (53 tahun). http	positive
La frase di Mario Monti sul gesso da togliere all'economia italiana mi ricorda quelle convalescenze lunghe e tristi...	negative
Kl1p, condividere velocemente tutti i tipi di testi http	neutral
del governo #Monti il 31% apprezza che decida in tempi brevi: ci sono anche io!	positive
Mario Monti √® un uomo di Stato: ma di quale Stato?	negative
PROSSIMAMENTE IN TUTTA L' ITALIA Mario Monti & Co presentano.. http	neutral
#mammahoripersolaereo pu√≤ essere vecchio quanto vi pare ma rimarr√† sempre uno dei film piu belli che ci siano.	positive
RT @user: Ma esattamente, Valerio Scanu a quale specie vivente appartiene?	negative
il governo #Monti si vanta di ridurre il debito con i recuperi dell'evasione, da imputare invece alla riduzione della tassazione complessiva	neutral
#Vauro: √à pi√π facile fare satira sulla Fornero e su questo governo che su Berlusconi . #governo #monti	positive
Professor Monti ma si rende conto che i creditori non credono alle sue ricette?	negative
@user @user @user @user @user magari si potesse fare ;)	neutral
@user: Gianni Letta: Sicuramente non far√≤ parte del governo Monti (ag Dire) e meno male!	positive
#Grillo √® tanto severo contro tutti quanto clemente e comprensivo con lega e leghisti.. #serviziopubblico	negative
La felicit√† non esiste. Esistono solo momenti in cui si raggiunge l'apice dello stare bene, ma √® destinato a finire anche quello.	neutral
Bella sta verifica ..... @user @user	positive
Attraversiamo un campo minato...Tutti al passo del leopardo...!	negative
"Buon giorno e buona domenica a tutti.. Vi voglio ricordare che la nostra strepitosa OFFERTA \""Camere a Met√† PREZZO\""... http"	neutral
Un pensiero: Dobbiamo avere fiducia in noi stessi per preparare un'Italia migliore per i nostri figli. (Mario Monti)	positive
#serviziopubblico Renzi critica #Grillo ma poi cerca di fare il comico con risultati disastrosi... manco quello riesce a fare.	negative
http Il Governo Monti vuol colpire i consumi per ridurre il passivo della Bilancia comme... http	neutral
@user :) capito	positive
@user @user @user scritto √® una cosa insensata.	negative
@user In realt√† #Grillo sembrerebbe essere in trincea con la #lega. Almeno dopo le ultime dichiarazioni, no?	neutral
Un Roberto a caso per voi ;) ...da ieri sono in fissa con queste foto: barbetta accennata, viso rilassato, fisico... http	positive
@user hai ragione, ecco perch√® l'italia si √® ridotta cos√¨ e poi se la prendono con le pensioni.Andr√≤ in pensione a 65 anni ,schifooo	negative
#hitchhiking #passaggio From Torino, Italia To Bologna, Italia http	neutral
Fiat, Marchionne: 2012 per l'auto ancora pi√π difficile: Totale appoggio al governo Monti http	positive
#Grillo odi i politici e i partiti? Ti prego, raccontami ancora di quando ne hai fondato uno.	negative
@user AHAHAHAHHAHAHHAHAHAHAH il costume basso ma dai √® capace di iperventilarci (?) anche vestito di lana fino al collo (?)	neutral
@user Grazie perche' sei il mio sorriso che non si spegne anche quando sono triste! T i a m o	positive
Governo Monti: ipotesi #Passera allo Sviluppo. Candidatura spontanea della Minetti.	negative
Open Bnl Italia, sorteggio a Piazza di Spagna http #news	neutral
Su rai1 la partita dell'Italia non √® criptata per gli utenti SKY: il primo vero effetto del governo monti?	positive
False illusioni, sgradevoli realt√†: http L'editoriale di Mario Monti sul fallimento di Berlusconi, oggi sul Corriere	negative
#governo #monti #ministri nell'archivio di Radio Radicale: #Giampaolo #DiPaola #Ministro #Difesa http	neutral
1927: 1¬∞ posto, 9 vittorie su 9 e 27 punti. TUTTO TORNA.	positive
e almeno una cosa chiara ho: sono tutti incazzati con Franceschini, che ha bombardato il governo Monti a tradimento..	negative
@user: Professor Monti, permette due parole? http	neutral
La Camera dei Deputati ha dato il via libera al governo Monti: finalmente si volta pagina. http	positive
@user Visti video in rete, non mi sembra granch√©. sotto porta x√≥ ha senso della posizione su rimpalli, come il cuchu un tempo	negative
@user #Grillo ha sempre detto quelle cose della TV ma esprime un opignone personale. Spero che quel candidato abbia una motivazione	neutral
@user anche io le sto cercando  di convincere...male che vada ci andiamo insieme.lol	positive
@user @user io nn ti faccio nessuna predica,dico solo che sei un povero ipocrita che giudica gli altri e fa di peggio,Amen!!	negative
PPN Verso un nuovo governo a guida Mario Monti http	neutral
@user come ti capisco! Io vorrei rivederlo e abbracciarlo fortissimo! Dirgli quanto gli voglio bene	positive
Governo Monti-Napolitano sa tanto di padre che toglie il giocattolo al pupo che senn√≤ rischia di sfasciarlo...#elezioni #308	negative
@user @user  io direi di farlo da me cosi guardiamo per sto locala cald con tuo fra x l'irrigazione che devo ancora pagartelo	neutral
Napolitano,classe politica,stampa sovvenzionata e non , tutti contro #Grillo : motivo in pi√π per votare movimento 5 stelle !	positive
Non ci sono solo studentelli idealisti a pensare che il Governo Monti sia un rischio sociale alto. Vogliamo parlarne? http	negative
Lo spot della fiat 500? Si gira a Maiori - Corriere del Mezzogiorno: The spot of the fiat 500? He turns to Maiori.http	neutral
http √® un pezzo meraviglioso questo. Professor Monti permette due parole? #manovra	positive
Rubati i primi soldi agli Italiani dal governo #monti #ladri http	negative
Beauty contest, il Pd chiede al governo Monti di cambiare le regole: Non si pu√≤ regalare agli incum. http	neutral
@user ti seguo! :)	positive
@user Eh Prive! (?) anche tu con campoolo no, ti prego D:m	negative
IL PD E IL GOVERNO MONTI. GOTOR A TUTTO CAMPO ALL'INCONTRO PROMOSSO DAL PD http	neutral
@user ad #agendadigitale sarebbe un ottimo inizio per questo governo #Monti. Servono competenze e persone giovani!	positive
RT @user: conte fa il possibilista e pragmatico sui moduli. e poi dobbiamo tenerci padoin sulla fascia contro il principio di re‚Ä¶	negative
@user Il consigliere dell'UDC e tutto il PDL fanno il loro mestiere. La novit√† √® l'appoggio del PD in sintonia col governo Monti	neutral
@user ** oddio ‚ù§Ô∏è‚ù§Ô∏è‚ù§Ô∏è‚ù§Ô∏è anche ioooooo‚ù§Ô∏è‚ù§Ô∏è‚ù§Ô∏è‚ù§Ô∏è‚ù§Ô∏è‚ù§Ô∏è	positive
Domani #Piazzapulita: SALVATORI DELLA PATRIA Il governo Monti stanga i ceti deboli Quando toccher√† a quelli che non vengono mai toccati?#La7	negative
"@user .. senatore Monti si doti di una rampa di lancio, lei √® distante anni luce dai problemi della \""povera\"" gente !"	neutral
I laureati italiani danno piena fiducia a Mario Monti http via @user in #edicolafree #giovani #politica #attualit√†	positive
Dopo #Grillo ho imparato che non sempre dove c'√® la merda si sente la puzza .. a volte √® profumo di soldi!!! #poveraitalia @user	negative
@user  ti pagano a fare cosa?	neutral
@user Anche tu odi Marta. Oh, ti amo, teiera rosa *-*	positive
Il Grande Golpe Globale chi sono Mario Monti e Luca Papademos? http via @user	negative
se #Grillo sta parlando a Monza,vorrei sapere se c'√® un live streaming in questo momento,RT please, grazie #piazzapulita	neutral
Un caloroso bentornato a @user ! Stella presente e futura della nostra nazionale. Un augurio di pronta guarigione! #ForzaAzzurri	positive
RT @user: -DARE PESO ALLE VOSTRE CRETINATE. MA NON CI FATE CASO? PERCHE' I VOSTRI IDOLI CI STANNO MALE MA TAYLOR NO? CHI PENSA A CO‚Ä¶	negative
Le congratulazioni di Michele Iorio al neo premier Mario Monti http	neutral
@user si lo yogurt bianco chi lo vuole scusa hahahah poi se vede che la vaschetta accanto √® vuota lo vuole ancora di meno	positive
@user non lo so, davvero non lo so. quei due mi odiano ;_____;	negative
in pratica c'ho messo il letto grande, e ho spostato tutto: armadio, scrivania, stereo. TUTTO √©w√®	neutral
#ITALYLOVESBIEBER RT se anche tu pensi che la Devonne senza trucco sia ancora pi√π bella.	positive
i falsari di banconote potrebbero rilanciare i consumi in italia	negative
@user @user √â vero. E pure l'aeronavale della Marina	neutral
tutti pensano che #Grillo e' #l'antipolitica e non far√† mai paura..anche la #Lega nacque cos√¨...intanto pero' facciamo #piazzapulita	positive
non posso credere a quello che leggo #Grillo mov 5 stelle 3^ forza del paese, il populismo paga, ma governare un paese non √® roba da cabaret	negative
@user ciao, benvenuta nel regno della Luna Rossa :)	neutral
Kekkoo! sono Giorgia solo che con un altro cognome..quello del mio fidanzato [quello della foto..bello √®] xD!	positive
 Bersani: ¬´Governo Monti punti al cuore degli italiani¬ª. Il fegato se lo sono rovinati col governo Berlusconi. 	negative
#Mario Monti Lettera al premier Corriere della Sera: http via @user	neutral
@user faccio la metereologa HAHHA lo sai?uu	positive
Arriva Occupy Ancona, contro la manovra finanziaria e le politiche governo Monti http	negative
http srl facile, lettera aperta al governo #monti.	neutral
@user Le misure arriveranno 20 giorni dopo l'insediamento del governo #Monti e, visto il silenzio di questo periodo, fanno ben sperare	positive
Il governo Monti ha aumentato l'Ici ai pensionati con prima casa del 60% e alle banche e assicurazioni del 20%. Sono le manovre eque...^fb	negative
Il mondo del lavoro ‚Ä¢ Re: RIMBORSO  IRPEF SU CASSA MARITTIMA: dovevo ancora nascere in quelle dateStatistiche: I... http	neutral
ora il governo Monti toglier√† le pensioni di anzianit√†... e sar√† giusto	positive
Governo #Monti: Sparisce il ministero del federalismo. #Calderoli ha detto qualcosa a riguardo ma tanto, ormai, chissenefrega	negative
Il governo #Monti blocca la sanatoria per non pagare le tasse sui manifesti @user	neutral
Romano Prodi: Mario Monti risposta italiana alla crisi credibile... http	positive
@user Sara' dura per tutti con il nuovo governo #Monti, speriamo serva	negative
@user @user ...vero: √® che con tutto questo #Grillo in televisione stasera considero altri gli insulti...	neutral
#serviziopubblico in questo momento non possiamo scegliere, governo monti, poi elezioni con nuove regole!#brignanoiena	positive
#Grillo esiste per colpa vostra... e anche per questo dovete andare tutti a casa !! #non√®populismo	negative
RT @user: voglio vedere dei profili perfetti. #rt seguimi, ricambio e ti voto il profilo. non unfollowo se non lo fai tu.	neutral
#ilRagazzo mi ha fatto due faccine in un solo messaggio: erano giorni che non succedeva LOL	positive
Che nel governo Monti l'Economia vada indifferentemente a Siniscalco, Bini smaghi o Saccomanni e' demenziale. #fullmonti #stamoagioca'	negative
Governo Monti o elezioni?!	neutral
Vendola favorevole al governo Monti. Non me l'aspettavo e mi fa piacere! #FullMonti #3O8 #fatepresto	positive
Tra le decisioni del governo Monti aumento della benzina di 10cent e del gasolio di 12cent da gennaio. Siete contenti ITALIOTI ?	negative
Il parallelo #LePen con #Grillo conferma che andare a #serviziopubblico o in altre trasmissioni √© inutile. Dopo l'#antipolitica, #fasci	neutral
Dillo che mi volevi fare piangere :') ti amo amore, ti amo come non ho mai amato nessuno prima d'ora. ‚ù§http via @user	positive
non rompete il cazzo, l' abbiamo fatto per divertimento, dai un p√≥ di umorismo.  #twitterparty	negative
 @user: i ministri del governo #monti si tengano fuori dai talk show #ballaro #pauradelleverita	neutral
Oddio c'√® anche il Tavor!!!! SeeeeeeeeIo amo i DLC con nuove armi!! (@user http	positive
@user La dimostrazione che il governo #Monti √® un disastro.	negative
Il consulente giardiniere della Regione #Lombardia prende 150.000‚Ç¨ l'anno. O.o' #m5sTour #Grillo @user	neutral
#Grillo non √® il peggiore dei mali, e se tra mali devo scegliere lui √® quello minore, o quello di cui ancora non ho sofferto...	positive
#5Stelle: @user, al qualunquismo di #Grillo manca solo il cappio http	negative
@user va bene ragazzo questa settimana lo faremo perche ti fai il tatuaggio !!	neutral
@user hahahahahaha ;)))	positive
Vladimiro Giacch√®: Il governo Monti non √® la soluzione. Serve una vera svolta politica ed economica: Vladimiro... http	negative
La concertazione divide i Sindacati. Cgil: Monti sia chiaro: Camusso: No a solisti stonati. Se il governo Monti... http	neutral
Bellissimo video Maurizio Crozza imita Mario Monti 18 11 2011 26:00 UrlTubem http via @user	positive
Nella manovra del Governo Monti: soppressa l'Agenzia Nucleare.... ultimo atto di una farsa tutta italiana? http	negative
RT @user Non condivido tutto ma √® giusto rifletterci #pd#senza rinnovamento radicale, tanti voti a #Grillo http	neutral
Europa, @user #italia ha ritrovato credibilit√†. positivi risultati governo #Monti	positive
Sta partendo il fuoco di fila contro il voto anticipato. Cos√¨ ci siamo giocati anche la cartaZapatero. E se non si fa il governo Monti?	negative
SENTENZE. La Consulta boccia l'acqua pubblica pugliese (06/04/2012) | Vita.it http (via Instapaper)	neutral
sono troppo orgogliosa, si	positive
 Merkel: ¬´Le riforme strutturali del governo Monti sono impressionanti¬ª. il ristorante di Montecitorio diventer√† un self-service. 	negative
Governo, Monti: A breve misure di impulso per crescita: Per rendere il consolidamento fiscale sostenibile http	neutral
#XF7 il mio primo tweet di stasera √® per il grambiulino giallo di andrea.  Io voto per te #asilosyle	positive
Banchieri e membri della Trilateral nel governo Monti...Aiuto! Largo ai complottisti!	negative
Camera. Come al Senato solo la Lega vota no a governo Monti http	neutral
@user Seguindo segue de volta amore ‚ô•‚ô•‚ô•	positive
Nuovo provvedimento del governo Monti: tassare gli italiani all'estero. Da soli ci risolverebbero il debito per i prossimi 200 anni.	negative
@user @user Non si fanno cos√¨ i cuori su Twitter .-. alt + 3 della tastiera dei numeri affianco ‚ô•	neutral
grazie per avermi regalato il libro, ti amo.@user	positive
ma come ci siamo ridotti per essere contenti di un governo Monti che ci massacrer√†....	negative
@user Mario Monti √® stato costretto, nella sua qualit√† di Commissario europeo sotto la presidenza Santer, a dare le dimissioni	neutral
Mi piace quasi tutto il #Grillo che c'√®. Ma una volta fuori dai suoi sacrosanti monologhi,sopravviver√† al dibattito politico? @user	positive
#ballaro Governo Monti:tutto quello che voleva fare Berlusconi ma non poteva	negative
Incidenti stradali:due morti e due gravi http	neutral
A chi non piace #Grillo ed √® schifato dalla politica attuale consiglio di votare #MoVimento5Stelle.Grillo non √® candidato INFORMATEVI BENE!	positive
"\""quando ami devi anche lasciar andare\"".AO' A STRONZO!MA VA NPO' A FANCULO!COMINCIA A ESSE NPO' TROPPA STA GENTE DA LASCIA' ANNA'!"	negative
"#Grillo ora avverte \""Dopo la #Lega colpiranno noi e l'#Idv di Di Pietro\"" - http"	neutral
Difficile sopravvalutare il contributo di Santoro e #Grillo alla coscienza civile e alla maturit√† degli italiani	positive
Il programma del governo Mario Monti √© quello di Berlusconi senza Berlusconi	negative
MARIO MONTI:72.000 EURO AL MESE.ECCO QUELLO CHE LE TV NON TI DICONO SUL NUOVO PREMIER. | Free Italy: http via @user	neutral
@user @user #Grillo stasera #Desenzanodelgarda ha fatto il pieno io dico che travolger√† molti partiti la gente e' stanca!	positive
Odio i miei genitori! Devo fare per forza la cresima .__. IO NON CI CREDO CAZZO..TANTO ME VADO A SPOSA' IN COMUNE! FICCATEVELO IN TESTA!	negative
Marra, Scilipoti e la Tommasi: esposto contro Mario Monti http	neutral
in bocca al lupo a Mario Monti....speriamo bene!	positive
Non ho mai simpatizzato per #Grillo ma le calunnie che sta subendo mi indurranno a votarlo. Si dimostrano ancora una volta dei #mafiosi!	negative
#rinnovabili domani question time del PD, alla Camera, sulle rinnovabili	neutral
"Romano Prodi. ""Ho una grande fiducia nella saggezza di Mario Monti e credo che abbia capito la grande urgenza http"	positive
Ieri sera Mario Monti a Mixer ha perso una buona occasione per stare zitto	negative
"@user @user @user @user @user anche quelle di un \""principino\"" (cit) non scherzano, mi pare :-)"	neutral
@user grazie *----*	positive
‚Äú@DanieleKeshk ‚Äú@LucaToluBLOG #Grillo non √® la soluzione ai problemi dell'Italia: #Grillo √® un sintomo dei problemi dell'Italia.‚Äù‚Äù	negative
Il Senato voter√† questa sera la fiducia al governo di Mario Monti, che prima illustrer√† il programma... http	neutral
@user naturalmente uu *ride*	positive
RT @user: 'impacchettare gente a natale e spedirla a fanculo'	negative
Serviranno #Grillo in tutte le salse. Pu√≤ anche darsi che le tv superino il limite e ci sia una crisi di rigetto.	neutral
#Schifani e #Fini: s√¨ al taglio degli #stipendi per i #parlamentari, ma non decide il Governo #Monti http via @user	positive
RT @user: 'tipi di persone su twitter'  L'INNAMORATA. Lei che trova il fidanzato su twitter. http	negative
Economia, Chiodi: via libera alla legge sull'industria http ilcapoluogo.it	neutral
warrior dal vivo √® una meraviglia, ho i brividi.	positive
e anche se non siamo realmente dietro le sbarre, questo mondo √® una prigione con la cella un p√≤ pi√π grande!	negative
La vera storia di Mario Monti http #spottv #laverastoriadimariomonti	neutral
Votanti 306, 281 favorevoli, 25 contrari. Super-Mario #Monti incassa la fiducia al Senato.	positive
@user si certo, ma questa definizione passa spesso in secondo piano a seconda di chi viene indagato	negative
Indicazioni per Mario Monti sul cosa e dove si dovrebbe tagliare per fare cassa. http	neutral
RT @user: buongiorno!il mio augurio oggi √® per la mia mamma  perche' √® il suo compleanno .. ti amo mamy sei la mia vita http	positive
Secondo voi, con quella faccia antipatica, Mario #Monti, si sar√† mai divertito nella sua vita?	negative
Un frosti t lo doy alla @user hahahahaha	neutral
La rivoluzione dei cento fiori di Mario Monti √® partita. Le liberalizzazioni hanno cominciato a farsi strada... http	positive
Mi ero dimenticata del servizio Atac Roma.. #buongiornomondo	negative
Casa e IVA nel mirino del Governo Monti per ridurre il debito: Le misure saranno illustrate domani al vertice eu... http	neutral
@user grazie tvtttttttttttttttttttttb&lt;3 lol	positive
sembra che la fiducia degli italiani nel Governo Monti sia inversamente proporzionale alle temperature.	negative
Semplificazioni: il Comune di Cesena √® gi√† pronto ad adeguarsi alle direttive del Governo Monti. http	neutral
LUCIANA LITTIZZETTO 20/11/2011 Lucianina commenta il governo Monti http via @user adorabile!	positive
#Renzi dopo #Grillo equivale ad una doccia ghiacciata sotto il solleone. Non √© piacevole #serviziopubblico	negative
Mario Monti torna in treno a Roma http via @user	neutral
RT @user: Esiste un sito di incontri per calzini spaiati.	positive
Questi signori dissertano di economia del paese ma non sanno neppure quanto costa un kg di pane o un litro di benzina #piazzapulita	negative
Leggo news VACANZE GRATIS, MALINCONICO SI DIMETTE. LASCIO PER SALVARE IL GOVERNO MONTI : ROMA Il sottosegreta... http	neutral
Happy 11/11/11, speriamo ci sia una svolta sul Governo Monti..	positive
Il ricorso al senatore Mario Monti √® l'ennesima manifestazione della loro incapacit√†.(Maria Vittoria Pittamiglio) http	negative
MILANO- Dieci buste indirizzate al premier Mario Monti, a Silvio Berlusconi e ad alcuni direttori di quotidiani... http	neutral
@user Tutto ok, ho inchiodato, ...ti ho dato un bacetto e sono ripartito :-)	positive
Mario #Monti e Mario #Draghi sono massoni. Sostiene il portavoce del God alla Zanzara. Sconcerto e sbigottimento.	negative
Villa rallegra gli indigeni! Con questa costruzione la mia isola √® ancora pi√π fantastica!	neutral
@user s√¨, sono proprio una simpatica canaglia. :D	positive
"@user: Governo Monti, professori in Italia, scolaretti in Europa(#Santanch√©). Sar√† un po' meglio di puttanieri nel mondo? #l'infedele	"	negative
@user puo' anche nn piacere o nn concord.ma #Grillo ha un suo programma, ABC parlano,parlano ma poi permet.a questo Governo l'iniquita'	neutral
Vi siete sciroppati di buon grado un Governo di pulcinella e ballerine e ora fate le pulci al Governo Monti?! Ma ripijateve! #rimontiamo	positive
RT @user: @user ciao, Rosario a dire la verit√† ieri sera Amadeus non si poteva guardare!! Made Cina!!!	negative
Giorgio Corona al 28 minuto segna su calcio di rigore Messina 1-0 Poggibonsi	neutral
"@user Scusa il disturbo,puoi inviare un tweet a @/_StrengthToGoOn con scritto\""Dori ti trova fantastica,sei la sua vita\"" grazie‚ô•"	positive
"Ogni citt√† qualche guaio ha""@user: La manovra del governo #Monti √® stata scritta dal Principe Giovanni e dallo sceriffo di Nottingham"""	negative
mlmlmlmlmlmlmlmlmlmlmlmlmlmlieri a tutta forza con il vino	neutral
√® bello anche quando dorme..	positive
#Grillo a #Budrio ; ancora non una parola su come governare Budrio : e' uno show . Niente concretezza . Deludemte .	negative
@user salve! Nessuna novit√† ancora per i correntisti di Banca di Bologna? Grazie!	neutral
Forza Juve!!	positive
Eurozona, frena a sorpresa l'indice pmi della crescita economica: Il pmi flash dell'Eurozona a ottobre sce... http #fb	negative
La manovra varata dal governo Monti arriver√† in aula alla Camera mercoled√¨ alle 10. L'esame del provvedimento... http	neutral
Costi politica, Maroni: Stretta su vitalizi una cosa giusta: Ma l'ha fatta il Parlamento non il governo Monti http	positive
Se nel governo Monti entrano anche i ministri del governo Berlusconi come si fa ad avvicinarsi. Quelli hanno rovinato il Paese. Non si pu√≤	negative
Dal Gioved√¨ al Sabato alle 13.50, su Italia 2, appuntamento con il blocco #Cinema 2. Guarda il video: http	neutral
"che dire, anche oggi stupendo! ""@user: 'Governo Monti: 10 e Loden?' il titolo di #agorarai"""	positive
Votare #Grillo per vendicarsi dei partiti tradizionali √® come ammazzare la propria madre per fare uno sgarbo alla nonna. #M5S	negative
In questo momento alle commissioni Bilancio riunite di Camera e Senato per illustrare le politiche di coesione del Governo #monti	neutral
@user a Otto e Mezzo dopo tre mesi... contento del governo #Monti	positive
Va bene, sosteniamo #Grillo che soffia sul fuoco. Sosteniamo chi si √® fatto conoscere mandando a fanculo la gente.	negative
Edilizia residenziale. Il Governo Monti vara gli incentivi. http	neutral
Linkiesta LIVE Famiglia Cristiana online: Governo, ripartire da Mario Monti, l'unico che pu√≤ tirarci fuori dalla palude 	positive
CasaPound, protesta contro il governo Monti La Nazione Firenze: http via @user	negative
Giulietto Chiesa vs il governo Monti e il silenzio sulla speculazione internazionale http	neutral
Fede:se silvio se ne va lascio il tg4. Ecco la I notizia positiva che produce il governo monti.	positive
RT @user: sto soffrendo http	negative
@user ciao facciamo parte della stessa lista aumenta followers che ne dici di ricambiare?	neutral
@user sostieni 30ore per la vita e la maratona di radio private che parte sabato prossimo alle 16! Consigliaci ai tuoi followers!	positive
"RT @user: Abbassare le aspettative da principe azzurro a ""poco nuvoloso""."	negative
E domani sera ritorno a Roma, per adesso siamo imbarcati sulla nave. Sicuro ritornero' a Barcellona per conto mio.	neutral
La7 parlano ancora di #Grillo e di come fa paura alla #politica. Penso sia cosa buona #farepauraallapolitica.	positive
attenzione xch√© se #Grillo √® furbo e attenua un po' giustizialismo x cavalcare questione fiscale sono dolori per tutti #bluffitalia	negative
#Immigrazione: da Lampedusa appello a Mario #Monti http via @user cc @user	neutral
@user siii io voglio lo screen delle mie risposte hahahha! A Milano il 16? Mi pare ovvio! Senza di me non fanno il Live #Capo	positive
PD appoggia Gianni Letta e Giuliano Amato nel governo Monti? Si, no, n√¨ #oramonti #monti	negative
17. c'√® una persona per cui faresti in assoluto di tutto? sisi	neutral
"POLITICA. Don #Ciotti: ""Speriamo che il governo #Monti sia etico, trasparente e sobrio"", http"	positive
Ma alto profilo de che? Chi √® davvero Mario Monti: http @user #fullmonti #crisi #lacrisiancoradevearrivare	negative
Compie 80 anni il Moto Club di Smcv tra i 20 pi√π antichi d'Italia - Caserta News: Caserta NewsCompie 80 anni il ... http	neutral
Oggi √® il nostro anniversario, 3 anni insieme!Grazie di Esistere! &lt;3 &lt;3	positive
@user @user ..il fenomeno #Grillo in #Rete √® dovuto alla #occupazione degli altri #media da parte dei #giornalisti venduti!	negative
Articolo 18. Paolo Ferrero: \ Cosa aspetta il Pd a sfiduciare il governo Monti?\ : ROMA Paolo Ferrero, segreta... http	neutral
RT @user: @user l'icon √® stupenda e il resto mi piace c;	positive
@user @user seguo #Grillo dal suo primo post ed ho partecipato anche a svariati V-Day. Ma ora mi ha proprio rotto!	negative
Ecco come Monti intende far ripartire l'Italia: Mario Monti ha presentato un ambizioso programma di austerit√† e... http	neutral
La cosa migliore del governo Monti e' che far√† saltare per aria il Nuovo Ulivo	positive
Il posto fisso? Che monotonia, l'intervento di Mario Monti ? video | Diritto di critica http	negative
Governo Monti, se il cambio di passo arriva anche sul Web Tg24 Sky.it | @user http	neutral
Per approfondimenti: Anche Berlusconi apre allidea di un governo Monti http	positive
Feltri qui lo squallido sei tu non #Grillo Dopo la figura che ti sei fatto oggi a #matrix fai bene ad andare a dormire Sei stanco e sragioni	negative
Il governo va sotto, Mario Monti convoca i partiti POLITICA http	neutral
"RT @user: ""Tu che stai leggendo questo, ne uscirai, non c'√® bisogno che ti dica da cosa."""	positive
@user @user che tristezza	negative
Il Movimento di #Grillo √® solo Pars-Destruens o anche Pars-Construens?Se ne parla ora a @user, con @user.	neutral
@user sei sexy anche quando elenchi gli ingredienti della mistery box!!! :))))	positive
RT @user: @user te e il tuo amico Bucelli siete proprio due mbriaghon!	negative
@user Grazie amiko! &lt;3 notte	neutral
L'incredibile storia del leone Christian (sottotitoli in italiano)per emozionarsi un po'... http	positive
@user tu pensa. Come sarebbe pi√π comics se tornassi tu di l√†. EGOISTA	negative
@user e anche minorati.	neutral
Napolitano: governo Monti non √® sospensione della democrazia http cos√¨ per i pi√π smemorati	positive
Giustificare le colpe della politica addossando la responsabilita' a #Grillo e all' #antipolitica ...un #erroredrammatico	negative
E come dice @user guardate il sito di #xoff...ce n'√® per tutti @user #coraggio	neutral
Il primo vero successo raggiunto dal #governo #monti √® che nei talkshow si comincia a parlare di cose serie http #buongiorno	positive
Tutti contro #Grillo , tutti col pepe al culo e la coda di paglia.	negative
Vado, ciao bimbi	neutral
@user grazie Ilaria un bacio a te	positive
@user --in america sono arrivati pure primi e faranno un tour estivo. √® un ingiustizia, amano pi√π l'america, infondo essa ha tutto.	negative
Riusciranno i due Mario Mario Monti e Mario Draghi ? a salvare l'eurozona? L'articolo di Martin Wolf. http	neutral
@user tutto merito del trucco, Enny! Grazie comunque :')	positive
spiego: se i 16 ministri del governo Monti hanno pi√π di un millennio (64 anni di media) secondo me per l'Italia √® un problema	negative
La materia prende vita  nelle sculture di Ivo Gensini  al Palazzo del Monte: L'esposizione comprende 37 opere es... http	neutral
Sono stato rapito dal sorriso di Emma, oddio. E' cos√¨ semplice e bella.	positive
@user il governo Monti √® come una bella lavanderia a secco per i partiti che hanno governato, male, negli ultimi tre anni.	negative
@user siiiiii ma deve ancora uscire quando fa lo scherzo a liam	neutral
@user che bei momenti.	positive
@user ..giusto Mario Monti non salta...speriamo che saltino loro..	negative
Bamo alla	neutral
@user no niente, per√≥ sto aspettando con ansia che finisca l'anno scolastico e poi mi iscrivo a scuola guida ;)	positive
E' davvero scandaloso che nel nuovo governo Monti non ci sia nemmeno una mignotta o qualche indagato per mafia! #ministri #monti #colle	negative
che ho fatto?	neutral
Io Mario #Monti lo adoro, non posso farci niente!	positive
Morango ingrata http	negative
@user per favore appoggia questa iniziativa,siamo alla fine  abbiamo solo 7 giorni http	neutral
La vittoria di #casini con il #governo #monti. http	positive
http anche se cresci il tuo lato truzzo rimanse sempre eh Zayn? lol	negative
@user @user @user  pur di difendere quei 3 puntiüòÉanche quello!!! üòÉ. Ke momento da fiato sospeso...	neutral
#partisociali convocate domenica. Del #governo #monti si pu√≤ dire di tutto ma non certo che non lavori sodo vero? #serviziopubblico	positive
odio tutti voi che siete gi√† andati a vedere midnight in paris	negative
@user La mia Uno bianca era la macchina della ditta. In realt√† io avevo un BMW #bugiaxcuccare	neutral
seguite @user bho il suo profilo √® tutto bello c:	positive
Alexis che si piglia la mononucleosi, Meredith compare a casa sua, e ci rimane e Kate non pu√≤ far altro che accettare #CastleRaiDue	negative
"2Bossi: ""Berlusconi? Non l'ho visto, ora sta con la banda di sinistra: #berlusconi #mario monti #umberto bossi A... http"	neutral
"Governo Monti, Fini: ""Ministri di grande competenza e indiscusso valore professionale"": Generazion http"	positive
Poi mi spiegate perch√© bisognerebbe essere felici di Mario Monti http	negative
Che la Cgil abbia un atteggiamento critico nei confronti del governo Monti mi sembra scontato ma che ora anche la... http	neutral
#Robinson Forza #Grillo siamo in milioni con te!	positive
@user: Mario Monti non sa impennare hahaha :D	negative
@user scusa ma alle 2 di notte a chi le dai ste notizie e dopo non interessano a nessuno....	neutral
RT @user: sdasdksjakdh la amo.	positive
#pascale amore vero? Il mondo intero chiede certezze.	negative
@user ma √® vero che Mario Monti parteciper√† a Jersey Shore? http	neutral
Guardate Mario Monti Channel qui http Un avatar simpaticissimo del premier!	positive
vabb√©, rispetto a Silvio Berlusconi il nuovo premier Mario Monti √® un tipo molto freddo, ma adesso esagera...	negative
@user Ho fatto un transloco e aspetto per il segnale al mio Vodafone station 65 giorni, ora devo pagare transloco e fattura. Opinioni?	neutral
Adesso #Grillo √® sulla bocca di tutti!! E pensare che lo sostengo da anni...e il #movimento5stelle l'ho visto nascere vai #beppe!	positive
"Io oggi vado a suola a fare niente, ho detto a mamma che rimanevo a casa e ha detto ""FAI QUELLO CHE VUOI"" e allora mi sono sentita in colpa"	negative
Post Terremoto in Molise: gli EcoDem chiedono risposte concrete da Governo Monti: LARINO _ Per l'Associazione Ec... http	neutral
@user Seguindo amore! :p	positive
Governo Monti? Roba da complottisti http via @user	negative
Catanzaro: pizzini dal carcere per il boss Giuseppe Alferi - Anche se detenuto nel carcere di Catanzaro, il boss Gi... http	neutral
Coraggio, Mario Monti!	positive
#Grillo scende in politica. Il Papa dichiara di voler fare il calciatore. Bruno vespa fara' la velina.	negative
Sottosegretari governo Monti, c'√® il vero Braga: Palazzo Chigi: ¬´Tutto a posto, giurer√† fra pochi giorni¬ª. Minis... http	neutral
Francesco Profumo al Ministero MIUR del governo Monti: ottimo! Presidente del CNR #francescoprofumo #MIUR #Monti #cnr	positive
"\""Si partiti faremo una piccola Norimberga\""? Ok, √® ufficiale, Beppe #Grillo s'√® fumato il cervello, non si possono fare metafore del genere!"	negative
#Universit√† e #governo #Monti: quali prospettive? http #ricerca	neutral
Comunque se parte il governo Monti √® grande vittoria dell' #Udc, di @user e @user	positive
Lotta studentesca contro il Governo Monti: PROFUMO di rinnovamento?No! Solo puzza di vecchi... http	negative
5 prodotti che gli uomini ‚Äúrubano‚Äù alle donne http #fashion	neutral
RT @user: sono riuscita a cambiare il profilo, mo nevica.	positive
RT @user: Nessun politico italiano √® mai andato in Europa a fare i nostri interessi  http @user #m5s	negative
@user secondo me Bini va nel governo Monti.	neutral
@user @user belin tardi ... Alla prox gelato al pistacchio:-)	positive
 Mario Monti ha lasciato il suo albergo a Monti ...ma sti giornalisti ogni tanto non si vergognano?	negative
@user Ciao darling,ho parlato con Vale delle sfilate milanesi e mi ha raccontato un po' di coe.Appena vengo su Milano ci vediamo tt 3	neutral
Ho appena ricevuto la telefonata del presidente del consiglio, Mario Monti. Si √® complimentato per la gestione... http	positive
In un articolo de #IlGiornale si accusa il governo #Monti di conflitto d'interessi: quando si dice avere la faccia come il culo...	negative
#ministri Presentata la squadra del governo Monti. Di tutti i ministri, quale di questi conosci?... http	neutral
@user *gli prende le mani* oddio perrie non sai quanto sono felice *si stende sul letto chiude gli occhi* *sorride*	positive
Ma chi le salva le persone che non permettono a nessuno di salvarle? - cit. (via ladistanzadiunbacio) http	negative
SWG: #Pd-#Pdl alla pari. Terzo #Grillo al 7,2. #FLI al 5%. #Lega al 7,1%. #Idv al 6,5 e #Udc al 6,3% http via @user	neutral
@user sei finita sui nuovi mostri a striscia in italia.HAHAHAHAHAHAH lol	positive
Decisamente, #Grillo √® l'erede della Lega Nord, il problema √® che per molti √® una virt√π.	negative
cerco immagini di Las Vegas e mi piombano quelle dei Killers. quanto orgoglio. ‚ô•	neutral
tutti pensano che #Grillo e' l'antipolitica e non far√† mai paura..anche la #Lega nacque cos√¨...intanto pero' facciamo #piazzapulita	positive
attenzione...perch√® la storia ci insegna che dopo una depressione...si rinforza l'estremismo e si arriva alla violenza...	negative
@user ci ho fatto tutte le giovanili pi√π 3-4 anni con la prima squadra. Ogni tanto mi alleno l√¨ ancora adesso che non ho una squadra	neutral
@user @user  Rappresentate due mie passioni, Roma e la Sicilia: non pu√≤ essere solo un caso ma √® un segno del destino ol√©	positive
@user cazzi per tutti	negative
a te invece che piacerebbe fare? :3 ‚Äî domanda da un milione di dollari, non lo so AMO le lingue mi piacerebbe po... http	neutral
tutto gratis	positive
Mario Monti istituisce per i barboni, l'obbligo di emissione dello scontrino fiscale, in seguito ad eventuale elemosina ricevuta.	negative
*GOVERNO: MONTI MERCOLEDI' A MATRIX* =	neutral
#serviziopubblico tutto condivisibile,ma nessuno parla di signoraggio bancario,ecco perch√® #Grillo avanza,perch√® √® in contatto con la realt√†	positive
Uau mario monti ci fa il regalo dinatale e approda su twitter. Che culo.	negative
Chi dice s√¨ al #governo Monti? #fatepresto #meritodimonti	neutral
L'addetto stampa di Mario Monti e' un idolo. Buongiorno Mondo.	positive
Le lobby sconfiggono il governo #Monti http via @user://www.romaitalialab.it/articolo.cfm?id=261	negative
Governo #Monti, si parla di Buttiglione al ministero dell'Istruzione e di riconferma di La Russa alla Difesa (Fonte Piazza Pulita La7)	neutral
@user grazie c:	positive
la lega non approva il governo #Monti. e sti cazzi!	negative
@user no nulla solo il nome. Ma Cappellacci pres. PDL della Sardegna √® coinvolto in in varie inchieste nella sua regione.	neutral
formato il nuovo governo Monti. Che Dio ce la mandi tecnicamente buona.	positive
Cose che non mi piacciono: le nomine nel governo #Monti fanno felice il mondo cattolico. http / via @user #ministri	negative
@user @user vado a fare la punta al pennarello.	neutral
RT @user: amo troppo i janoskians	positive
RT @user: Viviamo in un Paese in cui si militarizza una valle per un'opera che nessuno vuole e la Salerno-Reggio √® ferma da 30 anni. #serv‚Ä¶	negative
Ferrero (PRC) propone a Vendola (SEL) unit√† a sinistra contro Governo Monti | umbrialeft.it http	neutral
http Per restare in tema, #buonanotte Italia, io resto ancora su!	positive
#monti #chetempochefa L'atteggiamento 'mentale' del governo Monti? Nessun tab√π! (Aiiuutooo)	negative
un tal Lucas: Suggerimenti al Governo Monti per risparmiare qual... http	neutral
@user Ben detto condivido e danno a #Grillo anche ottimi assist come #rimborsielettorali che #M5S rifiuta e ora le 400 #autoblu	positive
dalla rass stampa http di #CitofonareAdinolfi si capisce pi√π dai giornali che dalle Camere, la fragilit√† del governo Monti	negative
Luned√¨ arriva la manovra del governo Monti: in agenda pensioni, piano casa, iva e lavoro http http	neutral
@user guarda come siamo tutte prese bene con le nostre date di nascita :3 ahahahah	positive
@user solo col governo Monti non funziona, dannazione.	negative
La fase 2 del governo Monti? Per ora comanda l'uomo di Letta http	neutral
¬´Per ogni ministro del governo Monti guardate chi era il suo predecessore. Il passo avanti sar√† enorme. A prescindere¬ª Michele Serra.	positive
Questo non √® un paese per giovani. Avrei voluto che la prima riforma del governo #Monti fosse stata quella del lavoro, non delle pensioni.	negative
Le ultime rivelazioni di Greenwald ‚ÄúItalia spiata da Usa e Gran ... - La Stampa - http	neutral
"Il fatto che non hai ancora trovato il tuo principe azzurro non significa che tu non sia una principessa.\"" - Zayn Malik."	positive
http fanculo! nel 2012 non li conoscevo ancora	negative
@user ci sto parlando proprio ora,tutto apposto zsdfg a te con la tua amica?	neutral
"\""Ti amo da qui... Alla fine del monfo... Di nuovo qui all'infinito\"""	positive
@user #Grillo pu√≤ essere anche peggio di #Berlusconi...	negative
@user hei se per uscire facessimo fra due sabati va bene spostare?	neutral
BRAVO Monti! RT @user La classe e l'ironia di Mario Monti nel rispondere sulla presunta festa dell'ultimo dell'anno http	positive
"Camusso (Cgil): ""Lavoro, serve un piano. Rischio di tensioni sociali"": #cgil #lavoro #mario monti ROMA ‚Äì Secondo... http"	negative
#f1 #formula1 Dai Gas alla sicurezza. Partir√† da Modena il Ferrari Driver Academy Tour: Maranello, 26 aprile - P... http	neutral
@user vinile tutta la vita...  :-P http	positive
Il governo #Monti mi ricorda la corazzata kotiokmin	negative
Aria di provocazione Annamaria #Cancellieri http #Governo #Monti #EatTheRich	neutral
20/10/13 arrivo il mio amore :):):):);)	positive
Se gli uomini fossero liberi dallo Stato e dalle sue orrende leggi, L'Aquila e tutto l'Abruzzo sarebbero risorti... http	negative
@user ma posso attivarla anche senza abbinare mobile internet?	neutral
Nessuno scandalo nelle parole di Mario #Monti: http #postofisso #monotonia	positive
La gente incolpa #Grillo persino del debito pubblico! Feltri, Vespa e Ferrara staranno pensando a quanto siamo capre noi italiani.	negative
85. E nell'amore a prima vista? no.86. Il 'e vissero tutti felici e contenti' esiste? no.87. L'ultimo film visto? non ricordo o:	neutral
Oggi il motto √® :  relax &amp; relax , a tempo perso ...relax ! Buona domenica twitteri ! CIAO ! http	positive
@user @user #Grillo fa capire quanto basso sia oggi il livello politico . #siamoseri	negative
Peluffo al posto di Malinconico, Olivi nuova portavoce. Restyling nel governo #Monti: http	neutral
Mi piace l'atteggiamento di #Grillo nel suo blog. Pubblica tutti gli attacchi che gli fanno, li mette alla luce... http	positive
@user i piccoli partiti rendono ingovernabile il paese, per√≤. E non si pu√≤ fare nulla. Su questo ha ragione purtroppo Berlusconi	negative
@user se guardi bene gli estintori non li usa nessuno sono sempre li appesi...	neutral
Oggi pranzo da nonna. Torner√≤ rotolando	positive
Controlla questo video ITALIANI NON ESULTATE: MARIO MONTI E' L'ENNESIMO BURATTINO! http via @user	negative
http Invece della spina, ricaricheremo (quasi) tutto dalla porta Usb  #Sapevatelo #Tech #StartUp	neutral
Asko: La canzone che meglio rappresenta l'amore per te :) ? ‚Äî favola-mod√° ‚ô• http	positive
E poi, cosa cazzo ci riempiamo le bocche con le parole pi√π belle del mondo, se poi non sappiamo neanche apprezzarle. Cosa. Cosa, eh?	negative
@user hahahaha anche io lol.	neutral
@user 'grazie della fiducia' ...ho vinto qualche cosa?	positive
Le mani legate del governo Monti: http via @user	negative
road map definita: approvazione legge stabilit√†, #dimissioni #berlusconi, consultazioni, governo #monti. poi #elezioni a marzo?	neutral
RT @user: - ZAYN, √â UNA BRAVISSIMA CANTANTE ED HA PURE LA FORTUNA DI ESSERE BELLA. VI RICORDO CHE, A DIFFERENZA DEI ONED, LE LITTLE MI‚Ä¶	positive
@user mmm #Grillo (razzista e omofobo http prende  pi√π i voti dell'idv che della lega	negative
Mario Monti e Mario Draghi #Italiaresiste	neutral
@user grazie ** e grazie del follow!	positive
RT @user: Uscire dalla stanza in pigiama e trovarsi davanti sconosciuti che ti fissano. Cos'√®? Non avete mai visto un pigiama co‚Ä¶	negative
Mario Monti nominato senatore a vita: http I tempi per arrivare alle dimissioni di Silvio Be... http	neutral
"la \""vera\"" musica √® quella che ti fa venire i brividi,quella che fa la TUA storia,non la storia della musica."	positive
Il governo #Monti √® sotto scacco del Conflitto d'Interessi di B. ed √® imbarazzante l'ammissione del baratto fiducia e #FrequenzeTv #Ballar√≤	negative
@user sono davvero belle come scuole c: delle mie amiche vanno alle magistrali e dicono che √® davvero una bella scuola.sknjsxb c:	neutral
@user da milanista 6 un fenomeno sia come giocatore sia come uomo ogni volta ke scendi in campo √® uno spettacolo per tutto il calcio	positive
RT @user: Ancora Giannino invitato come opinion-leader e presentato come modello? #lagabbia	negative
#Grillo ieri a Conegliano ha detto che pagare le tasse e' giusto ma vuole conoscere la destinazione d'uso. Anche la Lega diceva cosi'...	neutral
non so come abbia dormito questa notte #Pogba, io benissimo grazie a lui...e se mi scampanella x 1 po' d latte, gli mungo la mucca!	positive
#Monti ha detto ke dobbiamo cambiare stile di vita... ANCORA? una regolatina a politici e pubblici amministratori no eh? #SiamoAlleSolite	negative
@user non ci sara' nessun governo monti...Ci saranno invece elezioni anticipate...	neutral
@user ciao giorgione! ieri ho iniziato un corso di cabaret a teatro.. stradivertito..speriam bene!! consigli?? :D	positive
Amo economia #ironia #fuck	negative
Un funambolo ... Mustaf√†, il mago della patata (e della carota): ROMA ‚Äì Nel mercato romano di Porta Port... http	neutral
Governo Monti giura al Quirinale Napolitano: Sono soddisfatto 	positive
Alle prossime elezioni andranno tutti a votare #Grillo ... Tanto ormai non ci resta che ridere per non piangere #politica	negative
Enrico Mentana: ¬´Il successo (possibile) di #Grillo √® un effetto, non una causa della #crisi dei #partiti¬ª http	neutral
Una chicca della comicit√† italiana... Benigni e Mario Monti :D http	positive
Ok, Grillo, va bene. Ma dicci anche come si fa #Grillo #Robinson #sfacelo	negative
SPECIALI OFFERTE WEEKEND: Hotel con Spa Terme della Fratta: OFFERTE WEEKENDGrand Hotel con Terme e Centro Beness... http	neutral
#Governo #Monti, segnali positivi, incoraggianti e congratulazioni dai premier dei grandi paesi eu, speriamo bene. #lungavitagovernomonti	positive
No al governo Monti, che rappresenterebbe il sistema bancario e finanziario, persino in difesa delle speculazioni. Si pensi ai cittadini	negative
@user anche io lo sto vedendo ahahahhaha	neutral
RT @user: @user no √® uguale al primo :)	positive
Dice che se il prossimo governo #Monti non te convince, sei anti-italiano e non vuoi bene manco a #Napolitano... e manco a Ges√π.	negative
L'Espresso: La dura vita dei siti indipendenti - http - by @user	neutral
Niente politici nel governo Monti. Per me va benissimo...	positive
@user Anche nelle 4000 #Parafarmacie E il delitti #farmaci C senza ricetta ?Intanto #federfarma fa' lobby su #balduzzi .Man !	negative
TT ITALIA 00:08 1.#serviziopubblico 2.#piazzapulita 3.#Grillo 4.Trota 5.Prince Of Persia 6.Franca Rame 7.Billboard Awards 8.Lega	neutral
@user Grazie Wendy:)	positive
Ritrovata la salma di Mike Bongiorno. Giusto in tempo, nel Governo Monti c'√® ancora un Ministero libero	negative
"Enrico Morando (Pd) al Foglio: ""Il governo Monti ha cambiato il Pd. Ora Bersani deve convocare presto un congresso per ridiscutere la linea"""	neutral
Se affronti con coraggio le tue paure, scoprirai che erano solo paure. (di Stephen Littleword) http	positive
A volte vorrei spegnermi e non pensare pi√π a niente e a nessuno	negative
Nella lista dei potenti della Terra il primo posto √® una poltrona vuota /read in @user http	neutral
Vai cos√¨ super Mario #Monti! Non mollare !	positive
Ma tutte queste pubblicit√† di farmaci contro il bruciore di stomaco sono dovute agli stravizi natalizi o alle virt√π di Mario Monti?	negative
"Assotutela?.net: ""Il Governo Monti vuol colpire i consumi per ridurre il passivo della... http"	neutral
POLITICA. NAP oggi: Viva soddisfazione per un governo che nasce in un clima positivo , http #Governo, #Monti, #Napolitano	positive
#Passera dice che potrebbero pagarmi in #Bot ..ma dal salumiere me li accettano? #finanzacreativa #crisis #sviluppoeconomico #governo #monti	negative
Governo #Monti: sono migliaia le mail e lettere con cui gli italiani fanno suggerimenti sulla #manovra. Leitmotiv: abbattere costi politica	neutral
Governo: Allen Sinai, Monti eccellente, priorita' tagliare spesa: Roma, 11 nov. ? (Adnkronos) ? Mario Monti sare... http	positive
Il centro-sinistra riparte da Napoli! PRC:FERRERO, DA NAPOLI √à EMERSA OPPOSIZIONE A GOVERNO MONTI http	negative
Verso una nuova cifra comunicativa con il Governo #Monti? #Ferpi: http via @user	neutral
@user ma grazie, Stefano	positive
Controlla questo video La protesta farsa dei sindacati contro il governo Monti 12 dicembre 2011... http via @user	negative
COL GOVERNO MONTI,IL PAPA STRANIERO ALLA POLITICA, NASCE LA TERZA REPUBBLICA: ORMAI SIAMO STRETTAMENTE SOTTO IL... http	neutral
L'editoria non √® la Fieg. Una gran bella lettera di @user a Mario Monti http via @user	positive
Dall'antipolitica #Grillo si e' passati alla politica con miss padania! Ma quello del pd e' sveglio o soffre di jet-lag?	negative
La camera dei deputati approva la manovra del governo Monti con 495 voti a favore. AFP	neutral
C'√® una coppia di manzi che ciao proprio.. #IKEA e io giro con due figli a carico -.- NON SONO MIEEI!	positive
Professor #Monti ma non √® che a pagare saranno sempre i soliti? Per adesso, tra #pensioni e #iva, di #equit√† e #crescita non c'√® traccia	negative
Appena segnalato traffico su Dir. Acilia, Ostia, Roma, http usando @user - Social GPS.	neutral
@user Ok, non aggettivi per descriverti!!! Non sono abbastanza per te!!! *___* Grazie	positive
E il governo Monti non toccher√† la legge elettorale. Sento puzza di Pentapartito 2.0. #doposilvio	negative
TT Twitter Italia 22:00: 1.#Grillo 2.#serviziopubblico 3.#primoLibro 4.Renzi 5.Prince Of Persia 6.Franca Rame 7.Partito della Nazione	neutral
Mario Monti ama la bici. Bene, voglio apprezzarlo per questo motivo e magari sistema qualcosa a favore delle due ruote.	positive
@user mah, infatti si :) cmq sono stata spostata anche prima, c'√® da morire -.-	negative
@user Sar√† in Italia ahahha	neutral
Buongiorno e buona domenica !!! http	positive
Qui sono io che faccio le domande. Non tu. ‡≤†_‡≤† ‚Äî  http	negative
Raga, mi esce che ho votato troppe volte.. come faccio a votare? #aiutatemi	neutral
comunque io non sono nelle foto ufficiali, sono stata tutto il tempo in giro AHAHHA	positive
Manovra/ Ferrero: stangata sociale del governo Monti contro i lavoratori | umbrialeft.it http	negative
Probabile una soluzione identica a quella di Atene: un governo di larghe intese con a capo Mario Monti.	neutral
Con #Grillo sembra tutto facile http #blog #politicapalazzo #beppegrillo #cultura	positive
SONDAGGIO CRESPI RICERCHE, QUASI FINITA LA LUNA DI MIELE: MARIO MONTI AL 56% http	negative
The Asch Experiment: http via @user ecco perch√® nelle riunioni alla fine litigo sempre con tutti :)	neutral
@user se avessi i soldi, s√¨ XD XD ;_;	positive
RT @user: @user io ti odio NON PU√í ESSERE FINITO COS√å NON PU√í	negative
#LinkedIn: 200 milioni di iscritti, 4 milioni in Italia http via @user	neutral
Una cosa positiva del governo Monti √® la produttivit√†, ora finalmente avremo uno standard al quale confrontare i successivi governi.	positive
Mario Monti √® occidentalista, banchiere, massone, antifascita: insomma, un mafioso	negative
"fattoquotidiano: #Grillo attacca #Vendola: \""Supercazzola che fa affari con la Marcegaglia\"" - Video http http"	neutral
Governo Monti pronto: domani al Quirinale ¬´Lavoro proficuo, Italia superer√† la crisi¬ª Il Messaggero http	positive
Italia illegal operation via @user http	negative
#Frequenze TV, il governo #Monti pensa solo a #Rai e #Mediaset http via @user	neutral
#OMMHSC Oh mio Dio Che gol ha fatto #Belhanda üò≤üò≤üò±üò≤üò±	positive
Orto Botanico Cagliari: a ormai 1 anno dal primo attacco ad opera del punteruolo rosso, non √® stata ancora tagliata la P. dactylifera morta	negative
@user Grazie per  invito,dipende  dal lavoro,comunque sempre in contatto	neutral
@user √© un play con le palle! davvero bravo	positive
@user  anche ioooooo :-(	negative
@user @user YAH! Eri contento? D.D Hyung √® tornato ^^ erano tutte cesse, nessuna alla mia altezza KWAKWAKWA XD	neutral
@user Hey, grazie per il follow! Piacere, Robby :)	positive
Rubare ai 'poveri' per dare alle ricche banche ecco il governo Monti	negative
#Roma, presidenti delle province chiedono a #Napolitano modifica del decreto Salva Italia del governo #Monti http	neutral
@user ah grazie (:	positive
281 senatori a favore del governo tecnico. Mario Monti √® pronto ad instaurare il Reich.	negative
Riassunto: La versione 6.0 della soluzione Surveillint di Proximex √® stata selezionata come finalista nell‚Äôedizio...  #biz #hitech #italy	neutral
@user grazie per le infinite emozioni che mi fai provare quando fai e telecronache *-* #forzanapoli	positive
scusate ma se story of my life parla di una ragazza e blabla perch√® nel video ci sono le foto dei ragazzi da piccoli? cio√© non ha senso	negative
@user cosa devo dirti?	neutral
Per adesso √® solo un TT Italiano, spero che diventi anche un TT mondiale.#ItalianSelenatorsLoveSelena	positive
@user Vedi se ti devi far parlare dietro per qualche centinaio di chilometri. @user @user	negative
@user oddio, come mai? ma quindi torneremmo la sera stessa a casa o staremmo tutti a dormire a Firenze? lol	neutral
La nomina a senatore a vita dell'ottimo Mario #Monti, sembra non bastare. Il mondo e l'Europa vogliono azioni concrete. Nuovo governo subito	positive
giornalisti italiani, smettetela con queste domande veramente scomode e impertinenti a mario #monti	negative
@user @user amore ti presento miley, miley lei √® mia figlia :3	neutral
@user @user io sono tutto impazzito...√® stato un gran piacere conversare con voi...lo rifaro' prestissimo.	positive
un sms mi avvisa che d'alema potrebbe essere ministro nel governo monti. improvvisamente via veneto ha perso il suo fascino	negative
http MARIO MONTI NEI TALK SHOW SENZA CONTRADDITTORIO	neutral
RT @user: Carissimo Federico oggi √® il tuo compleanno!! Tanti AUGURI adorato cugino!!  Ti voglio bene http	positive
 Il terzo polo d√† appoggio totale a Mario Monti,ma di chi ti eri andato a fidare? (cit. #MIOPADRE)	negative
L'assist di Fitch a Mario Monti: Oggi l'Italia ha tutto il diritto di non sentirsi pi√π il brutto anatroccolo del... http	neutral
@user mi debbo complimentare con il Governo Monti per la trasparenza, la sobriet√† e la pragmaticit√† tuttavia	positive
certo che nel governo Monti entreranno Profumo e Passera a Mr. B. verr√† un attacco di bile da record: il suo sogno realizzato da altri...	negative
Tra pochi minuti Mario Monti in diretta su rai3 a che tempo che fa .	neutral
GRANDE,GENIO,CAPO,GROSO,IDOLOOOOOOO http	positive
#fisco e abuso del diritto: quando il risparmio d'imposta diventa vantaggio fiscale indebito #governo Monti http	negative
Piano #Sud, accordo Regioni-Governo #Monti sblocco per 8 miliardi http via @user	neutral
Il governo Monti sta puntando molto sui giovani, adesso sta a noi dimostrare che la fiducia √® ben riposta!... http	positive
Il governo #Monti non e' ancora nato e gia' sta perdendo troppo tempo.	negative
@user @user dopo Linea B adesso anche la #RomaLido #tordivalle √® presa d'assalto da suonatori #free	neutral
Terzo posto?!lontano ma non impossibile!!!!combattiamo fino alla fine!!!!	positive
Adesso mi tocca sentire che il blocco dei #TIR √® un complotto contro il governo #monti. Che faccia tosta! #italiablocatta	negative
Su #paywall #journalism #paidcontent finalmente, in Italia. I quotidiani italiani e il mondo del Web - Wired.it http	neutral
@user aww grazie dhshhs	positive
#Grillo anche a #inonda ... Bastaaaa !!!	negative
@user Allora 1. la tua bio √® fiulherahfuilerfhifuil 2. il tuo nome √® dskalhhfelfefnsil alla seconda (?)E 3. sono Sara Yeah u.u	neutral
Monti: Ho apprezzato il senso di responsabilit√† di Berlusconi : #berlusconi #camera #mario monti ROMA, 18 NOV ‚Äì... http	positive
Il Fatto Quotidiano Com'era verde quella porcata: La cura da cavallo del governo Monti con tanto salva-Italia e... http	negative
@user: Travaglio Governo Monti potrebbe aprire asta pubblica su frequenze #serviziopubblicoE' OBBLIGATORIO	neutral
Buongiorno a tutti ragazzi e ragazze	positive
@user: Perch√© Patroni Griffi √® ancora nel governo #Monti? [a sua insaputa, I presume]	negative
"@user ahahah!! Ma che fine ha fatto @user detto \""la torcia umana\""...???"	neutral
Mario Monti ha presentato il programma che ci aspettavamo: rigore, crescita, sviluppo economico e sociale.	positive
Mario Monti √® senatore a vita: pi√π posto fisso di cos√¨ si muore (letteralmente) - M. Travaglio #serviziopubblico	negative
#calcio Juventus, Barzagli alla Rai: ¬´Non so analizzare questo 2-4¬ª http #news #calciomercato #news #calciomercato	neutral
Primi effetti positivi del Governo Monti. Mi √® stata recapitata una bolletta del gas dove devo pagare -14.84‚Ç¨.	positive
Anche Mario #Monti √® fotogenico. Solo io vengo una merda sulle foto?	negative
Il governo Monti non sa comunicare http	neutral
@user il governo Monti fa quello che deve e grazie a Dio lo fa bene. Sono gli italiani ad essere delle barzellette!	positive
Se alla fine bel governo Monti infileranno dei politici sar√† la solita rivoluzione all'italiana. Poco seria.	negative
Il presidente MARIO MONTI e la massoneria http	neutral
@user vedo che anche senza di te i Raptors se la cavano abbastanza bene , convinto che con tuo recupero Raptors piu' forti , ciao	positive
RT @user: la mia tl continua a fare schifo	negative
Il grafico che fa pi√π arrabbiare Mario Monti, considerati i tassi che ancora paga l'Italia sui titoli di stato http	neutral
Bellissima vittoria stasera! Grazie ragazzi! @user @user #lube #CEV #A1Mvolley	positive
Con il governo Monti e la nuova manovra sono scomparsi gli indignati... #farsa	negative
Il Fatto Quotidiano Berlusconi √® invecchiato di colpo: Il tenero Silvio dice che Mario Monti gli ha copiato l'ot... http	neutral
9. hai mai sofferto per amore? No, grazie al cielo no	positive
@user non lo hanno mai fatto,  il loro unico obiettivo e dare un po' di cosce ai mariti frustrati	negative
#Grillo di non critichi #Napolitano: la critica al Presidente della Repubblica compete solo ai partiti in cui milita  #Bersani	neutral
@user con tutte quelle assenze siamo stati anche troppo bravi!! #ForzaMilan ..sempre..	positive
e anche #Grillo ce lo siamo giocati,sbaglio o ora ha solo il popolino ex Lega,exPd,exPdl,ex tutto ??	negative
@user @user ....Viviana il prossimo tre novembre un' eclisse ibrida visibili nel sud Italia ???Pu√≤ essere !...ne sai qualche cosa	neutral
@user come stai amore mio?	positive
Sto impazzendo..	negative
mario monti	neutral
"Di Pietro: ""Si alla fiducia per governo Monti, ma vogliamo risultati"" http"	positive
Mario Monti nominato senatore a vita. I primi momenti del post-Berlusconi mi fanno terrore...	negative
Per le agenzie, anche Letta punterebbe a un governo Monti. Gianni Letta, intendo	neutral
#monti : se tutti pagassero le tasse.. #Grillo rubereste il doppio .. sante parole miticoooo	positive
@user RIFORMA: una delle tante che i partiti hanno imposto (ahahhha) al Governo Monti. #puttanate #campacavallochelerbacresce	negative
@user per fare cosa ?	neutral
@user Dm amore	positive
Se #Grillo √® l'alternativa mi tenevo #Bossi: fa anche ridere di pi√π.	negative
Governo Monti, se il cambio di passo arriva anche sul Web Tg24 Sky.it. Guardalo su: http	neutral
#Grillo buongiorno a tutti! #M5S	positive
A #Grillo che propone di uscire dall‚ÄôEuro consiglio di entrare alla Neuro	negative
Crisi,Sarkozy: serve accordo Ue. Vertice cruciale a Bruxelles: Per l'Italia il premier Mario Monti http	neutral
DI VI NO. http	positive
Mamma mia una zanzara in camera...meglio un aereo che atterra... #odiolezanzare	negative
@user ma li voglio tutti arrivo	neutral
@user grazie mille	positive
@user @user @user Per Marco Rizzo al Tg4 il governo Monti √® peggio di quello di Berlusconi!	negative
#Grillo e il teatrino della politica. Quanto ci piace - Dal blog di Fabrizio Tonellohttp	neutral
#Grillo e #Bossi : #Lega era forza territoriale separatista, #M5S e' aggregatore nazionale generazionale. Fiducia ai giovani #Muoviti_Italia	positive
Beh certo, tenere il cellulare al bar in tasca vicino alle parti intime ci salver√† tutti dal tumore. Udine cell free http	negative
@user @user  beh se tsunade e hashy li curano ho il sospetto dalle foto  che anche il primo hokage non amasse invecchiare	neutral
@user notte,grazie per aver parlato con me.	positive
tutti i politici hanno espresso la preferenza a non entrare nel governo #monti. un bel lavaggio collettivo di mani. bene.	negative
"Polemica #DiPietro #Grillo :solo  una ‚Äústrumentalizzazione\"" che vuol fare chi ha paura di un progetto politico alternativo a questo governo."	neutral
@user *sorride e lo ribacia, annusa le rose* oddio quanto profumano	positive
@user √® vero la politica deve stare in mezzo alla gente perch√© altrimenti ci sta #Grillo e i suoi falsi ideali	negative
Mario Monti conferma Manlio Strano segretario generale: ROMA, 2 DIC ‚Äì Il Presidente del Consiglio Mario Monti, d... http	neutral
"Liam: \""Le nostre fans pensano che non vediamo i loro tweets, in realt√† noi li vediamo tutti e a volte √® anche spaventoso\"".#1DFact"	positive
#Grillo guadagna consensi e il Pd cosa fa? manda Renzi? fosse stato un film di Pieraccioni, poteva anche starci... #serviziopubblico	negative
L'Arte Del Pianoforte in Italia: (Da Clementi a Sgambati) Opera Adottata Nel Liceo Musicale Rossini Di Pesaro (I... http	neutral
il governo monti cercher√† di mettere in piedi italia che piange.........speriamo bene e speriamo di vederla ridere ........	positive
Se il governo #Monti cede sui #taxi, √® politicamente morto. Cedere al teppismo politico √® una tipica dichiarazione di inesistenza in vita.	negative
Premi e riconoscimenti http	neutral
@user si! Ma te la do solo se mi dici se stai ancora con Nina *si illumina AHAHAHAH UWU*	positive
@user era un grande problema per le banche, ma ora che Bankitalia √® al timone del Governo #monti dormiremo #spread e c/c tranquilli	negative
TT Twitter Italia 05:00: 1.#cinemaInChiesa 2.#serviziopubblico 3.#Grillo 4.Trota 5.Levon Helm 6.Damon and Elena 7.Prince Of Persia 8.Lega	neutral
@user grazie mille, sei un amore asdfghjkl c:	positive
Qual √® la cosa pi√π pericolosa che hai mai fatto? ‚Äî dire a mia nonna che non avevo fame ... http	negative
Il presidente del Consiglio, Mario Monti, √® appena arrivato a Bruxelles per il Consiglio europeo informale. A una... http	neutral
@user Bello veramente azzeccato. Corretto fino alla fine: il prelievo √® per Mario Monti e per la Casta.	positive
#Bersani critica #Grillo per le offese a Napolitano ma non si sente in colpa per le offese alla nostra dignit√† di tutti questi anni.	negative
POLITICA. #Panebianco sul CorSera: La durata e la stabilit√† del governo Monti non hanno nulla a che fare con la questione del #referendum .	neutral
#OttoEMezzo certo che abituati al nano...anche se non ne condivido le scelte Mario Monti √® proprio un gran signore..	positive
Ancora 32%,bella merda	negative
Sabato alla Camera si vota il DDL SVILUPPO...poi da Lunedi avremo un nuovo Governo con Mario Monti Premier. http	neutral
Grazie *-* @user *-*	positive
Chi dice s√¨ al governo Monti? La lista dei deficienti in arancione http	negative
@user sisi, sempre su tutto..	neutral
La faccia della giornalista del #tg3 dopo il servizio su #Grillo dice tutto. Brava.	positive
governo monti con gianni letta, pd perplesso. Ma che vogliono? Non esagerate senn√≤ ci mettiamo @user	negative
Rai: Mario Monti e Corrado Passera lavorano a riforma? http	neutral
"MARIO MONTI: ""L'EURO E' UN SUCCESSO, SOPRATTUTTO PER LA GRECIA"" http"	positive
RT @user: odiare qualsiasi tipo di canzone se viene impostata come sveglia.	negative
CASA, CONDOMINIO E MANOVRA SALVA-ITALIA DEL GOVERNO MONTI. marted√¨ 13 dicembre 2011 http	neutral
Massimo Franco sul Corriere illustra efficacemente aspettative ed incognite del Governo Monti http	positive
RT @user: Rep Petrini su caos tasse.Confcommercio denuncia Tassa rifiuti aumento fino a 600% su rifiuti.Si scherza col fuoco anch‚Ä¶	negative
Ok, ti ho fatto pubblicit√† u.u (@user live on http	neutral
Secondo me il governo Monti non sar√† una sconfitta della politica, tutt'altro. Semmai sar√† una sconfitta di certa lotta partitaria.	positive
la noia della domenica non ha eguali	negative
Accadde oggi:  1993: entra in vigore il Trattato di Maastricht, che stabilisce formalmente l'Unione Europea.... http	neutral
Mi sto commuovendo a guardare How I Met Your Mother	positive
@user Eh, ma i salernitani sono campioni nel lamentarsi!	negative
Chameleon Launcher in arrivo anche per smartphone: video beta privata su Galaxy Note 2 e Nexus 4: Chameleon Laun... http	neutral
@user graaaaandee!	positive
Berlusca ha problemi di doppia personalit√†: ha appena smentito (in viva voce) di potere/volere staccare la spina al Governo #Monti .	negative
Giornata della Memoria 2012: il discorso di Mario Monti http via @user	neutral
@user si, perch√© i miei non hanno la macchina. Si in effetti, per√≤ rimane sempre bellissimo, perch√©? Io lo bacerei comunque lol.	positive
"Lei \""ma tu ora saresti pronta per un amore?\"" Io \""se devo domandarmelo immagino io sia gi√† preda dell'incantesimo dell'orologio biologico\"""	negative
@user ..ci chiamavano Mario Monti a scuola...;)	neutral
Controlla questo video MARIO MONTI: L'EURO E' UN SUCCESSO, SOPRATTUTTO PER LA GRECIA http via @user	positive
@user Qualcosa in cambio doveva avere. Se no non se ne andava. Certo che il governo Monti non ci fa una bella figura.	negative
‚ÄúLiving well, within the limits of our planet‚Äú (Vivere bene nel rispetto dei limiti del nostro pianeta). Questo il... http	neutral
Ecco i primi incoraggianti passi del Governo Monti sulle rinnovabili http	positive
@user il mio albero avverte la crisi...Mario Monti grazie x questo natale stupendo	negative
TT ITALIA 23:28 1.#piazzapulita 2.#serviziopubblico 3.#Grillo 4.Prince Of Persia 5.Franca Rame 6.Belsito 7.M5S 8.Falcao 9.Nero Wolfe	neutral
Governo: Fini, Monti personalita' piu' adeguata a affrontare crisi: Roma, 10 nov. (Adnkronos) ? Mario Monti e' l... http	positive
 Mario Monti for president? Che fatica essere di sinistra . Dalla Jena di oggi	negative
#StayStrongHarryDirectionersLoveYou #RT Se anche tu ami Harry come sempre nonostante la storia Haylor.20	neutral
"[vero] ""@user: grande professor #Monti, nell'aula del Senato: Se dovete fare una scelta: ascoltate, non applaudite"""""	positive
Dio quanto mi odio. Sono inutile.	negative
@user fatto ricambi??	neutral
Definisce il governo Monti un esecutivo di buona volont√† . Ai partiti dice: Si impegnino, anche a riscattarsi	positive
I sindacati si accorsero solo ora che il governo monti √® deleterio... Buongiorno!ben svegliati!	negative
Questa sera alle ore 23:30 americane, andr√† in onda il famoso show della NBC Saturday Night Live e la... http	neutral
#Movimento5stelle #Politica #Italia #Grillini E #Grillo va, alla conquista del paese! | hubmagazine http	positive
@user ho le balle girate di mio, ok? se poi devo sentirmi la ramanzina da te, guarda, vai pure a quel paese	negative
"f #LaRagazzaDiFuocoRoma ""L'uccello, la spilla, la canzone, le bacche l'orologio, il pane tostato, il vestito consumato dal fuoco..."" 61"	neutral
Nn so se dopo posso aprirlo ti amo buonantt	positive
Va bene il governo Monti, ma in Italia c'√® ancora da risolvere la crisi bimbiminkia affetti dalla sindrome di Twilight.	negative
#Grillo e il teatrino della politica. Quanto ci piace | Fabrizio Tonello | Il Fatto Quotidiano http via @user	neutral
Il nuovo Governo Monti √® stato presentato. Non ho cognizioni specifiche per valutare i nomi, ma apprezzo molto che non ci siano politici.	positive
trovo che beppe #Grillo sia insopportabile. solo un gran casino e critiche continue, ma non gli ho mai sentito fare una proposta che sia una	negative
 @user: Stasera Mario Monti alle 20 tg5 .. per la prima voltaa!	neutral
Monti festeggiato per le strade di Roma ¬´Avete visto che splendida giornata?¬ª: ROMA Mario Monti ha lasciato in... http	positive
Laura Pausini e poi il presidente del Consiglio Mario Monti @user sceglie bene i suoi ospiti!	negative
Secondo alcune voci, Beppe #Grillo sarebbe al 7%. Ma da ottobre anche lui al 23%. #M5S	neutral
RT @user: niall √® perfetto biondo, niall √® perfetto castano. niall √® sempre prefetto http	positive
"Continuare a considerare #Grillo come antipolitica. #erroredrammatico [Abbia il coraggio di definirsi \""forza politica\""]"	negative
"Roma, i ""Draghi Ribelli"" protestano contro il governo Monti: #draghi ribelli #governo monti #montecitorio ROMA ‚Äì... http"	neutral
Quanto era bello oggi. Con i capelli tutti arruffati, la tuta. Mi era venuta voglia di una cosa pervy con lui. Ok ora datemi della pazza.	positive
Speriamo non mi interroghi,cazzo	negative
Tutti lo cercano tutti lo vogliono solo le piazze e gli elettori lo trovano chi e'? #Grillo ! #ottoemezzo	neutral
"Marc Lazar: ""Napolitano? L'Europa lo ammira. Mario Monti? Pu√≤ salvare l'Italia"" http via @user"	positive
Rutelli, fiducia al governo #Monti: mancava che gli dicesse che √® bello ( elegante e con indiscutibile aplomb li aveva gi√† usati)	negative
Mario Monti senatore a vita http	neutral
@user wow, conosci tutti questi posti? Mi dicono che sei intelligente. E poi sto alla grande oggi.	positive
Ecco tutti i privilegi della Casta che il premier non ha tagliato mario monti, casta, sprechi, cam http	negative
@user @user Ahahahahaha Tranquilla Grazie :') tanto la rabbia mi e passata stavo aspettando la monchele riot !	neutral
@user ...#seguodeejay perch√® li tengono bene il tempo...:)	positive
RT @user: ragazzi che ‚Äúperch√® le tette di fuori hanno pi√π mi piace di un sorriso?‚Äú e poi se non hai un balcone con tanto di fiori nem‚Ä¶	negative
C'√® anche Stich O.O (@user http	neutral
Ci diranno che Mario Monti √® troppo poco italiano. Bene! #rimontiamo http via @user	positive
10mln per #400NuoveAutoBlu e poi #Napolitano predica contro l' #antipolitica e chi s'incazza come #Grillo ? Ma questi vanno rinchiusi tutti!	negative
D'Alema: Per la prima volta pagano anche i ricchi : ROMA ‚Äì ''Il professor Monti si e' trovato ad operare in una... http	neutral
RT @user: I migliori tweet pt.3  'Ah la musica, una di quelle magie che supera tutte quelle che facciamo noi.'	positive
@user io ancora rutto la ricotta fritta di mezz'ora fa!	negative
Porsi a distanza, quel tanto che basta per mettere bene a fuoco e osservare che le cose non sono esattamente come credevi che fossero.	neutral
Governo, Monti: E' trasparente, non c'√® conflitto interesse: Squadra snella e forte .Parlamento costante punto... http	positive
Governo Monti: l'ultimo atto della lenta agonia della politica sovrana. La tecnocrazia come esito in http	negative
Liga Italia ‚Ä¢ Re: Conte Sebut Balotelli seperti Lukisan Mona Lisa http	neutral
Il vecchio governo paragonato al governo #monti sembra il cast di un film di lino banfi e Renzo montagnani rispetto ad uno di scorsese	positive
#Grillo che scappa inseguito da Bertazzoni mi ha fatto cadere le palle per terra. #ServizioPubblico	negative
"Pensioni, flessibilit√†, Pompei... Le priorit√† del governo Monti: ROMA ? ""Crescita ed equit√† sociale"" sono le prior... http"	neutral
Mario Monti: Con seriet√† e rigore, forse la sfanghiamo 	positive
Ma non sar√† che il governo #Monti sar√† un flop come i precedenti governi tecnici?	negative
Sabato 26 gennaio dalle 10.30 alle 11.30 visita guidata della Basilica di San Piero a Grado http	neutral
@user grande mozart domenica li spacchiamo noi e solo noi i campioni d'italia forza pirlo non fermarti mai	positive
"\""Gli Stati Uniti sono la prova evidente di quanto sbagliato sia per la democrazia avere partiti privatizzati.\""N.Urbinati #Grillo #radicali"	negative
@user ciao a me piacciono tutti i ragazzi di tluc ma in particolare michele e matteo &gt;.&lt;	neutral
@user Grazie tante cara mia.	positive
@user anche io..vorrei morire a causa del lavoro di tessili	negative
@user ciao meraviglia, potresti mettere mi piace qui &gt;&gt; http ‚Ä¶ se non lo metti non importa, grazie comunque :)	neutral
Monti credit rating: AAA. Sono sempre pi√π impressionato dallo stile e dalla seriet√† di Mario Monti, speriamo che il mondo si accorga di lui	positive
C'√® mio pap√† che sta urlando come un dannato per la partita, sono qua di fianco a lui, mi sta stordendo	negative
Da #Santoro un match #Renzi-#Grillo - Italia - l'Unit√† http	neutral
A #Catania 10 fischi e 300 applausi. Bilancio positivo per me e per il Governo #Monti che sono fiero di sostenere.	positive
messaggio per Ges√π che sta per nascere: attenzione sulla grotta fredda dove nascerai il Governo Monti metter√† l'ICI!	negative
@user ti piace il tuo comportamento? motiva la tua risposta.	neutral
La manovra del governo Monti √® impopolare, reazione prevedibile! Ma √® necessaria, l'Italia ne ha bisogno!	positive
RT @user: Brissogne:multa per i cani che sporcano per strada! ma solo  i cani? quando passano delle mucche fanno peggio e nessuno pu‚Ä¶	negative
La stampa: Il governo monti perde un pezzo Vacanze gratis malinconico lascia .	neutral
http sondaggio non male, vedrai che il PDL cambia di nuovo rotta e si tiene stretto il governo #Monti #opencamera	positive
Che uno poi vorrebbe pure darlo un rigore al Milan ma se negli ultimi 20 minuti entri in area della Lazio mezza volta diventa impossibile.	negative
Manovra, meno tagli su casa e pensioni: adesso Monti apre alle modifiche: Mario Monti non chiude la porta a poc... http	neutral
il #governo #Monti mi piace, finalmente composto da personaggi di spessore! Speriamo che li facciano lavorare	positive
Governo Monti, Universit√†,Natale... ij k mal e cap....	negative
LA MANIFESTAZIONE: Oggi in piazza contro la manovra del Governo Monti http via @user	neutral
@user fosse solo quello il punto... Per fortuna da me un congresso democratico si √® fatto	positive
#Grillo al prossimo #Governo?! Volta buona che impacchetto tutto e vado via. Di #AntiPolitica non si vive,non giova a nessuno @user	negative
"#Santoro: \""Perch√® nessuno oltre #Grillo parla della crisi delle banche italiane? All'estero √® un argomento dibattuto.\"""	neutral
@user io di reggio calabria, ascolto un p√≤ di tutto :)	positive
Non abbiamo privatizzato, abbiamo svenduto! Quello che far√† anche il Governo #Monti! #piazzapulita	negative
@user chi mi segue sa che ora e' questa..massi proprio lei l'ora della caga cazzo del 10 e lotto!!!!.....puntuale come la morte!	neutral
Da grandi poteri derivano grandi responsabilit√†, Illustre Professor Monti. Now save us!	positive
Particolari le risposte del sito #agendadigitale ... comunica che non trova competenze digitali in #Italia .... http	negative
Governo Monti: ogni famiglia dovr√† pagare una tassa su ogni animale che possiede come bene di lusso http	neutral
@user @user @user esatto dopo 20 anni qualcosa si impara per forza!!!	positive
RT @user: Sei proprio una testa di cazzo	negative
"Forse Favia non ha spiegato bene il ruolo di #Grillo e del \""marchio\"" ma basta poco per capire che un garante √® necessario. #serviziopubblico"	neutral
RT @user: GOOOOOOOL, dal dischetto Tevez non sbaglia!!!  #FiorentinaJuve 1-0	positive
@user Ho appena ascoltato l'intervento di questa militante. Non ho parole √® l'unica cosa che viene da dire anche a me.	negative
Padelli ci starebbe bene nella difesa dell'#Inter	neutral
irene invece √® cos√¨ simpatica	positive
Senza Letta chi ha le mani pi√π libere verso il Governo Monti? Indovinate? Sempre bravissimi, quelli del Pd.	negative
Striscioni e biscotti pro Bossi in via Bellerio -Milano - Repubblica.it http	neutral
@user bella foto . Fa molto relax	positive
L‚ÄôItalia dei valori...Lidia Undemi, nauseata dalla falsit√† del partito si dimette. -  Raccontate la verit√†,‚Ä¶ http	negative
@user HAHAHAHAHAHAHAHAHAHAHAHAHAHAH non √® un porno alla fine	neutral
@user sii √® tutto meraviglioso djjdhdsjdh	positive
Il governo Monti √® troppo tenero con gli sprechi della casta POLITICA http	negative
Il governo Monti e la manovra salva Italia http	neutral
@user Grazie xD ahaha ti capisco xD ti auguro comunque buona fortuna, forse torner√† la voglia di studiare (?)	positive
